sample	name	taxonomy_id	taxonomy_lvl	kraken_assigned_reads	added_reads	new_est_reads	fraction_total_reads
SRR6145059	Candidatus Nanopelagicaceae	2162846	F	53	3	56	0.00001
SRR6145059	Candidatus Babeliaceae	2497645	F	6	7	13	0.00000
SRR6145059	Candidatus Brocadiaceae	1127830	F	5	0	5	0.00000
SRR6145059	Candidatus Paracaedibacteraceae	1777752	F	4	0	4	0.00000
SRR6145059	Candidatus Midichloriaceae	1328881	F	3	0	3	0.00000
SRR6145059	Candidatus Methanomethylophilaceae	2517203	F	1	0	1	0.00000
SRR6145059	Candidatus Desulfofervidaceae	1902584	F	1	0	1	0.00000
SRR6145059	Candidatus Deianiraeaceae	2603433	F	1	0	1	0.00000
SRR6145059	Hominidae	9604	F	5310201	3274	5313475	0.63250
SRR6145059	Burkholderiaceae	119060	F	1155420	9361	1164781	0.13865
SRR6145059	Propionibacteriaceae	31957	F	600976	7210	608186	0.07240
SRR6145059	Micrococcaceae	1268	F	135229	7766	142995	0.01702
SRR6145059	Moraxellaceae	468	F	122945	4492	127437	0.01517
SRR6145059	Staphylococcaceae	90964	F	89255	18389	107644	0.01281
SRR6145059	Enterobacteriaceae	543	F	78587	12626	91213	0.01086
SRR6145059	Corynebacteriaceae	1653	F	77672	1921	79593	0.00947
SRR6145059	Gordoniaceae	85026	F	44283	1630	45913	0.00547
SRR6145059	Rhodobacteraceae	31989	F	41328	2379	43707	0.00520
SRR6145059	Intrasporangiaceae	85021	F	30940	1071	32011	0.00381
SRR6145059	Streptococcaceae	1300	F	30105	1559	31664	0.00377
SRR6145059	Flavobacteriaceae	49546	F	30960	420	31380	0.00374
SRR6145059	Sphingomonadaceae	41297	F	29595	1769	31364	0.00373
SRR6145059	Dermacoccaceae	145357	F	27053	1349	28402	0.00338
SRR6145059	Pseudomonadaceae	135621	F	26719	1025	27744	0.00330
SRR6145059	Mycobacteriaceae	1762	F	27082	318	27400	0.00326
SRR6145059	Microbacteriaceae	85023	F	25722	953	26675	0.00318
SRR6145059	Caulobacteraceae	76892	F	24322	1064	25386	0.00302
SRR6145059	Tsukamurellaceae	85028	F	22647	849	23496	0.00280
SRR6145059	Xanthomonadaceae	32033	F	22406	495	22901	0.00273
SRR6145059	Halomonadaceae	28256	F	20515	202	20717	0.00247
SRR6145059	Streptomycetaceae	2062	F	19166	310	19476	0.00232
SRR6145059	Dietziaceae	85029	F	16089	1496	17585	0.00209
SRR6145059	Actinomycetaceae	2049	F	15699	394	16093	0.00192
SRR6145059	Comamonadaceae	80864	F	14815	700	15515	0.00185
SRR6145059	Bradyrhizobiaceae	41294	F	13809	586	14395	0.00171
SRR6145059	Nocardiaceae	85025	F	11966	2127	14093	0.00168
SRR6145059	Nocardioidaceae	85015	F	12172	247	12419	0.00148
SRR6145059	Oxalobacteraceae	75682	F	8109	4126	12235	0.00146
SRR6145059	Rhizobiaceae	82115	F	9961	1528	11489	0.00137
SRR6145059	Deinococcaceae	183710	F	10960	25	10985	0.00131
SRR6145059	Methylobacteriaceae	119045	F	10142	565	10707	0.00127
SRR6145059	Neisseriaceae	481	F	9093	306	9399	0.00112
SRR6145059	Acetobacteraceae	433	F	7243	1018	8261	0.00098
SRR6145059	Yersiniaceae	1903411	F	7593	579	8172	0.00097
SRR6145059	Brevibacteriaceae	85019	F	6718	265	6983	0.00083
SRR6145059	Pseudonocardiaceae	2070	F	7064	-135	6929	0.00082
SRR6145059	Dermabacteraceae	85020	F	6625	166	6791	0.00081
SRR6145059	Bacillaceae	186817	F	3265	3298	6563	0.00078
SRR6145059	Sphingobacteriaceae	84566	F	6403	65	6468	0.00077
SRR6145059	Pasteurellaceae	712	F	5445	162	5607	0.00067
SRR6145059	Prevotellaceae	171552	F	5092	138	5230	0.00062
SRR6145059	Peptoniphilaceae	1570339	F	4851	376	5227	0.00062
SRR6145059	Erythrobacteraceae	335929	F	4448	495	4943	0.00059
SRR6145059	Micromonosporaceae	28056	F	4846	66	4912	0.00058
SRR6145059	Siphoviridae	10699	F	4160	580	4740	0.00056
SRR6145059	Rhodospirillaceae	41295	F	3757	866	4623	0.00055
SRR6145059	Alcaligenaceae	506	F	3576	790	4366	0.00052
SRR6145059	Aeromonadaceae	84642	F	3878	373	4251	0.00051
SRR6145059	Phyllobacteriaceae	69277	F	4010	212	4222	0.00050
SRR6145059	Veillonellaceae	31977	F	3226	13	3239	0.00039
SRR6145059	Cellulomonadaceae	85016	F	2091	80	2171	0.00026
SRR6145059	Fusobacteriaceae	203492	F	2039	11	2050	0.00024
SRR6145059	Erwiniaceae	1903409	F	1749	139	1888	0.00022
SRR6145059	Hyphomicrobiaceae	45401	F	1693	69	1762	0.00021
SRR6145059	Isosphaeraceae	1763524	F	307	1346	1653	0.00020
SRR6145059	Leptotrichiaceae	1129771	F	1585	14	1599	0.00019
SRR6145059	Promicromonosporaceae	85017	F	1430	52	1482	0.00018
SRR6145059	Geodermatophilaceae	85030	F	1447	38	1485	0.00018
SRR6145059	Bifidobacteriaceae	31953	F	1529	2	1531	0.00018
SRR6145059	Xanthobacteraceae	335928	F	1353	117	1470	0.00017
SRR6145059	Sporichthyaceae	85033	F	1450	16	1466	0.00017
SRR6145059	Lactobacillaceae	33958	F	1338	43	1381	0.00016
SRR6145059	Peptostreptococcaceae	186804	F	1185	74	1259	0.00015
SRR6145059	Aerococcaceae	186827	F	1161	43	1204	0.00014
SRR6145059	Zoogloeaceae	2008794	F	1060	63	1123	0.00013
SRR6145059	Hymenobacteraceae	1853232	F	1062	12	1074	0.00013
SRR6145059	Methylocystaceae	31993	F	532	500	1032	0.00012
SRR6145059	Campylobacteraceae	72294	F	973	4	977	0.00012
SRR6145059	Vibrionaceae	641	F	873	14	887	0.00011
SRR6145059	Thermomonosporaceae	2012	F	897	27	924	0.00011
SRR6145059	Sinobacteraceae	568386	F	895	7	902	0.00011
SRR6145059	Polyangiaceae	49	F	857	26	883	0.00011
SRR6145059	Paenibacillaceae	186822	F	957	-1	956	0.00011
SRR6145059	Nakamurellaceae	85031	F	874	16	890	0.00011
SRR6145059	Microcoleaceae	1892252	F	871	20	891	0.00011
SRR6145059	Frankiaceae	74712	F	858	78	936	0.00011
SRR6145059	Clostridiaceae	31979	F	919	10	929	0.00011
SRR6145059	Streptosporangiaceae	2004	F	814	17	831	0.00010
SRR6145059	Rhodanobacteraceae	1775411	F	831	39	870	0.00010
SRR6145059	Myxococcaceae	31	F	793	33	826	0.00010
SRR6145059	Conexibacteraceae	320583	F	795	7	802	0.00010
SRR6145059	Chromobacteriaceae	1499392	F	801	11	812	0.00010
SRR6145059	Carnobacteriaceae	186828	F	821	14	835	0.00010
SRR6145059	Archangiaceae	39	F	818	34	852	0.00010
SRR6145059	Shewanellaceae	267890	F	691	41	732	0.00009
SRR6145059	Pectobacteriaceae	1903410	F	564	214	778	0.00009
SRR6145059	Cytophagaceae	89373	F	792	6	798	0.00009
SRR6145059	Chitinophagaceae	563835	F	750	0	750	0.00009
SRR6145059	Papillomaviridae	151340	F	670	-18	652	0.00008
SRR6145059	Morganellaceae	1903414	F	608	62	670	0.00008
SRR6145059	Leuconostocaceae	81850	F	673	19	692	0.00008
SRR6145059	Lachnospiraceae	186803	F	607	28	635	0.00008
SRR6145059	Gemmataceae	1914233	F	630	1	631	0.00008
SRR6145059	Tannerellaceae	2005525	F	554	23	577	0.00007
SRR6145059	Rhodocyclaceae	75787	F	501	58	559	0.00007
SRR6145059	Porphyromonadaceae	171551	F	565	29	594	0.00007
SRR6145059	Nocardiopsaceae	83676	F	569	11	580	0.00007
SRR6145059	Chromatiaceae	1046	F	595	5	600	0.00007
SRR6145059	Beutenbergiaceae	125316	F	541	23	564	0.00007
SRR6145059	Spirochaetaceae	137	F	534	4	538	0.00006
SRR6145059	Planctomycetaceae	126	F	423	67	490	0.00006
SRR6145059	Natrialbaceae	1644061	F	516	10	526	0.00006
SRR6145059	Jiangellaceae	1217100	F	468	8	476	0.00006
SRR6145059	Enterococcaceae	81852	F	449	24	473	0.00006
SRR6145059	Ectothiorhodospiraceae	72276	F	462	56	518	0.00006
SRR6145059	Desulfovibrionaceae	194924	F	470	7	477	0.00006
SRR6145059	Chroococcidiopsidaceae	1890528	F	490	16	506	0.00006
SRR6145059	Brachyspiraceae	143786	F	40	481	521	0.00006
SRR6145059	Bogoriellaceae	145358	F	529	15	544	0.00006
SRR6145059	Bacteroidaceae	815	F	475	27	502	0.00006
SRR6145059	Alteromonadaceae	72275	F	522	23	545	0.00006
SRR6145059	Sterolibacteriaceae	2008793	F	243	196	439	0.00005
SRR6145059	Ruaniaceae	1331736	F	272	173	445	0.00005
SRR6145059	Labilitrichaceae	1524216	F	186	193	379	0.00005
SRR6145059	Cellvibrionaceae	1706371	F	427	1	428	0.00005
SRR6145059	Brucellaceae	118882	F	297	85	382	0.00005
SRR6145059	Beijerinckiaceae	45404	F	393	22	415	0.00005
SRR6145059	Aurantimonadaceae	255475	F	415	39	454	0.00005
SRR6145059	Atopobiaceae	1643824	F	429	4	433	0.00005
SRR6145059	Verrucomicrobiaceae	203557	F	303	0	303	0.00004
SRR6145059	Selenomonadaceae	1843491	F	367	2	369	0.00004
SRR6145059	Rubrobacteraceae	84997	F	341	0	341	0.00004
SRR6145059	Opitutaceae	134623	F	334	4	338	0.00004
SRR6145059	Nostocaceae	1162	F	258	47	305	0.00004
SRR6145059	Halorubraceae	1963271	F	231	70	301	0.00004
SRR6145059	Halobacteriaceae	2236	F	244	70	314	0.00004
SRR6145059	Glycomycetaceae	85034	F	116	193	309	0.00004
SRR6145059	Dermatophilaceae	85018	F	294	2	296	0.00004
SRR6145059	Chelatococcaceae	2036754	F	294	29	323	0.00004
SRR6145059	Anaeromyxobacteraceae	1524215	F	295	4	299	0.00004
SRR6145059	Thermaceae	188786	F	240	0	240	0.00003
SRR6145059	Synechococcaceae	1890426	F	259	5	264	0.00003
SRR6145059	Sanguibacteraceae	145360	F	284	8	292	0.00003
SRR6145059	Ruminococcaceae	541000	F	225	24	249	0.00003
SRR6145059	Rhodothermaceae	563843	F	223	0	223	0.00003
SRR6145059	Rhodobiaceae	119043	F	224	30	254	0.00003
SRR6145059	Pseudoalteromonadaceae	267888	F	213	3	216	0.00003
SRR6145059	Planococcaceae	186818	F	247	5	252	0.00003
SRR6145059	Nitrosomonadaceae	206379	F	77	139	216	0.00003
SRR6145059	Mycoplasmataceae	2092	F	211	2	213	0.00003
SRR6145059	Methylococcaceae	403	F	260	0	260	0.00003
SRR6145059	Kineosporiaceae	83778	F	210	6	216	0.00003
SRR6145059	Hyphomonadaceae	69657	F	217	2	219	0.00003
SRR6145059	Haloferacaceae	1644056	F	248	6	254	0.00003
SRR6145059	Haloarculaceae	1963268	F	286	0	286	0.00003
SRR6145059	Geobacteraceae	213422	F	213	8	221	0.00003
SRR6145059	Gemmatimonadaceae	219687	F	253	0	253	0.00003
SRR6145059	Cardiobacteriaceae	868	F	232	3	235	0.00003
SRR6145059	Calotrichaceae	2661849	F	210	5	215	0.00003
SRR6145059	Baekduiaceae	2600303	F	279	2	281	0.00003
SRR6145059	Alcanivoracaceae	224372	F	206	6	212	0.00003
SRR6145059	Sandaracinaceae	1055686	F	195	1	196	0.00002
SRR6145059	Rikenellaceae	171550	F	170	13	183	0.00002
SRR6145059	Rickettsiaceae	775	F	189	0	189	0.00002
SRR6145059	Pirellulaceae	2691357	F	155	0	155	0.00002
SRR6145059	Peptococcaceae	186807	F	106	85	191	0.00002
SRR6145059	Myoviridae	10662	F	172	-11	161	0.00002
SRR6145059	Microbulbiferaceae	1706373	F	129	0	129	0.00002
SRR6145059	Listeriaceae	186820	F	120	33	153	0.00002
SRR6145059	Legionellaceae	444	F	141	-4	137	0.00002
SRR6145059	Lacipirellulaceae	2691359	F	183	0	183	0.00002
SRR6145059	Kofleriaceae	224464	F	138	1	139	0.00002
SRR6145059	Iamiaceae	633392	F	164	2	166	0.00002
SRR6145059	Gallionellaceae	90627	F	144	3	147	0.00002
SRR6145059	Eggerthellaceae	1643826	F	203	4	207	0.00002
SRR6145059	Desulfobacteraceae	213119	F	132	2	134	0.00002
SRR6145059	Coxiellaceae	118968	F	15	146	161	0.00002
SRR6145059	Catenulisporaceae	414877	F	193	3	196	0.00002
SRR6145059	Bdellovibrionaceae	213483	F	132	0	132	0.00002
SRR6145059	Acidobacteriaceae	204434	F	172	0	172	0.00002
SRR6145059	Wenzhouxiangellaceae	1676141	F	43	0	43	0.00001
SRR6145059	Vulgatibacteraceae	1524213	F	61	0	61	0.00001
SRR6145059	Vicinamibacteraceae	2211325	F	107	11	118	0.00001
SRR6145059	Trueperaceae	332247	F	88	0	88	0.00001
SRR6145059	Thiobacillaceae	2008790	F	88	6	94	0.00001
SRR6145059	Thermoproteaceae	2267	F	45	0	45	0.00001
SRR6145059	Thermococcaceae	2259	F	57	0	57	0.00001
SRR6145059	Thermoanaerobacteraceae	186814	F	66	0	66	0.00001
SRR6145059	Thermoactinomycetaceae	186824	F	43	0	43	0.00001
SRR6145059	Synergistaceae	649777	F	59	0	59	0.00001
SRR6145059	Sulfolobaceae	118883	F	52	0	52	0.00001
SRR6145059	Steroidobacteraceae	2689614	F	43	2	45	0.00001
SRR6145059	Spiroplasmataceae	2131	F	73	-1	72	0.00001
SRR6145059	Sphaerobacteraceae	85002	F	51	0	51	0.00001
SRR6145059	Solibacteraceae	332161	F	52	0	52	0.00001
SRR6145059	Segniliparaceae	316606	F	62	0	62	0.00001
SRR6145059	Scytonemataceae	1182	F	205	-124	81	0.00001
SRR6145059	Salinisphaeraceae	742031	F	45	0	45	0.00001
SRR6145059	Prolixibacteraceae	1471398	F	65	0	65	0.00001
SRR6145059	Podoviridae	10744	F	68	0	68	0.00001
SRR6145059	Piscirickettsiaceae	135616	F	86	1	87	0.00001
SRR6145059	Phycisphaeraceae	666507	F	63	24	87	0.00001
SRR6145059	Pelagibacteraceae	1655514	F	47	6	53	0.00001
SRR6145059	Odoribacteraceae	1853231	F	31	30	61	0.00001
SRR6145059	Oceanospirillaceae	135620	F	107	0	107	0.00001
SRR6145059	Nitrospiraceae	189779	F	124	0	124	0.00001
SRR6145059	Nimaviridae	196937	F	108	0	108	0.00001
SRR6145059	Nannocystaceae	224463	F	118	1	119	0.00001
SRR6145059	Muribaculaceae	2005473	F	50	-7	43	0.00001
SRR6145059	Methylophilaceae	32011	F	95	1	96	0.00001
SRR6145059	Methanosarcinaceae	2206	F	76	-2	74	0.00001
SRR6145059	Limnochordaceae	1676650	F	32	12	44	0.00001
SRR6145059	Lichenihabitantaceae	2723775	F	79	2	81	0.00001
SRR6145059	Leptolyngbyaceae	1890438	F	81	4	85	0.00001
SRR6145059	Kiritimatiellaceae	1921783	F	15	35	50	0.00001
SRR6145059	Immundisolibacteraceae	1934946	F	65	1	66	0.00001
SRR6145059	Ilumatobacteraceae	2448023	F	96	1	97	0.00001
SRR6145059	Hungateiclostridiaceae	2304686	F	74	-3	71	0.00001
SRR6145059	Herelleviridae	2560065	F	126	-9	117	0.00001
SRR6145059	Helicobacteraceae	72293	F	101	9	110	0.00001
SRR6145059	Hapalosiphonaceae	1892263	F	28	24	52	0.00001
SRR6145059	Halieaceae	1706372	F	108	0	108	0.00001
SRR6145059	Hafniaceae	1903412	F	74	3	77	0.00001
SRR6145059	Gottschalkiaceae	2042895	F	7	112	119	0.00001
SRR6145059	Francisellaceae	34064	F	63	0	63	0.00001
SRR6145059	Flammeovirgaceae	200667	F	66	39	105	0.00001
SRR6145059	Euzebyaceae	908622	F	95	0	95	0.00001
SRR6145059	Eubacteriaceae	186806	F	53	1	54	0.00001
SRR6145059	Erysipelotrichaceae	128827	F	97	5	102	0.00001
SRR6145059	Emcibacteraceae	2066491	F	44	0	44	0.00001
SRR6145059	Egicoccaceae	1755824	F	110	0	110	0.00001
SRR6145059	Egibacteraceae	1747769	F	62	21	83	0.00001
SRR6145059	Desulfuromonadaceae	213421	F	83	3	86	0.00001
SRR6145059	Desulfobulbaceae	213121	F	80	1	81	0.00001
SRR6145059	Cyclobacteriaceae	563798	F	105	3	108	0.00001
SRR6145059	Coriobacteriaceae	84107	F	72	6	78	0.00001
SRR6145059	Colwelliaceae	267889	F	69	0	69	0.00001
SRR6145059	Cohaesibacteraceae	655351	F	116	4	120	0.00001
SRR6145059	Chroococcaceae	1890464	F	66	2	68	0.00001
SRR6145059	Chlorobiaceae	191412	F	90	0	90	0.00001
SRR6145059	Casimicrobiaceae	2705999	F	40	17	57	0.00001
SRR6145059	Bradymonadaceae	1779135	F	22	63	85	0.00001
SRR6145059	Bartonellaceae	772	F	70	2	72	0.00001
SRR6145059	Bacteriovoracaceae	263369	F	67	0	67	0.00001
SRR6145059	Azonexaceae	2008795	F	63	0	63	0.00001
SRR6145059	Ardenticatenaceae	1382930	F	57	0	57	0.00001
SRR6145059	Aphanizomenonaceae	1892259	F	44	17	61	0.00001
SRR6145059	Anaplasmataceae	942	F	45	8	53	0.00001
SRR6145059	Anaerolineaceae	292628	F	43	0	43	0.00001
SRR6145059	Alicyclobacillaceae	186823	F	62	0	62	0.00001
SRR6145059	Akkermansiaceae	1647988	F	25	59	84	0.00001
SRR6145059	Actinopolysporaceae	622451	F	73	0	73	0.00001
SRR6145059	Acidithiobacillaceae	225058	F	51	0	51	0.00001
SRR6145059	Acidiferrobacteraceae	1692041	F	109	0	109	0.00001
SRR6145059	Acholeplasmataceae	2146	F	35	12	47	0.00001
SRR6145059	Woeseiaceae	1738654	F	16	0	16	0.00000
SRR6145059	Waddliaceae	92714	F	3	0	3	0.00000
SRR6145059	Vallitaleaceae	2603322	F	4	0	4	0.00000
SRR6145059	Tristromaviridae	2022738	F	1	0	1	0.00000
SRR6145059	Tospoviridae	1980419	F	3	0	3	0.00000
SRR6145059	Tolypothrichaceae	119859	F	12	5	17	0.00000
SRR6145059	Togaviridae	11018	F	2	0	2	0.00000
SRR6145059	Tissierellaceae	1737406	F	27	0	27	0.00000
SRR6145059	Thiotrichaceae	135617	F	12	0	12	0.00000
SRR6145059	Thioalkalispiraceae	1096778	F	33	3	36	0.00000
SRR6145059	Thioalkalibacteraceae	2035710	F	34	1	35	0.00000
SRR6145059	Thermotogaceae	188709	F	17	0	17	0.00000
SRR6145059	Thermomicrobiaceae	189777	F	11	0	11	0.00000
SRR6145059	Thermoguttaceae	2691358	F	10	0	10	0.00000
SRR6145059	Thermofilaceae	114378	F	6	0	6	0.00000
SRR6145059	Thermodesulfobiaceae	227387	F	6	0	6	0.00000
SRR6145059	Thermodesulfobacteriaceae	188711	F	12	0	12	0.00000
SRR6145059	Thermoanaerobacterales Family IV. Incertae Sedis	543372	F	4	3	7	0.00000
SRR6145059	Thermoanaerobacterales Family III. Incertae Sedis	543371	F	52	0	52	0.00001
SRR6145059	Tepidiformaceae	2682227	F	39	0	39	0.00000
SRR6145059	Syntrophomonadaceae	68298	F	6	0	6	0.00000
SRR6145059	Syntrophobacteraceae	213465	F	27	1	28	0.00000
SRR6145059	Syntrophaceae	213468	F	16	0	16	0.00000
SRR6145059	Symbiobacteriaceae	543349	F	30	0	30	0.00000
SRR6145059	Sutterellaceae	995019	F	37	0	37	0.00000
SRR6145059	Succinivibrionaceae	83763	F	7	0	7	0.00000
SRR6145059	Sporomusaceae	1843490	F	24	0	24	0.00000
SRR6145059	Sporolactobacillaceae	186821	F	9	0	9	0.00000
SRR6145059	Spongiibacteraceae	1706375	F	29	0	29	0.00000
SRR6145059	Simkaniaceae	92712	F	4	0	4	0.00000
SRR6145059	Silvanigrellaceae	2024974	F	6	6	12	0.00000
SRR6145059	Sedimentisphaeraceae	2483367	F	10	1	11	0.00000
SRR6145059	Saprospiraceae	89374	F	5	0	5	0.00000
SRR6145059	Salinivirgaceae	1970190	F	10	0	10	0.00000
SRR6145059	Saccharospirillaceae	255527	F	29	0	29	0.00000
SRR6145059	Rudiviridae	157897	F	1	-1	0	0.00000
SRR6145059	Roseiflexaceae	1508635	F	40	1	41	0.00000
SRR6145059	Rivulariaceae	1185	F	17	9	26	0.00000
SRR6145059	Rhabdoviridae	11270	F	8	0	8	0.00000
SRR6145059	Retroviridae	11632	F	8	-1	7	0.00000
SRR6145059	Pyrodictiaceae	2307	F	4	0	4	0.00000
SRR6145059	Puniceicoccaceae	415002	F	10	0	10	0.00000
SRR6145059	Psychromonadaceae	267894	F	18	0	18	0.00000
SRR6145059	Pseudanabaenaceae	1890436	F	21	0	21	0.00000
SRR6145059	Prochlorotrichaceae	2303730	F	9	0	9	0.00000
SRR6145059	Prochloraceae	1213	F	34	0	34	0.00000
SRR6145059	Poxviridae	10240	F	12	0	12	0.00000
SRR6145059	Potyviridae	39729	F	2	0	2	0.00000
SRR6145059	Polyomaviridae	151341	F	17	0	17	0.00000
SRR6145059	Pleolipoviridae	1911603	F	2	0	2	0.00000
SRR6145059	Picrophilaceae	46630	F	2	1	3	0.00000
SRR6145059	Picornaviridae	12058	F	1	0	1	0.00000
SRR6145059	Phycodnaviridae	10501	F	15	0	15	0.00000
SRR6145059	Phenuiviridae	1980418	F	1	0	1	0.00000
SRR6145059	Petrotogaceae	1643949	F	13	0	13	0.00000
SRR6145059	Parvularculaceae	255474	F	16	0	16	0.00000
SRR6145059	Parachlamydiaceae	92713	F	12	0	12	0.00000
SRR6145059	Paludibacteraceae	2005523	F	7	0	7	0.00000
SRR6145059	Oscillospiraceae	216572	F	29	3	32	0.00000
SRR6145059	Oscillatoriaceae	1892254	F	30	0	30	0.00000
SRR6145059	Orbaceae	1240483	F	15	0	15	0.00000
SRR6145059	Oleiphilaceae	191033	F	11	0	11	0.00000
SRR6145059	Oculatellaceae	2303507	F	13	2	15	0.00000
SRR6145059	Nitrososphaeraceae	1033997	F	13	18	31	0.00000
SRR6145059	Nitrosopumilaceae	338190	F	17	0	17	0.00000
SRR6145059	Nautiliaceae	224467	F	20	5	25	0.00000
SRR6145059	Natranaerobiaceae	485255	F	4	0	4	0.00000
SRR6145059	Nairoviridae	1980415	F	1	0	1	0.00000
SRR6145059	Moritellaceae	267891	F	20	0	20	0.00000
SRR6145059	Mimiviridae	549779	F	8	0	8	0.00000
SRR6145059	Microviridae	10841	F	29	0	29	0.00000
SRR6145059	Microcystaceae	1890449	F	14	0	14	0.00000
SRR6145059	Methylacidiphilaceae	717964	F	12	0	12	0.00000
SRR6145059	Methanotrichaceae	143067	F	12	0	12	0.00000
SRR6145059	Methanothermaceae	2178	F	5	0	5	0.00000
SRR6145059	Methanospirillaceae	196137	F	3	0	3	0.00000
SRR6145059	Methanoregulaceae	1198451	F	12	0	12	0.00000
SRR6145059	Methanopyraceae	183713	F	11	0	11	0.00000
SRR6145059	Methanomicrobiaceae	2194	F	42	0	42	0.00000
SRR6145059	Methanomassiliicoccaceae	1577788	F	10	0	10	0.00000
SRR6145059	Methanocorpusculaceae	88404	F	1	0	1	0.00000
SRR6145059	Methanococcaceae	2183	F	26	0	26	0.00000
SRR6145059	Methanocellaceae	570265	F	18	2	20	0.00000
SRR6145059	Methanocaldococcaceae	196117	F	16	3	19	0.00000
SRR6145059	Methanobacteriaceae	2159	F	41	0	41	0.00000
SRR6145059	Mesoaciditogaceae	1769717	F	2	0	2	0.00000
SRR6145059	Merismopediaceae	1890428	F	14	0	14	0.00000
SRR6145059	Melioribacteraceae	1334117	F	6	0	6	0.00000
SRR6145059	Marseilleviridae	944644	F	3	0	3	0.00000
SRR6145059	Marnaviridae	324901	F	1	0	1	0.00000
SRR6145059	Mariprofundaceae	580372	F	10	0	10	0.00000
SRR6145059	Marinilabiliaceae	558415	F	17	0	17	0.00000
SRR6145059	Marinifilaceae	1573805	F	7	0	7	0.00000
SRR6145059	Malacoherpesviridae	548685	F	1	0	1	0.00000
SRR6145059	Magnetococcaceae	1191479	F	7	0	7	0.00000
SRR6145059	Litoricolaceae	449732	F	8	6	14	0.00000
SRR6145059	Leptospiraceae	170	F	50	-10	40	0.00000
SRR6145059	Ktedonosporobacteraceae	2692416	F	12	0	12	0.00000
SRR6145059	Kosmotogaceae	1643948	F	12	0	12	0.00000
SRR6145059	Kangiellaceae	1920240	F	27	0	27	0.00000
SRR6145059	Jonesiaceae	85022	F	30	0	30	0.00000
SRR6145059	Iridoviridae	10486	F	4	0	4	0.00000
SRR6145059	Ignavibacteriaceae	795749	F	4	9	13	0.00000
SRR6145059	Idiomarinaceae	267893	F	31	-11	20	0.00000
SRR6145059	Ichthyobacteriaceae	1755828	F	6	0	6	0.00000
SRR6145059	Hytrosaviridae	1285590	F	1	1	2	0.00000
SRR6145059	Hyellaceae	1890500	F	3	0	3	0.00000
SRR6145059	Hydrogenothermaceae	224027	F	6	4	10	0.00000
SRR6145059	Hydrogenophilaceae	206349	F	20	0	20	0.00000
SRR6145059	Holosporaceae	44746	F	13	0	13	0.00000
SRR6145059	Herpesviridae	10292	F	19	0	19	0.00000
SRR6145059	Heliobacteriaceae	31984	F	14	0	14	0.00000
SRR6145059	Halothiobacillaceae	255526	F	28	0	28	0.00000
SRR6145059	Halobacteroidaceae	53434	F	10	5	15	0.00000
SRR6145059	Halobacteriovoraceae	1652132	F	17	0	17	0.00000
SRR6145059	Haliscomenobacteraceae	1937961	F	21	0	21	0.00000
SRR6145059	Halanaerobiaceae	972	F	26	0	26	0.00000
SRR6145059	Hahellaceae	224379	F	27	0	27	0.00000
SRR6145059	Granulosicoccaceae	449719	F	28	0	28	0.00000
SRR6145059	Gomontiellaceae	1892255	F	13	7	20	0.00000
SRR6145059	Gloeomargaritaceae	1955043	F	5	4	9	0.00000
SRR6145059	Gloeobacteraceae	1890422	F	42	0	42	0.00000
SRR6145059	Geminiviridae	10811	F	1	-1	0	0.00000
SRR6145059	Fimbriimonadaceae	1663426	F	25	15	40	0.00000
SRR6145059	Fibrobacteraceae	204431	F	7	8	15	0.00000
SRR6145059	Fervidobacteriaceae	1643950	F	30	0	30	0.00000
SRR6145059	Fervidicoccaceae	685949	F	1	0	1	0.00000
SRR6145059	Ferroplasmaceae	90142	F	1	11	12	0.00000
SRR6145059	Ferrimonadaceae	267892	F	24	0	24	0.00000
SRR6145059	Entomoplasmataceae	33925	F	27	0	27	0.00000
SRR6145059	Endozoicomonadaceae	2066474	F	10	0	10	0.00000
SRR6145059	Endomicrobiaceae	1783343	F	4	0	4	0.00000
SRR6145059	Elusimicrobiaceae	641876	F	2	1	3	0.00000
SRR6145059	Dysgonamonadaceae	2005520	F	18	0	18	0.00000
SRR6145059	Drexlerviridae	2731691	F	1	0	1	0.00000
SRR6145059	Dictyoglomaceae	203488	F	7	0	7	0.00000
SRR6145059	Dicistroviridae	232795	F	1	0	1	0.00000
SRR6145059	Desulfurococcaceae	2272	F	14	1	15	0.00000
SRR6145059	Desulfurobacteriaceae	558314	F	2	0	2	0.00000
SRR6145059	Desulfurellaceae	117942	F	5	0	5	0.00000
SRR6145059	Desulfomicrobiaceae	213116	F	30	0	30	0.00000
SRR6145059	Desulfohalobiaceae	213117	F	9	0	9	0.00000
SRR6145059	Desulfarculaceae	453228	F	34	4	38	0.00000
SRR6145059	Dermocarpellaceae	1890498	F	16	0	16	0.00000
SRR6145059	Demerecviridae	2731690	F	3	0	3	0.00000
SRR6145059	Dehalococcoidaceae	1202464	F	5	0	5	0.00000
SRR6145059	Deferribacteraceae	191394	F	26	0	26	0.00000
SRR6145059	Cyanothecaceae	1892249	F	19	0	19	0.00000
SRR6145059	Cyanobacteriaceae	1890452	F	8	0	8	0.00000
SRR6145059	Cuniculiplasmataceae	1747776	F	3	0	3	0.00000
SRR6145059	Cryomorphaceae	246874	F	4	0	4	0.00000
SRR6145059	Crocinitomicaceae	1853230	F	20	11	31	0.00000
SRR6145059	Coleofasciculaceae	1892251	F	21	0	21	0.00000
SRR6145059	Clostridiales Family XVII. Incertae Sedis	539000	F	103	0	103	0.00001
SRR6145059	Clostridiales Family XVI. Incertae Sedis	543347	F	1	0	1	0.00000
SRR6145059	Clostridiales Family XIII. Incertae Sedis	543314	F	364	8	372	0.00004
SRR6145059	Chthonomonadaceae	1077264	F	7	4	11	0.00000
SRR6145059	Chrysiogenaceae	189770	F	7	0	7	0.00000
SRR6145059	Christensenellaceae	990719	F	15	0	15	0.00000
SRR6145059	Chloroflexaceae	1106	F	19	-12	7	0.00000
SRR6145059	Chlamydiaceae	809	F	17	0	17	0.00000
SRR6145059	Chamaesiphonaceae	1890431	F	11	0	11	0.00000
SRR6145059	Caulimoviridae	186534	F	2	2	4	0.00000
SRR6145059	Calditrichaceae	1962854	F	8	0	8	0.00000
SRR6145059	Caldisphaeraceae	255472	F	5	0	5	0.00000
SRR6145059	Caldilineaceae	475964	F	21	12	33	0.00000
SRR6145059	Caedimonadaceae	2100208	F	5	0	5	0.00000
SRR6145059	Budviciaceae	1903416	F	10	0	10	0.00000
SRR6145059	Borreliaceae	1643685	F	40	-1	39	0.00000
SRR6145059	Blattabacteriaceae	39782	F	31	0	31	0.00000
SRR6145059	Betaflexiviridae	675068	F	1	0	1	0.00000
SRR6145059	Bernardetiaceae	1937968	F	14	0	14	0.00000
SRR6145059	Barnesiellaceae	2005519	F	6	0	6	0.00000
SRR6145059	Baculoviridae	10442	F	15	0	15	0.00000
SRR6145059	Autographiviridae	2731643	F	27	-2	25	0.00000
SRR6145059	Archaeoglobaceae	2232	F	8	-1	7	0.00000
SRR6145059	Aquificaceae	64898	F	17	-2	15	0.00000
SRR6145059	Aphanothecaceae	1890450	F	41	1	42	0.00000
SRR6145059	Anaerohalosphaeraceae	2690158	F	6	0	6	0.00000
SRR6145059	Amoebophilaceae	1501348	F	7	0	7	0.00000
SRR6145059	Alloherpesviridae	548682	F	4	0	4	0.00000
SRR6145059	Adenoviridae	10508	F	2	33	35	0.00000
SRR6145059	Ackermannviridae	2169529	F	7	-4	3	0.00000
SRR6145059	Acidothermaceae	85032	F	41	0	41	0.00000
SRR6145059	Acidimicrobiaceae	84994	F	32	0	32	0.00000
SRR6145059	Acidilobaceae	871007	F	6	0	6	0.00000
SRR6145059	Acidaminococcaceae	909930	F	23	0	23	0.00000
SRR6145059	Acaryochloridaceae	1890429	F	8	0	8	0.00000
