sample	name	taxonomy_id	taxonomy_lvl	kraken_assigned_reads	added_reads	new_est_reads	fraction_total_reads
SRR6145059	Candidatus Promineofilum	1988031	G	57	23	80	0.00001
SRR6145059	Candidatus Accumulibacter	327159	G	62	0	62	0.00001
SRR6145059	Candidatus Solibacter	332162	G	52	0	52	0.00001
SRR6145059	Candidatus Pelagibacter	198251	G	31	16	47	0.00001
SRR6145059	Candidatus Saccharimonas	1331051	G	28	17	45	0.00001
SRR6145059	Candidatus Planktophila	622681	G	43	2	45	0.00001
SRR6145059	Candidatus Phaeomarinobacter	1541445	G	22	17	39	0.00000
SRR6145059	Candidatus Desulforudis	471826	G	13	12	25	0.00000
SRR6145059	Candidatus Methylospira	1808977	G	19	0	19	0.00000
SRR6145059	Candidatus Koribacter	658061	G	19	0	19	0.00000
SRR6145059	Candidatus Aquiluna	529881	G	19	0	19	0.00000
SRR6145059	Candidatus Phytoplasma	33926	G	9	8	17	0.00000
SRR6145059	Candidatus Symbiobacter	1436289	G	16	0	16	0.00000
SRR6145059	Candidatus Bipolaricaulis	2250122	G	14	0	14	0.00000
SRR6145059	Candidatus Kinetoplastibacterium	33055	G	21	-8	13	0.00000
SRR6145059	Candidatus Blochmannia	203804	G	13	0	13	0.00000
SRR6145059	Candidatus Reidiella	2738850	G	10	0	10	0.00000
SRR6145059	Candidatus Nanopelagicus	2039639	G	10	0	10	0.00000
SRR6145059	Candidatus Methylopumilus	1679002	G	10	0	10	0.00000
SRR6145059	Candidatus Azobacteroides	511434	G	10	0	10	0.00000
SRR6145059	Candidatus Arthromitus	49082	G	10	0	10	0.00000
SRR6145059	Candidatus Protochlamydia	282132	G	9	0	9	0.00000
SRR6145059	Candidatus Hamiltonella	568987	G	5	4	9	0.00000
SRR6145059	Candidatus Cyclonatronum	2489367	G	9	0	9	0.00000
SRR6145059	Candidatus Sulcia	336809	G	8	0	8	0.00000
SRR6145059	Candidatus Cytomitobacter	2601574	G	8	0	8	0.00000
SRR6145059	Candidatus Thioglobus	655184	G	7	0	7	0.00000
SRR6145059	Candidatus Nitrotoga	453161	G	7	0	7	0.00000
SRR6145059	Candidatus Endolissoclinum	1263978	G	7	0	7	0.00000
SRR6145059	Candidatus Sneabacter	2601645	G	6	0	6	0.00000
SRR6145059	Candidatus Ruthia	1541743	G	4	2	6	0.00000
SRR6145059	Candidatus Nitrosoglobus	1980513	G	6	0	6	0.00000
SRR6145059	Candidatus Fonsibacter	2045213	G	6	0	6	0.00000
SRR6145059	Candidatus Babela	1551504	G	6	0	6	0.00000
SRR6145059	Candidatus Prometheoarchaeum	2732160	G	5	0	5	0.00000
SRR6145059	Candidatus Nucleicultrix	1509243	G	5	0	5	0.00000
SRR6145059	Candidatus Nitrosocosmicus	1826864	G	5	0	5	0.00000
SRR6145059	Candidatus Nesciobacter	2601651	G	3	2	5	0.00000
SRR6145059	Candidatus Mancarchaeum	2490204	G	4	1	5	0.00000
SRR6145059	Candidatus Kuenenia	380738	G	5	0	5	0.00000
SRR6145059	Candidatus Puniceispirillum	767891	G	4	0	4	0.00000
SRR6145059	Candidatus Portiera	235572	G	4	0	4	0.00000
SRR6145059	Candidatus Paracaedibacter	1521255	G	4	0	4	0.00000
SRR6145059	Candidatus Izimaplasma	1912503	G	4	0	4	0.00000
SRR6145059	Candidatus Cardinium	273135	G	4	0	4	0.00000
SRR6145059	Candidatus Atelocyanobacterium	1453359	G	4	0	4	0.00000
SRR6145059	Candidatus Walczuchella	1940138	G	2	1	3	0.00000
SRR6145059	Candidatus Nitrosomarinus	1993653	G	3	0	3	0.00000
SRR6145059	Candidatus Methanoplasma	1607807	G	3	0	3	0.00000
SRR6145059	Candidatus Hoaglandella	1906659	G	2	1	3	0.00000
SRR6145059	Candidatus Fukatsuia	1927833	G	3	0	3	0.00000
SRR6145059	Candidatus Amoebophilus	281119	G	3	0	3	0.00000
SRR6145059	Candidatus Purcelliella	472825	G	2	0	2	0.00000
SRR6145059	Candidatus Profftella	1381133	G	2	0	2	0.00000
SRR6145059	Candidatus Phycorickettsia	2115980	G	2	0	2	0.00000
SRR6145059	Candidatus Nitrosotalea	1078904	G	2	0	2	0.00000
SRR6145059	Candidatus Nitrosopelagicus	1593364	G	2	0	2	0.00000
SRR6145059	Candidatus Nardonella	204619	G	2	0	2	0.00000
SRR6145059	Candidatus Korarchaeum	498845	G	2	0	2	0.00000
SRR6145059	Candidatus Ishikawaella	409304	G	2	0	2	0.00000
SRR6145059	Candidatus Hodgkinia	573657	G	2	0	2	0.00000
SRR6145059	Candidatus Fokinia	1802983	G	2	0	2	0.00000
SRR6145059	Candidatus Carsonella	114185	G	2	0	2	0.00000
SRR6145059	Candidatus Vesicomyosocius	2732587	G	1	0	1	0.00000
SRR6145059	Candidatus Tachikawaea	1682492	G	1	0	1	0.00000
SRR6145059	Candidatus Syntrophocurvum	2293313	G	1	0	1	0.00000
SRR6145059	Candidatus Riesia	401618	G	1	0	1	0.00000
SRR6145059	Candidatus Mikella	1906660	G	1	0	1	0.00000
SRR6145059	Candidatus Midichloria	411566	G	1	0	1	0.00000
SRR6145059	Candidatus Methanomethylophilus	1291539	G	1	0	1	0.00000
SRR6145059	Candidatus Doolittlea	1906657	G	1	0	1	0.00000
SRR6145059	Candidatus Desulfofervidus	1902583	G	1	0	1	0.00000
SRR6145059	Candidatus Deianiraea	2603321	G	1	0	1	0.00000
SRR6145059	Candidatus Cloacimonas	456826	G	1	0	1	0.00000
SRR6145059	Homo	9605	G	5310201	3274	5313475	0.63250
SRR6145059	Paraburkholderia	1822464	G	1092240	27354	1119594	0.13327
SRR6145059	Cutibacterium	1912216	G	595160	8179	603339	0.07182
SRR6145059	Micrococcus	1269	G	109025	7956	116981	0.01393
SRR6145059	Staphylococcus	1279	G	88633	18503	107136	0.01275
SRR6145059	Moraxella	475	G	77920	1894	79814	0.00950
SRR6145059	Corynebacterium	1716	G	77107	2486	79593	0.00947
SRR6145059	Klebsiella	570	G	57153	9759	66912	0.00796
SRR6145059	Acinetobacter	469	G	43736	3445	47181	0.00562
SRR6145059	Gordonia	2053	G	44283	1630	45913	0.00547
SRR6145059	Burkholderia	32008	G	34839	2623	37462	0.00446
SRR6145059	Streptococcus	1301	G	29622	1499	31121	0.00370
SRR6145059	Paracoccus	265	G	28375	2712	31087	0.00370
SRR6145059	Pseudomonas	286	G	26386	1191	27577	0.00328
SRR6145059	Janibacter	53457	G	25251	1315	26566	0.00316
SRR6145059	Chryseobacterium	59732	G	24459	1184	25643	0.00305
SRR6145059	Tsukamurella	2060	G	22647	849	23496	0.00280
SRR6145059	Brevundimonas	41275	G	19978	1305	21283	0.00253
SRR6145059	Halomonas	2745	G	20108	253	20361	0.00242
SRR6145059	Streptomyces	1883	G	18321	541	18862	0.00225
SRR6145059	Microbacterium	33882	G	17036	1303	18339	0.00218
SRR6145059	Dietzia	37914	G	16089	1496	17585	0.00209
SRR6145059	Dermacoccus	57495	G	16028	664	16692	0.00199
SRR6145059	Kocuria	57493	G	15027	637	15664	0.00186
SRR6145059	Sphingomonas	13687	G	13757	1457	15214	0.00181
SRR6145059	Mycolicibacterium	1866885	G	13761	1460	15221	0.00181
SRR6145059	Actinomyces	1654	G	13118	370	13488	0.00161
SRR6145059	Kytococcus	57499	G	10543	693	11236	0.00134
SRR6145059	Deinococcus	1298	G	10960	25	10985	0.00131
SRR6145059	Mycobacterium	1763	G	7106	2209	9315	0.00111
SRR6145059	Neisseria	482	G	8543	412	8955	0.00107
SRR6145059	Rhodococcus	1827	G	8166	384	8550	0.00102
SRR6145059	Bosea	85413	G	7981	461	8442	0.00100
SRR6145059	Nocardioides	1839	G	7891	389	8280	0.00099
SRR6145059	Serratia	613	G	7196	584	7780	0.00093
SRR6145059	Methylobacterium	407	G	7203	646	7849	0.00093
SRR6145059	Escherichia	561	G	422	7405	7827	0.00093
SRR6145059	Stenotrophomonas	40323	G	6526	880	7406	0.00088
SRR6145059	Brevibacterium	1696	G	6718	265	6983	0.00083
SRR6145059	Sphingobium	165695	G	5108	1758	6866	0.00082
SRR6145059	Roseomonas	125216	G	5797	1011	6808	0.00081
SRR6145059	Rothia	32207	G	6280	104	6384	0.00076
SRR6145059	Rhizobium	379	G	4033	2294	6327	0.00075
SRR6145059	Lysobacter	68	G	5667	315	5982	0.00071
SRR6145059	Citrobacter	544	G	5318	665	5983	0.00071
SRR6145059	Sphingobacterium	28453	G	5805	85	5890	0.00070
SRR6145059	Brachybacterium	43668	G	5794	100	5894	0.00070
SRR6145059	Enterobacter	547	G	4736	997	5733	0.00068
SRR6145059	Prevotella	838	G	5055	142	5197	0.00062
SRR6145059	Sphingopyxis	165697	G	4208	639	4847	0.00058
SRR6145059	Haemophilus	724	G	4328	215	4543	0.00054
SRR6145059	Bradyrhizobium	374	G	4127	320	4447	0.00053
SRR6145059	Aeromonas	642	G	3785	378	4163	0.00050
SRR6145059	Pahexavirus	1982251	G	3537	504	4041	0.00048
SRR6145059	Nocardia	1817	G	3571	154	3725	0.00044
SRR6145059	Acidovorax	12916	G	2783	841	3624	0.00043
SRR6145059	Xanthomonas	338	G	3125	308	3433	0.00041
SRR6145059	Finegoldia	150022	G	3171	312	3483	0.00041
SRR6145059	Mesorhizobium	68287	G	3080	243	3323	0.00040
SRR6145059	Massilia	149698	G	3175	170	3345	0.00040
SRR6145059	Luteimonas	83614	G	3066	234	3300	0.00039
SRR6145059	Cupriavidus	106589	G	3108	174	3282	0.00039
SRR6145059	Veillonella	29465	G	3161	12	3173	0.00038
SRR6145059	Janthinobacterium	29580	G	2930	132	3062	0.00036
SRR6145059	Bacillus	1386	G	2410	645	3055	0.00036
SRR6145059	Caulobacter	75	G	2816	106	2922	0.00035
SRR6145059	Micromonospora	1873	G	2559	187	2746	0.00033
SRR6145059	Rhodobacter	1060	G	1736	919	2655	0.00032
SRR6145059	Variovorax	34072	G	2469	107	2576	0.00031
SRR6145059	Pseudonocardia	1847	G	2203	88	2291	0.00027
SRR6145059	Mycobacteroides	670516	G	1264	1012	2276	0.00027
SRR6145059	Comamonas	283	G	2080	151	2231	0.00027
SRR6145059	Gemella	1378	G	2139	64	2203	0.00026
SRR6145059	Agrobacterium	357	G	1797	382	2179	0.00026
SRR6145059	Methylorubrum	2282523	G	1572	524	2096	0.00025
SRR6145059	Novosphingobium	165696	G	1714	300	2014	0.00024
SRR6145059	Fusobacterium	848	G	2031	11	2042	0.00024
SRR6145059	Arthrobacter	1663	G	1964	69	2033	0.00024
SRR6145059	Serinicoccus	265976	G	1735	131	1866	0.00022
SRR6145059	Schaalia	2529408	G	1783	45	1828	0.00022
SRR6145059	Azospirillum	191	G	1753	103	1856	0.00022
SRR6145059	Cellulomonas	1707	G	1716	85	1801	0.00021
SRR6145059	Achromobacter	222	G	1548	192	1740	0.00021
SRR6145059	Lawsonella	1847725	G	1642	27	1669	0.00020
SRR6145059	Leptotrichia	32067	G	1552	16	1568	0.00019
SRR6145059	Erythrobacter	1041	G	1310	257	1567	0.00019
SRR6145059	Altererythrobacter	361177	G	1358	137	1495	0.00018
SRR6145059	Pseudoxanthomonas	83618	G	1236	193	1429	0.00017
SRR6145059	Hydrogenophaga	47420	G	1277	120	1397	0.00017
SRR6145059	Epidermidibacterium	2078948	G	1450	16	1466	0.00017
SRR6145059	Amycolatopsis	1813	G	1580	-144	1436	0.00017
SRR6145059	Sinorhizobium	28105	G	828	489	1317	0.00016
SRR6145059	Ornithinimicrobium	125287	G	1248	110	1358	0.00016
SRR6145059	Lactobacillus	1578	G	1296	46	1342	0.00016
SRR6145059	Isosphaera	127	G	20	1340	1360	0.00016
SRR6145059	Capnocytophaga	1016	G	1336	13	1349	0.00016
SRR6145059	Raoultella	160674	G	1138	125	1263	0.00015
SRR6145059	Ralstonia	48736	G	1159	112	1271	0.00015
SRR6145059	Pantoea	53335	G	1180	120	1300	0.00015
SRR6145059	Lautropia	47670	G	1259	24	1283	0.00015
SRR6145059	Bordetella	517	G	1176	94	1270	0.00015
SRR6145059	Aeromicrobium	2040	G	1253	48	1301	0.00015
SRR6145059	Actinoplanes	1865	G	1247	28	1275	0.00015
SRR6145059	Tessaracoccus	72763	G	1099	52	1151	0.00014
SRR6145059	Sulfitobacter	60136	G	539	601	1140	0.00014
SRR6145059	Flavobacterium	237	G	1133	8	1141	0.00014
SRR6145059	Delftia	80865	G	1044	147	1191	0.00014
SRR6145059	Thermomonas	141948	G	1003	123	1126	0.00013
SRR6145059	Salmonella	590	G	226	905	1131	0.00013
SRR6145059	Porphyrobacter	1111	G	919	160	1079	0.00013
SRR6145059	Pandoraea	93217	G	1037	19	1056	0.00013
SRR6145059	Rathayibacter	33886	G	959	52	1011	0.00012
SRR6145059	Phycicoccus	367298	G	961	55	1016	0.00012
SRR6145059	Ezakiella	1582879	G	101	911	1012	0.00012
SRR6145059	Agromyces	33877	G	964	60	1024	0.00012
SRR6145059	Acidipropionibacterium	1912215	G	940	43	983	0.00012
SRR6145059	Nakamurella	53460	G	874	16	890	0.00011
SRR6145059	Hymenobacter	89966	G	892	13	905	0.00011
SRR6145059	Elizabethkingia	308865	G	848	41	889	0.00011
SRR6145059	Devosia	46913	G	868	39	907	0.00011
SRR6145059	Agrococcus	46352	G	845	54	899	0.00011
SRR6145059	Solimonas	413435	G	849	4	853	0.00010
SRR6145059	Rhodoferax	28065	G	773	31	804	0.00010
SRR6145059	Paenibacillus	44249	G	810	6	816	0.00010
SRR6145059	Gardnerella	2701	G	835	18	853	0.00010
SRR6145059	Exiguobacterium	33986	G	814	12	826	0.00010
SRR6145059	Dermabacter	36739	G	771	92	863	0.00010
SRR6145059	Conexibacter	191494	G	795	7	802	0.00010
SRR6145059	Clostridium	1485	G	844	18	862	0.00010
SRR6145059	Actinomadura	1988	G	800	33	833	0.00010
SRR6145059	Sorangium	39643	G	736	29	765	0.00009
SRR6145059	Shewanella	22	G	677	45	722	0.00009
SRR6145059	Rhodopseudomonas	1073	G	675	123	798	0.00009
SRR6145059	Propionibacterium	1743	G	613	112	725	0.00009
SRR6145059	Phenylobacterium	20	G	706	39	745	0.00009
SRR6145059	Peptoniphilus	162289	G	724	36	760	0.00009
SRR6145059	Microvirga	186650	G	727	34	761	0.00009
SRR6145059	Leclercia	83654	G	660	76	736	0.00009
SRR6145059	Herbaspirillum	963	G	747	27	774	0.00009
SRR6145059	Haematobacter	366614	G	624	170	794	0.00009
SRR6145059	Frankia	1854	G	781	8	789	0.00009
SRR6145059	Diaphorobacter	238749	G	276	470	746	0.00009
SRR6145059	Curtobacterium	2034	G	717	33	750	0.00009
SRR6145059	Campylobacter	194	G	715	5	720	0.00009
SRR6145059	Aggregatibacter	416916	G	702	25	727	0.00009
SRR6145059	Pimelobacter	2044	G	534	104	638	0.00008
SRR6145059	Marmoricola	86795	G	565	87	652	0.00008
SRR6145059	Dolosigranulum	29393	G	663	12	675	0.00008
SRR6145059	Cloacibacterium	501783	G	641	21	662	0.00008
SRR6145059	Cellulosimicrobium	157920	G	649	29	678	0.00008
SRR6145059	Caballeronia	1827195	G	629	4	633	0.00008
SRR6145059	Bifidobacterium	1678	G	654	-7	647	0.00008
SRR6145059	Anaerococcus	165779	G	642	45	687	0.00008
SRR6145059	Aerococcus	1375	G	618	37	655	0.00008
SRR6145059	Vibrio	662	G	553	15	568	0.00007
SRR6145059	Tannerella	195950	G	529	20	549	0.00007
SRR6145059	Sphingorhabdus	1434046	G	584	3	587	0.00007
SRR6145059	Shinella	323620	G	419	128	547	0.00007
SRR6145059	Saccharomonospora	1851	G	518	44	562	0.00007
SRR6145059	Pseudopropionibacterium	1912217	G	619	7	626	0.00007
SRR6145059	Pseudarthrobacter	1742993	G	565	22	587	0.00007
SRR6145059	Porphyromonas	836	G	546	28	574	0.00007
SRR6145059	Paenalcaligenes	1100891	G	4	596	600	0.00007
SRR6145059	Ottowia	219181	G	606	16	622	0.00007
SRR6145059	Mitsuaria	65047	G	540	48	588	0.00007
SRR6145059	Micropruina	116071	G	579	15	594	0.00007
SRR6145059	Microlunatus	29404	G	587	5	592	0.00007
SRR6145059	Leifsonia	110932	G	531	23	554	0.00007
SRR6145059	Croceicoccus	1295327	G	305	258	563	0.00007
SRR6145059	Celeribacter	875170	G	407	151	558	0.00007
SRR6145059	Azoarcus	12960	G	596	20	616	0.00007
SRR6145059	Arthrospira	35823	G	319	261	580	0.00007
SRR6145059	Aquabacterium	92793	G	516	43	559	0.00007
SRR6145059	Treponema	157	G	489	3	492	0.00006
SRR6145059	Thauera	33057	G	432	75	507	0.00006
SRR6145059	Saccharopolyspora	1835	G	520	22	542	0.00006
SRR6145059	Roseovarius	74030	G	462	73	535	0.00006
SRR6145059	Rhodovulum	34008	G	458	58	516	0.00006
SRR6145059	Ramlibacter	174951	G	451	19	470	0.00006
SRR6145059	Proteus	583	G	439	59	498	0.00006
SRR6145059	Phreatobacter	1632780	G	487	17	504	0.00006
SRR6145059	Nonomuraea	83681	G	467	13	480	0.00006
SRR6145059	Neorhizobium	1525371	G	470	27	497	0.00006
SRR6145059	Modestobacter	88138	G	433	30	463	0.00006
SRR6145059	Luteipulveratus	745364	G	467	5	472	0.00006
SRR6145059	Lactococcus	1357	G	451	92	543	0.00006
SRR6145059	Kitasatospora	2063	G	399	95	494	0.00006
SRR6145059	Jiangella	281472	G	468	8	476	0.00006
SRR6145059	Humibacter	427753	G	207	308	515	0.00006
SRR6145059	Georgenia	154116	G	529	15	544	0.00006
SRR6145059	Geodermatophilus	1860	G	476	38	514	0.00006
SRR6145059	Friedmanniella	53387	G	519	18	537	0.00006
SRR6145059	Ensifer	106591	G	436	42	478	0.00006
SRR6145059	Duganella	75654	G	485	56	541	0.00006
SRR6145059	Corallococcus	83461	G	435	60	495	0.00006
SRR6145059	Chroococcidiopsis	54298	G	490	16	506	0.00006
SRR6145059	Blastococcus	38501	G	472	34	506	0.00006
SRR6145059	Betapapillomavirus	333922	G	502	-4	498	0.00006
SRR6145059	Bacteroides	816	G	475	27	502	0.00006
SRR6145059	Arsenicicoccus	267408	G	472	31	503	0.00006
SRR6145059	Alicycliphilus	201096	G	303	170	473	0.00006
SRR6145059	Abiotrophia	46123	G	539	5	544	0.00006
SRR6145059	Spirosoma	107	G	403	6	409	0.00005
SRR6145059	Sphingosinicella	335405	G	401	6	407	0.00005
SRR6145059	Saccharothrix	2071	G	412	42	454	0.00005
SRR6145059	Psychrobacter	497	G	411	30	441	0.00005
SRR6145059	Plantibacter	190323	G	206	173	379	0.00005
SRR6145059	Pannonibacter	227873	G	286	102	388	0.00005
SRR6145059	Nocardiopsis	2013	G	371	12	383	0.00005
SRR6145059	Mycolicibacter	1073531	G	390	15	405	0.00005
SRR6145059	Miniimonas	947525	G	377	22	399	0.00005
SRR6145059	Methylibium	316612	G	431	30	461	0.00005
SRR6145059	Leucobacter	55968	G	403	15	418	0.00005
SRR6145059	Intrasporangium	53357	G	372	12	384	0.00005
SRR6145059	Glutamicibacter	1742989	G	447	14	461	0.00005
SRR6145059	Enterococcus	1350	G	356	25	381	0.00005
SRR6145059	Defluviimonas	1097466	G	346	77	423	0.00005
SRR6145059	Clavibacter	1573	G	415	23	438	0.00005
SRR6145059	Cellvibrio	10	G	389	0	389	0.00005
SRR6145059	Brachyspira	29521	G	40	422	462	0.00005
SRR6145059	Blastomonas	150203	G	378	14	392	0.00005
SRR6145059	Baekduia	2600304	G	279	168	447	0.00005
SRR6145059	Azospira	146937	G	376	30	406	0.00005
SRR6145059	Asticcacaulis	76890	G	348	86	434	0.00005
SRR6145059	Weissella	46255	G	311	8	319	0.00004
SRR6145059	Tetrasphaera	99479	G	300	15	315	0.00004
SRR6145059	Streptosporangium	2000	G	339	12	351	0.00004
SRR6145059	Starkeya	152053	G	313	40	353	0.00004
SRR6145059	Sphaerotilus	34102	G	312	39	351	0.00004
SRR6145059	Skermanella	204447	G	356	20	376	0.00004
SRR6145059	Selenomonas	970	G	311	1	312	0.00004
SRR6145059	Rubrobacter	42255	G	341	0	341	0.00004
SRR6145059	Rubrivivax	28067	G	321	33	354	0.00004
SRR6145059	Rhizorhabdus	1649486	G	213	129	342	0.00004
SRR6145059	Rhizobacter	212743	G	330	21	351	0.00004
SRR6145059	Protaetiibacter	2680004	G	287	32	319	0.00004
SRR6145059	Propioniciclava	1085622	G	298	19	317	0.00004
SRR6145059	Polaromonas	52972	G	338	3	341	0.00004
SRR6145059	Plantactinospora	673534	G	284	14	298	0.00004
SRR6145059	Phytohabitans	907364	G	326	8	334	0.00004
SRR6145059	Phietavirus	1623298	G	33	278	311	0.00004
SRR6145059	Phaeobacter	302485	G	262	50	312	0.00004
SRR6145059	Pauljensenia	2740557	G	314	22	336	0.00004
SRR6145059	Ochrobactrum	528	G	233	84	317	0.00004
SRR6145059	Myxococcus	32	G	296	34	330	0.00004
SRR6145059	Mogibacterium	86331	G	223	138	361	0.00004
SRR6145059	Methylocystis	133	G	332	16	348	0.00004
SRR6145059	Macrococcus	69965	G	297	13	310	0.00004
SRR6145059	Limnoglobus	2731450	G	154	163	317	0.00004
SRR6145059	Leuconostoc	1243	G	349	16	365	0.00004
SRR6145059	Komagataeibacter	1434011	G	261	38	299	0.00004
SRR6145059	Isoptericola	254250	G	321	20	341	0.00004
SRR6145059	Gemmata	113	G	290	9	299	0.00004
SRR6145059	Empedobacter	59734	G	299	4	303	0.00004
SRR6145059	Desulfovibrio	872	G	345	10	355	0.00004
SRR6145059	Cnuibacter	1759331	G	59	239	298	0.00004
SRR6145059	Chromobacterium	535	G	331	10	341	0.00004
SRR6145059	Chelatococcus	28209	G	294	29	323	0.00004
SRR6145059	Aureimonas	414371	G	172	181	353	0.00004
SRR6145059	Ancylobacter	99	G	257	40	297	0.00004
SRR6145059	Anaeromyxobacter	161492	G	295	4	299	0.00004
SRR6145059	Aminobacter	31988	G	283	61	344	0.00004
SRR6145059	Actinosynnema	40566	G	290	31	321	0.00004
SRR6145059	Actinoalloteichus	65496	G	316	6	322	0.00004
SRR6145059	Zhihengliuella	370735	G	201	87	288	0.00003
SRR6145059	Yangia	354203	G	265	16	281	0.00003
SRR6145059	Xylophilus	54066	G	199	13	212	0.00003
SRR6145059	Xylanimonas	186188	G	271	21	292	0.00003
SRR6145059	Xanthobacter	279	G	242	45	287	0.00003
SRR6145059	Thiomonas	32012	G	265	2	267	0.00003
SRR6145059	Sterolibacterium	157591	G	27	186	213	0.00003
SRR6145059	Stella	93	G	218	5	223	0.00003
SRR6145059	Sphingosinithalassobacter	2676233	G	209	57	266	0.00003
SRR6145059	Shigella	620	G	14	266	280	0.00003
SRR6145059	Serpentinomonas	2490452	G	223	6	229	0.00003
SRR6145059	Sanguibacter	60919	G	284	8	292	0.00003
SRR6145059	Salipiger	263377	G	162	79	241	0.00003
SRR6145059	Salinivibrio	51366	G	224	3	227	0.00003
SRR6145059	Sagittula	58842	G	166	93	259	0.00003
SRR6145059	Roseivivax	93682	G	183	34	217	0.00003
SRR6145059	Roseateles	93681	G	255	24	279	0.00003
SRR6145059	Rhodospirillum	1081	G	192	20	212	0.00003
SRR6145059	Rheinheimera	67575	G	285	3	288	0.00003
SRR6145059	Qipengyuania	1855416	G	227	9	236	0.00003
SRR6145059	Pseudoalteromonas	53246	G	213	3	216	0.00003
SRR6145059	Pluralibacter	1330546	G	252	15	267	0.00003
SRR6145059	Planctomyces	118	G	243	9	252	0.00003
SRR6145059	Pedobacter	84567	G	225	1	226	0.00003
SRR6145059	Parvimonas	543311	G	236	25	261	0.00003
SRR6145059	Paraoceanicella	2683599	G	201	35	236	0.00003
SRR6145059	Olsenella	133925	G	252	8	260	0.00003
SRR6145059	Oligotropha	40136	G	102	139	241	0.00003
SRR6145059	Mucilaginibacter	423349	G	242	0	242	0.00003
SRR6145059	Mixta	2100764	G	254	33	287	0.00003
SRR6145059	Microterricola	518733	G	217	14	231	0.00003
SRR6145059	Martelella	293088	G	243	32	275	0.00003
SRR6145059	Marinobacter	2742	G	284	4	288	0.00003
SRR6145059	Magnetospirillum	13134	G	285	6	291	0.00003
SRR6145059	Limnospira	2596745	G	58	168	226	0.00003
SRR6145059	Leptothrix	88	G	262	29	291	0.00003
SRR6145059	Leisingera	191028	G	238	24	262	0.00003
SRR6145059	Labrenzia	478070	G	228	2	230	0.00003
SRR6145059	Kribbella	182639	G	234	7	241	0.00003
SRR6145059	Kosakonia	1330547	G	212	13	225	0.00003
SRR6145059	Kineococcus	33981	G	210	6	216	0.00003
SRR6145059	Indioceanicola	2478349	G	102	113	215	0.00003
SRR6145059	Hypericibacter	2705399	G	239	6	245	0.00003
SRR6145059	Gluconobacter	441	G	123	119	242	0.00003
SRR6145059	Geobacter	28231	G	209	7	216	0.00003
SRR6145059	Frondihabitans	447237	G	229	9	238	0.00003
SRR6145059	Dickeya	204037	G	239	-3	236	0.00003
SRR6145059	Cystobacter	42	G	202	28	230	0.00003
SRR6145059	Cryobacterium	69578	G	261	9	270	0.00003
SRR6145059	Cronobacter	413496	G	224	19	243	0.00003
SRR6145059	Collimonas	202907	G	271	5	276	0.00003
SRR6145059	Cardiobacterium	2717	G	229	3	232	0.00003
SRR6145059	Calothrix	1186	G	210	5	215	0.00003
SRR6145059	Blastochloris	59282	G	204	22	226	0.00003
SRR6145059	Auraticoccus	1278221	G	211	4	215	0.00003
SRR6145059	Archangium	47	G	247	18	265	0.00003
SRR6145059	Yersinia	629	G	125	6	131	0.00002
SRR6145059	Xylanimicrobium	289244	G	147	24	171	0.00002
SRR6145059	Tomitella	741759	G	144	4	148	0.00002
SRR6145059	Tistrella	171436	G	140	14	154	0.00002
SRR6145059	Thioclava	285107	G	125	11	136	0.00002
SRR6145059	Thioalkalivibrio	106633	G	137	5	142	0.00002
SRR6145059	Thermobispora	147067	G	111	81	192	0.00002
SRR6145059	Tardiphaga	1395974	G	129	10	139	0.00002
SRR6145059	Tardibacter	2685927	G	107	74	181	0.00002
SRR6145059	Tabrizicola	1443919	G	146	5	151	0.00002
SRR6145059	Synechococcus	1129	G	182	5	187	0.00002
SRR6145059	Streptomonospora	104204	G	129	5	134	0.00002
SRR6145059	Stigmatella	40	G	167	14	181	0.00002
SRR6145059	Stappia	152161	G	189	7	196	0.00002
SRR6145059	Sinomonas	596707	G	156	2	158	0.00002
SRR6145059	Silicimonas	1955420	G	169	2	171	0.00002
SRR6145059	Sandaracinus	1055688	G	195	1	196	0.00002
SRR6145059	Salinispora	168694	G	136	6	142	0.00002
SRR6145059	Salinibacterium	235888	G	133	3	136	0.00002
SRR6145059	Ruegeria	97050	G	185	13	198	0.00002
SRR6145059	Roseimicrobium	1348508	G	147	1	148	0.00002
SRR6145059	Roseibacterium	159345	G	123	4	127	0.00002
SRR6145059	Rickettsia	780	G	175	0	175	0.00002
SRR6145059	Rhodoplanes	29407	G	124	5	129	0.00002
SRR6145059	Rhodanobacter	75309	G	154	15	169	0.00002
SRR6145059	Raineyella	1911549	G	148	1	149	0.00002
SRR6145059	Pulveribacter	2678886	G	159	14	173	0.00002
SRR6145059	Pseudolabrys	556257	G	174	11	185	0.00002
SRR6145059	Pseudactinotalea	1926259	G	145	2	147	0.00002
SRR6145059	Polymorphum	991903	G	171	18	189	0.00002
SRR6145059	Polaribacter	52959	G	111	99	210	0.00002
SRR6145059	Pigmentiphaga	152267	G	173	3	176	0.00002
SRR6145059	Phytobacter	447792	G	77	125	202	0.00002
SRR6145059	Pelagibaca	360528	G	129	51	180	0.00002
SRR6145059	Pectobacterium	122277	G	170	7	177	0.00002
SRR6145059	Paucibacter	318147	G	176	12	188	0.00002
SRR6145059	Parvibaculum	256616	G	120	28	148	0.00002
SRR6145059	Opitutus	178440	G	115	87	202	0.00002
SRR6145059	Oerskovia	162491	G	130	8	138	0.00002
SRR6145059	Nostoc	1177	G	197	13	210	0.00002
SRR6145059	Nitrospirillum	1543705	G	135	6	141	0.00002
SRR6145059	Nitratireductor	245876	G	178	14	192	0.00002
SRR6145059	Mycoplasma	2093	G	208	2	210	0.00002
SRR6145059	Mobilicoccus	984996	G	174	5	179	0.00002
SRR6145059	Minicystis	1649470	G	185	6	191	0.00002
SRR6145059	Microbulbifer	48073	G	129	0	129	0.00002
SRR6145059	Methylosinus	425	G	182	16	198	0.00002
SRR6145059	Methylocella	120652	G	138	5	143	0.00002
SRR6145059	Melittangium	44	G	153	22	175	0.00002
SRR6145059	Melaminivora	1649468	G	146	25	171	0.00002
SRR6145059	Marinovum	367771	G	101	34	135	0.00002
SRR6145059	Lysinimonas	1434018	G	118	12	130	0.00002
SRR6145059	Luteimicrobium	754249	G	165	5	170	0.00002
SRR6145059	Luteibacter	242605	G	147	6	153	0.00002
SRR6145059	Lentzea	165301	G	190	13	203	0.00002
SRR6145059	Legionella	445	G	123	6	129	0.00002
SRR6145059	Labrys	204476	G	157	5	162	0.00002
SRR6145059	Labilithrix	1524217	G	186	2	188	0.00002
SRR6145059	Kutzneria	43356	G	183	10	193	0.00002
SRR6145059	Kibdelosporangium	2029	G	165	5	170	0.00002
SRR6145059	Ketogulonicigenium	92944	G	122	5	127	0.00002
SRR6145059	Jatrophihabitans	1434010	G	76	71	147	0.00002
SRR6145059	Hyphomicrobium	81	G	191	7	198	0.00002
SRR6145059	Herbiconiux	881616	G	142	8	150	0.00002
SRR6145059	Halovulum	1844498	G	143	6	149	0.00002
SRR6145059	Halorubrum	56688	G	170	21	191	0.00002
SRR6145059	Haloactinobacterium	1331737	G	159	2	161	0.00002
SRR6145059	Haliangium	162027	G	138	1	139	0.00002
SRR6145059	Gryllotalpicola	1195526	G	124	6	130	0.00002
SRR6145059	Gimesia	1649453	G	3	145	148	0.00002
SRR6145059	Gemmatirosa	1706036	G	166	5	171	0.00002
SRR6145059	Gammapapillomavirus	325455	G	131	-1	130	0.00002
SRR6145059	Flavisolibacter	398041	G	136	7	143	0.00002
SRR6145059	Flaviflexus	1522056	G	132	4	136	0.00002
SRR6145059	Filimonas	649460	G	25	111	136	0.00002
SRR6145059	Filifactor	44259	G	175	15	190	0.00002
SRR6145059	Faecalibacterium	216851	G	121	21	142	0.00002
SRR6145059	Erwinia	551	G	155	4	159	0.00002
SRR6145059	Eikenella	538	G	184	9	193	0.00002
SRR6145059	Dyella	231454	G	171	15	186	0.00002
SRR6145059	Dyadobacter	120831	G	156	6	162	0.00002
SRR6145059	Dokdonella	323413	G	135	5	140	0.00002
SRR6145059	Dinoroseobacter	309512	G	101	44	145	0.00002
SRR6145059	Dechloromonas	73029	G	63	71	134	0.00002
SRR6145059	Confluentimicrobium	1609958	G	117	63	180	0.00002
SRR6145059	Citromicrobium	72173	G	162	44	206	0.00002
SRR6145059	Chitinophaga	79328	G	202	5	207	0.00002
SRR6145059	Chelativorans	449972	G	124	8	132	0.00002
SRR6145059	Catenulispora	414878	G	193	3	196	0.00002
SRR6145059	Caloranaerobacter	171003	G	4	205	209	0.00002
SRR6145059	Brevirhabdus	1855413	G	105	42	147	0.00002
SRR6145059	Beutenbergia	84756	G	162	2	164	0.00002
SRR6145059	Bdellovibrio	958	G	132	0	132	0.00002
SRR6145059	Azotobacter	352	G	200	-66	134	0.00002
SRR6145059	Azorhizobium	6	G	169	14	183	0.00002
SRR6145059	Atlantibacter	1903434	G	132	4	136	0.00002
SRR6145059	Arenimonas	490567	G	153	9	162	0.00002
SRR6145059	Arcobacter	28196	G	170	13	183	0.00002
SRR6145059	Aquitalea	407217	G	136	5	141	0.00002
SRR6145059	Aquisphaera	1511635	G	142	7	149	0.00002
SRR6145059	Alteromonas	226	G	117	22	139	0.00002
SRR6145059	Allokutzneria	1137960	G	153	10	163	0.00002
SRR6145059	Alloactinosynnema	674734	G	132	8	140	0.00002
SRR6145059	Alistipes	239759	G	158	13	171	0.00002
SRR6145059	Alcanivorax	59753	G	200	6	206	0.00002
SRR6145059	Alcaligenes	507	G	170	7	177	0.00002
SRR6145059	Afipia	1033	G	73	68	141	0.00002
SRR6145059	Actinopolymorpha	117156	G	171	2	173	0.00002
SRR6145059	Acetobacter	434	G	183	15	198	0.00002
SRR6145059	Youhaiella	1827478	G	111	9	120	0.00001
SRR6145059	Yoonia	2211641	G	88	20	108	0.00001
SRR6145059	Whispovirus	249585	G	108	0	108	0.00001
SRR6145059	Wenzhouxiangella	1676142	G	43	0	43	0.00001
SRR6145059	Vulgatibacter	1524214	G	61	0	61	0.00001
SRR6145059	Vogesella	57739	G	57	2	59	0.00001
SRR6145059	Vitreoscilla	59	G	66	0	66	0.00001
SRR6145059	Virgibacillus	84406	G	48	0	48	0.00001
SRR6145059	Verrucosispora	84593	G	97	16	113	0.00001
SRR6145059	Verrucomicrobium	2735	G	101	1	102	0.00001
SRR6145059	Verminephrobacter	364316	G	121	1	122	0.00001
SRR6145059	Variibacter	1649510	G	77	2	79	0.00001
SRR6145059	Vagococcus	2737	G	45	1	46	0.00001
SRR6145059	Undibacterium	401469	G	64	0	64	0.00001
SRR6145059	Trueperella	1069494	G	93	5	98	0.00001
SRR6145059	Truepera	332248	G	88	0	88	0.00001
SRR6145059	Thiohalobacter	1273155	G	50	1	51	0.00001
SRR6145059	Thiodictyon	53392	G	48	0	48	0.00001
SRR6145059	Thiocystis	13724	G	37	35	72	0.00001
SRR6145059	Thermus	270	G	106	0	106	0.00001
SRR6145059	Thermomonospora	2019	G	84	6	90	0.00001
SRR6145059	Thermococcus	2263	G	52	0	52	0.00001
SRR6145059	Thermobifida	83677	G	62	1	63	0.00001
SRR6145059	Thermaerobacter	73918	G	103	0	103	0.00001
SRR6145059	Thalassospira	168934	G	85	2	87	0.00001
SRR6145059	Thalassococcus	436357	G	44	0	44	0.00001
SRR6145059	Thalassobius	335927	G	42	1	43	0.00001
SRR6145059	Terriglobus	392733	G	51	1	52	0.00001
SRR6145059	Tenacibaculum	104267	G	68	0	68	0.00001
SRR6145059	Tatumella	82986	G	54	14	68	0.00001
SRR6145059	Tateyamaria	299261	G	61	0	61	0.00001
SRR6145059	Sulfuritortus	1938335	G	47	5	52	0.00001
SRR6145059	Sulfuritalea	1054211	G	46	0	46	0.00001
SRR6145059	Sulfurifustis	1692042	G	56	0	56	0.00001
SRR6145059	Sulfuriferula	1778653	G	52	1	53	0.00001
SRR6145059	Streptacidiphilus	228398	G	115	4	119	0.00001
SRR6145059	Steroidobacter	469322	G	43	2	45	0.00001
SRR6145059	Stackebrandtia	283810	G	116	0	116	0.00001
SRR6145059	Sporosarcina	1569	G	51	0	51	0.00001
SRR6145059	Spiroplasma	2132	G	73	-1	72	0.00001
SRR6145059	Spiribacter	1335745	G	65	0	65	0.00001
SRR6145059	Sphaerobacter	2056	G	51	0	51	0.00001
SRR6145059	Solibacillus	648800	G	49	1	50	0.00001
SRR6145059	Sodalis	84565	G	45	0	45	0.00001
SRR6145059	Sinimarinibacterium	1861863	G	45	3	48	0.00001
SRR6145059	Simplicispira	352450	G	95	7	102	0.00001
SRR6145059	Segniliparus	286801	G	62	0	62	0.00001
SRR6145059	Scytonema	1203	G	74	7	81	0.00001
SRR6145059	Salinisphaera	180541	G	45	0	45	0.00001
SRR6145059	Salinicola	404432	G	53	0	53	0.00001
SRR6145059	Salinicoccus	45669	G	47	0	47	0.00001
SRR6145059	Salinibacter	146918	G	52	0	52	0.00001
SRR6145059	Salicibibacter	2685905	G	43	0	43	0.00001
SRR6145059	Runella	105	G	82	1	83	0.00001
SRR6145059	Rufibacter	1379908	G	39	4	43	0.00001
SRR6145059	Ruania	626119	G	112	1	113	0.00001
SRR6145059	Rouxiella	1565532	G	58	1	59	0.00001
SRR6145059	Roseobacter	2433	G	91	3	94	0.00001
SRR6145059	Roseitalea	1915401	G	85	6	91	0.00001
SRR6145059	Riemerella	34084	G	69	5	74	0.00001
SRR6145059	Rhodothermus	29548	G	59	2	61	0.00001
SRR6145059	Rhodomicrobium	1068	G	52	1	53	0.00001
SRR6145059	Rhodobaca	119541	G	43	0	43	0.00001
SRR6145059	Rahnella	34037	G	115	6	121	0.00001
SRR6145059	Pyruvatibacter	1742974	G	65	1	66	0.00001
SRR6145059	Pusillimonas	305976	G	59	47	106	0.00001
SRR6145059	Pseudorhodoplanes	1734920	G	88	2	90	0.00001
SRR6145059	Pseudorhodobacter	238783	G	48	1	49	0.00001
SRR6145059	Pseudohalocynthiibacter	1759417	G	43	7	50	0.00001
SRR6145059	Pseudogulbenkiania	568394	G	56	2	58	0.00001
SRR6145059	Pseudodesulfovibrio	2035811	G	91	9	100	0.00001
SRR6145059	Pseudenhygromyxa	1324129	G	118	1	119	0.00001
SRR6145059	Providencia	586	G	76	5	81	0.00001
SRR6145059	Propionimicrobium	203133	G	82	2	84	0.00001
SRR6145059	Prauserella	142577	G	122	3	125	0.00001
SRR6145059	Pontibacter	323449	G	106	3	109	0.00001
SRR6145059	Polynucleobacter	44013	G	89	0	89	0.00001
SRR6145059	Planococcus	1372	G	59	1	60	0.00001
SRR6145059	Pirellula	123	G	112	0	112	0.00001
SRR6145059	Phycisphaera	666508	G	63	24	87	0.00001
SRR6145059	Peptacetobacter	2743582	G	43	1	44	0.00001
SRR6145059	Pelagibacterium	1082930	G	63	24	87	0.00001
SRR6145059	Pasteurella	745	G	85	26	111	0.00001
SRR6145059	Pararhodospirillum	1612157	G	51	2	53	0.00001
SRR6145059	Paraoerskovia	665568	G	81	3	84	0.00001
SRR6145059	Paraflavitalea	2698688	G	53	2	55	0.00001
SRR6145059	Panacibacter	1874621	G	50	1	51	0.00001
SRR6145059	Paludisphaera	1763521	G	95	7	102	0.00001
SRR6145059	Paenarthrobacter	1742992	G	22	65	87	0.00001
SRR6145059	Oryzomicrobium	1911577	G	55	0	55	0.00001
SRR6145059	Orrella	1921582	G	95	7	102	0.00001
SRR6145059	Octadecabacter	53945	G	92	6	98	0.00001
SRR6145059	Oceanicola	252301	G	105	2	107	0.00001
SRR6145059	Noviherbaspirillum	1344552	G	94	3	97	0.00001
SRR6145059	Nordella	169055	G	121	2	123	0.00001
SRR6145059	Nonlabens	363408	G	65	0	65	0.00001
SRR6145059	Niveispirillum	1543704	G	95	5	100	0.00001
SRR6145059	Nitrospira	1234	G	93	0	93	0.00001
SRR6145059	Nitrosospira	35798	G	31	75	106	0.00001
SRR6145059	Nitrosomonas	914	G	46	0	46	0.00001
SRR6145059	Nitrobacter	911	G	97	7	104	0.00001
SRR6145059	Nibricoccus	2576890	G	54	2	56	0.00001
SRR6145059	Nesterenkonia	57494	G	109	0	109	0.00001
SRR6145059	Neomicrococcus	1868332	G	83	3	86	0.00001
SRR6145059	Natronococcus	29287	G	63	1	64	0.00001
SRR6145059	Natrinema	88723	G	102	9	111	0.00001
SRR6145059	Myroides	76831	G	93	2	95	0.00001
SRR6145059	Mycolicibacillus	2126281	G	105	10	115	0.00001
SRR6145059	Mycetohabitans	2571159	G	49	0	49	0.00001
SRR6145059	Mycetocola	76634	G	48	1	49	0.00001
SRR6145059	Monaibacterium	2029873	G	71	13	84	0.00001
SRR6145059	Mobiluncus	2050	G	87	2	89	0.00001
SRR6145059	Microcoleus	44471	G	50	1	51	0.00001
SRR6145059	Microcella	337004	G	121	5	126	0.00001
SRR6145059	Micavibrio	213485	G	65	0	65	0.00001
SRR6145059	Methylovirgula	1156568	G	64	3	67	0.00001
SRR6145059	Methyloversatilis	378210	G	55	0	55	0.00001
SRR6145059	Methylomonas	416	G	85	0	85	0.00001
SRR6145059	Methylomicrobium	39773	G	54	0	54	0.00001
SRR6145059	Methyloligella	1485594	G	60	2	62	0.00001
SRR6145059	Methylococcus	413	G	59	0	59	0.00001
SRR6145059	Methyloceanibacter	1484898	G	98	2	100	0.00001
SRR6145059	Methylobacillus	404	G	20	23	43	0.00001
SRR6145059	Methanosarcina	2207	G	61	0	61	0.00001
SRR6145059	Metakosakonia	2055876	G	13	65	78	0.00001
SRR6145059	Meiothermus	65551	G	78	0	78	0.00001
SRR6145059	Megamonas	158846	G	56	0	56	0.00001
SRR6145059	Marisediminicola	1230698	G	90	2	92	0.00001
SRR6145059	Marichromatium	85076	G	50	2	52	0.00001
SRR6145059	Maricaulis	74317	G	44	0	44	0.00001
SRR6145059	Maribius	387095	G	72	1	73	0.00001
SRR6145059	Maribacter	252356	G	46	0	46	0.00001
SRR6145059	Mannheimia	75984	G	36	12	48	0.00001
SRR6145059	Mameliella	1434019	G	107	19	126	0.00001
SRR6145059	Lysinibacillus	400634	G	62	1	63	0.00001
SRR6145059	Luteolibacter	518753	G	52	0	52	0.00001
SRR6145059	Luteitalea	2004797	G	107	0	107	0.00001
SRR6145059	Litoreibacter	947567	G	62	1	63	0.00001
SRR6145059	Listeria	1637	G	56	32	88	0.00001
SRR6145059	Limnohabitans	665874	G	78	1	79	0.00001
SRR6145059	Lichenihabitans	2723776	G	79	2	81	0.00001
SRR6145059	Leptolyngbya	47251	G	81	4	85	0.00001
SRR6145059	Lelliottia	1330545	G	68	7	75	0.00001
SRR6145059	Lacunisphaera	1961799	G	55	5	60	0.00001
SRR6145059	Lacipirellula	2691417	G	83	3	86	0.00001
SRR6145059	Lachnoanaerobaculum	1164882	G	87	1	88	0.00001
SRR6145059	Kushneria	504090	G	58	0	58	0.00001
SRR6145059	Kurthia	1649	G	54	2	56	0.00001
SRR6145059	Kluyvera	579	G	66	4	70	0.00001
SRR6145059	Kiritimatiella	1921784	G	15	35	50	0.00001
SRR6145059	Kayvirus	1857843	G	73	0	73	0.00001
SRR6145059	Jeotgalicoccus	227979	G	46	0	46	0.00001
SRR6145059	Jeongeupia	885864	G	68	1	69	0.00001
SRR6145059	Jannaschia	188905	G	54	0	54	0.00001
SRR6145059	Inhella	644355	G	119	7	126	0.00001
SRR6145059	Immundisolibacter	1934947	G	65	1	66	0.00001
SRR6145059	Ilumatobacter	682522	G	96	1	97	0.00001
SRR6145059	Hyphomonas	85	G	120	0	120	0.00001
SRR6145059	Hylemonella	232523	G	86	1	87	0.00001
SRR6145059	Hoyosella	697025	G	64	0	64	0.00001
SRR6145059	Hoeflea	274591	G	68	2	70	0.00001
SRR6145059	Helicobacter	209	G	73	1	74	0.00001
SRR6145059	Hartmannibacter	1572860	G	94	6	100	0.00001
SRR6145059	Haloterrigena	121871	G	48	1	49	0.00001
SRR6145059	Halorussus	1070314	G	60	0	60	0.00001
SRR6145059	Halorientalis	1073987	G	34	31	65	0.00001
SRR6145059	Halorhodospira	85108	G	51	0	51	0.00001
SRR6145059	Halorhabdus	146825	G	50	1	51	0.00001
SRR6145059	Haloplanus	376170	G	95	4	99	0.00001
SRR6145059	Halopiger	387342	G	42	2	44	0.00001
SRR6145059	Halomicrobium	203135	G	45	3	48	0.00001
SRR6145059	Haloferax	2251	G	77	1	78	0.00001
SRR6145059	Halobiforma	203193	G	37	38	75	0.00001
SRR6145059	Halobacterium	2239	G	92	21	113	0.00001
SRR6145059	Haloarcula	2237	G	57	-2	55	0.00001
SRR6145059	Halioglobus	1217416	G	35	25	60	0.00001
SRR6145059	Granulicella	940557	G	59	1	60	0.00001
SRR6145059	Granulibacter	364409	G	55	0	55	0.00001
SRR6145059	Gramella	292691	G	67	0	67	0.00001
SRR6145059	Gordonibacter	644652	G	54	4	58	0.00001
SRR6145059	Glycocaulis	1433402	G	48	0	48	0.00001
SRR6145059	Gluconacetobacter	89583	G	87	5	92	0.00001
SRR6145059	Georhizobium	2661800	G	94	13	107	0.00001
SRR6145059	Geobacillus	129337	G	87	2	89	0.00001
SRR6145059	Gemmobacter	204456	G	119	7	126	0.00001
SRR6145059	Gemmatimonas	173479	G	82	0	82	0.00001
SRR6145059	Frateuria	70411	G	62	4	66	0.00001
SRR6145059	Francisella	262	G	57	0	57	0.00001
SRR6145059	Formosa	225842	G	65	0	65	0.00001
SRR6145059	Flammeovirga	59739	G	26	19	45	0.00001
SRR6145059	Fischerella	1190	G	28	24	52	0.00001
SRR6145059	Fibrella	861914	G	46	1	47	0.00001
SRR6145059	Ferrovibrio	1231242	G	83	1	84	0.00001
SRR6145059	Euzebya	908623	G	95	0	95	0.00001
SRR6145059	Eubacterium	1730	G	47	1	48	0.00001
SRR6145059	Epibacterium	1649279	G	38	10	48	0.00001
SRR6145059	Emcibacter	1602338	G	44	0	44	0.00001
SRR6145059	Egicoccus	1755825	G	110	0	110	0.00001
SRR6145059	Egibacter	1747770	G	62	21	83	0.00001
SRR6145059	Edwardsiella	635	G	54	3	57	0.00001
SRR6145059	Diaminobutyricimonas	1433997	G	59	2	61	0.00001
SRR6145059	Desulfuromonas	890	G	47	1	48	0.00001
SRR6145059	Desulfosarcina	2299	G	62	2	64	0.00001
SRR6145059	Desulfobulbus	893	G	55	1	56	0.00001
SRR6145059	Denitratisoma	311181	G	48	5	53	0.00001
SRR6145059	Cyanobium	167375	G	50	3	53	0.00001
SRR6145059	Curvibacter	281915	G	51	0	51	0.00001
SRR6145059	Crenobacter	1654931	G	57	1	58	0.00001
SRR6145059	Colwellia	28228	G	49	0	49	0.00001
SRR6145059	Collinsella	102106	G	53	17	70	0.00001
SRR6145059	Cobetia	204286	G	50	1	51	0.00001
SRR6145059	Clostridioides	1870884	G	40	21	61	0.00001
SRR6145059	Chromohalobacter	42054	G	70	0	70	0.00001
SRR6145059	Chondromyces	50	G	113	2	115	0.00001
SRR6145059	Chitinolyticbacter	1055692	G	56	0	56	0.00001
SRR6145059	Chania	1745211	G	45	0	45	0.00001
SRR6145059	Cedecea	158483	G	55	1	56	0.00001
SRR6145059	Castellaniella	359336	G	81	7	88	0.00001
SRR6145059	Carnobacterium	2747	G	88	2	90	0.00001
SRR6145059	Buchnera	32199	G	70	-1	69	0.00001
SRR6145059	Brucella	234	G	59	6	65	0.00001
SRR6145059	Brochothrix	2755	G	64	1	65	0.00001
SRR6145059	Brevibacillus	55080	G	53	0	53	0.00001
SRR6145059	Breoghania	1406135	G	98	4	102	0.00001
SRR6145059	Brenneria	71655	G	59	1	60	0.00001
SRR6145059	Bradymonas	1779136	G	22	63	85	0.00001
SRR6145059	Boseongicola	1648497	G	49	0	49	0.00001
SRR6145059	Blautia	572511	G	89	8	97	0.00001
SRR6145059	Bergeyella	59735	G	64	1	65	0.00001
SRR6145059	Bartonella	773	G	70	2	72	0.00001
SRR6145059	Barnesiella	397864	G	6	49	55	0.00001
SRR6145059	Bacteriovorax	146784	G	67	0	67	0.00001
SRR6145059	Austwickia	1184606	G	89	2	91	0.00001
SRR6145059	Auritidibacter	1160973	G	96	1	97	0.00001
SRR6145059	Auricoccus	2005363	G	100	3	103	0.00001
SRR6145059	Aurantimicrobium	1705353	G	47	0	47	0.00001
SRR6145059	Atopobium	1380	G	102	1	103	0.00001
SRR6145059	Aromatoleum	551759	G	48	48	96	0.00001
SRR6145059	Arachidicoccus	1769012	G	114	3	117	0.00001
SRR6145059	Arabia	2005386	G	34	9	43	0.00001
SRR6145059	Aquicella	254245	G	2	72	74	0.00001
SRR6145059	Aquaspirillum	187	G	46	0	46	0.00001
SRR6145059	Antarctobacter	74032	G	57	1	58	0.00001
SRR6145059	Anoxybacillus	150247	G	72	4	76	0.00001
SRR6145059	Anabaena	1163	G	22	54	76	0.00001
SRR6145059	Alkalilimnicola	133193	G	48	47	95	0.00001
SRR6145059	Alienimonas	2714737	G	87	0	87	0.00001
SRR6145059	Akkermansia	239934	G	25	59	84	0.00001
SRR6145059	Aerosticca	2707020	G	91	29	120	0.00001
SRR6145059	Adlercreutzia	447020	G	41	3	44	0.00001
SRR6145059	Actinotignum	1653174	G	59	0	59	0.00001
SRR6145059	Actinopolyspora	1849	G	73	0	73	0.00001
SRR6145059	Acidithiobacillus	119977	G	51	0	51	0.00001
SRR6145059	Acidiphilium	522	G	124	2	126	0.00001
SRR6145059	Acidihalobacter	1765964	G	74	1	75	0.00001
SRR6145059	Acidibrevibacterium	2603324	G	75	2	77	0.00001
SRR6145059	Zymomonas	541	G	27	8	35	0.00000
SRR6145059	Zymobacter	33073	G	42	0	42	0.00000
SRR6145059	Zunongwangia	417127	G	8	0	8	0.00000
SRR6145059	Zobellia	112040	G	8	0	8	0.00000
SRR6145059	Zobellella	347533	G	37	0	37	0.00000
SRR6145059	Zhongshania	1434050	G	9	0	9	0.00000
SRR6145059	Zetavirus	2733222	G	3	0	3	0.00000
SRR6145059	Yvonnevirus	2560257	G	1	0	1	0.00000
SRR6145059	Yuavirus	1299429	G	5	0	5	0.00000
SRR6145059	Yoloswagvirus	2733142	G	1	0	1	0.00000
SRR6145059	Yokenella	158876	G	16	1	17	0.00000
SRR6145059	Yatapoxvirus	10282	G	2	0	2	0.00000
SRR6145059	Yangvirus	2733221	G	1	0	1	0.00000
SRR6145059	Xylella	2370	G	23	0	23	0.00000
SRR6145059	Xenorhabdus	626	G	35	0	35	0.00000
SRR6145059	Wphvirus	1922327	G	2	0	2	0.00000
SRR6145059	Woodruffvirus	1982745	G	1	1	2	0.00000
SRR6145059	Wolinella	843	G	3	0	3	0.00000
SRR6145059	Wolbachia	953	G	26	0	26	0.00000
SRR6145059	Woeseia	1738655	G	16	0	16	0.00000
SRR6145059	Wizardvirus	2169658	G	3	0	3	0.00000
SRR6145059	Winogradskyella	286104	G	38	0	38	0.00000
SRR6145059	Wilnyevirus	2560255	G	1	0	1	0.00000
SRR6145059	Wigglesworthia	51228	G	4	0	4	0.00000
SRR6145059	Wifcevirus	2733141	G	1	0	1	0.00000
SRR6145059	Wenyingzhuangia	1518147	G	6	0	6	0.00000
SRR6145059	Wellingtonvirus	2733140	G	1	0	1	0.00000
SRR6145059	Weeksella	1013	G	18	0	18	0.00000
SRR6145059	Webervirus	1920860	G	1	0	1	0.00000
SRR6145059	Waddlia	71666	G	3	0	3	0.00000
SRR6145059	Vulcanisaeta	164450	G	4	0	4	0.00000
SRR6145059	Votkovvirus	2731987	G	1	0	1	0.00000
SRR6145059	Vividuovirus	2560251	G	7	0	7	0.00000
SRR6145059	Vhulanivirus	2560247	G	1	0	1	0.00000
SRR6145059	Vespertilionpoxvirus	2733301	G	1	0	1	0.00000
SRR6145059	Vendettavirus	2049885	G	1	-1	0	0.00000
SRR6145059	Varicellovirus	10319	G	3	0	3	0.00000
SRR6145059	Vampirococcus	1930592	G	4	3	7	0.00000
SRR6145059	Ureibacillus	160795	G	6	0	6	0.00000
SRR6145059	Urechidicola	2700084	G	16	0	16	0.00000
SRR6145059	Ureaplasma	2129	G	3	0	3	0.00000
SRR6145059	Twortvirus	1857846	G	2	2	4	0.00000
SRR6145059	Tuwongella	2051044	G	14	0	14	0.00000
SRR6145059	Turneriella	338321	G	9	0	9	0.00000
SRR6145059	Turicibacter	191303	G	5	0	5	0.00000
SRR6145059	Tumebacillus	432330	G	19	0	19	0.00000
SRR6145059	Tulanevirus	2560244	G	1	0	1	0.00000
SRR6145059	Tsarbombavirus	1985181	G	1	4	5	0.00000
SRR6145059	Tropheryma	2038	G	6	-6	0	0.00000
SRR6145059	Trigintaduovirus	2169657	G	1	0	1	0.00000
SRR6145059	Trichormus	264688	G	7	6	13	0.00000
SRR6145059	Trichodesmium	1205	G	17	0	17	0.00000
SRR6145059	Tortellinivirus	2560240	G	2	0	2	0.00000
SRR6145059	Tolypothrix	111782	G	12	5	17	0.00000
SRR6145059	Tolumonas	43947	G	11	0	11	0.00000
SRR6145059	Tissierella	41273	G	16	8	24	0.00000
SRR6145059	Tinduovirus	1982569	G	7	0	7	0.00000
SRR6145059	Timquatrovirus	1623306	G	8	0	8	0.00000
SRR6145059	Thioploca	40751	G	8	0	8	0.00000
SRR6145059	Thiomicrospira	933	G	5	0	5	0.00000
SRR6145059	Thiomicrorhabdus	2039723	G	26	0	26	0.00000
SRR6145059	Thiolapillus	1608298	G	5	4	9	0.00000
SRR6145059	Thioflavicoccus	156885	G	42	0	42	0.00000
SRR6145059	Thiobacillus	919	G	40	1	41	0.00000
SRR6145059	Thermotoga	2335	G	11	1	12	0.00000
SRR6145059	Thermosynechococcus	146785	G	14	0	14	0.00000
SRR6145059	Thermosulfuriphilus	2033601	G	2	0	2	0.00000
SRR6145059	Thermosulfurimonas	1522431	G	2	0	2	0.00000
SRR6145059	Thermosulfidibacter	412592	G	4	0	4	0.00000
SRR6145059	Thermosipho	2420	G	18	0	18	0.00000
SRR6145059	Thermosediminibacter	291988	G	3	0	3	0.00000
SRR6145059	Thermoproteus	2270	G	16	0	16	0.00000
SRR6145059	Thermomicrobium	499	G	11	0	11	0.00000
SRR6145059	Thermoleptolyngbya	2303528	G	13	2	15	0.00000
SRR6145059	Thermogutta	1676125	G	10	0	10	0.00000
SRR6145059	Thermofilum	2268	G	6	0	6	0.00000
SRR6145059	Thermodesulfovibrio	28261	G	1	0	1	0.00000
SRR6145059	Thermodesulfobium	227388	G	6	0	6	0.00000
SRR6145059	Thermodesulfobacterium	1740	G	3	0	3	0.00000
SRR6145059	Thermodesulfatator	241192	G	2	0	2	0.00000
SRR6145059	Thermocrinis	75905	G	6	0	6	0.00000
SRR6145059	Thermoclostridium	2304691	G	4	-4	0	0.00000
SRR6145059	Thermochromatium	85073	G	21	0	21	0.00000
SRR6145059	Thermobaculum	262406	G	4	0	4	0.00000
SRR6145059	Thermobacillus	76632	G	17	0	17	0.00000
SRR6145059	Thermoanaerobacterium	28895	G	26	0	26	0.00000
SRR6145059	Thermoanaerobacter	1754	G	18	0	18	0.00000
SRR6145059	Thermoactinomyces	2023	G	5	0	5	0.00000
SRR6145059	Thermincola	278993	G	6	0	6	0.00000
SRR6145059	Thermanaerovibrio	81461	G	10	0	10	0.00000
SRR6145059	Thermanaeromonas	202949	G	4	0	4	0.00000
SRR6145059	Thermacetogenium	140458	G	8	0	8	0.00000
SRR6145059	Thalassotalea	1518149	G	14	0	14	0.00000
SRR6145059	Thalassolituus	187492	G	7	0	7	0.00000
SRR6145059	Tetragenococcus	51668	G	36	1	37	0.00000
SRR6145059	Teseptimavirus	110456	G	2	0	2	0.00000
SRR6145059	Terribacillus	459532	G	6	0	6	0.00000
SRR6145059	Teredinibacter	2425	G	6	0	6	0.00000
SRR6145059	Terasakiella	196080	G	6	0	6	0.00000
SRR6145059	Tepidiforma	2682228	G	39	0	39	0.00000
SRR6145059	Tepidanaerobacter	499228	G	8	0	8	0.00000
SRR6145059	Teetrevirus	2732693	G	1	0	1	0.00000
SRR6145059	Taylorella	29574	G	9	0	9	0.00000
SRR6145059	Tatlockia	465	G	8	0	8	0.00000
SRR6145059	Tankvirus	1982566	G	1	0	1	0.00000
SRR6145059	Tamlana	393005	G	6	0	6	0.00000
SRR6145059	Taipeivirus	2731621	G	2	-2	0	0.00000
SRR6145059	Syntrophus	43773	G	4	0	4	0.00000
SRR6145059	Syntrophothermus	129001	G	3	0	3	0.00000
SRR6145059	Syntrophomonas	862	G	2	0	2	0.00000
SRR6145059	Syntrophobotulus	51196	G	2	25	27	0.00000
SRR6145059	Syntrophobacter	29526	G	15	1	16	0.00000
SRR6145059	Synechocystis	1142	G	14	0	14	0.00000
SRR6145059	Symbiobacterium	2733	G	30	0	30	0.00000
SRR6145059	Swingsia	1649499	G	9	0	9	0.00000
SRR6145059	Sutterella	40544	G	37	0	37	0.00000
SRR6145059	Sulfurovum	265570	G	3	0	3	0.00000
SRR6145059	Sulfurospirillum	57665	G	22	0	22	0.00000
SRR6145059	Sulfurivermis	2034504	G	33	3	36	0.00000
SRR6145059	Sulfurisphaera	69655	G	7	0	7	0.00000
SRR6145059	Sulfurimonas	202746	G	22	0	22	0.00000
SRR6145059	Sulfurihydrogenibium	212790	G	4	0	4	0.00000
SRR6145059	Sulfuriflexus	1860077	G	7	0	7	0.00000
SRR6145059	Sulfuricurvum	286130	G	2	0	2	0.00000
SRR6145059	Sulfuricella	935200	G	16	0	16	0.00000
SRR6145059	Sulfuricaulis	1744881	G	33	0	33	0.00000
SRR6145059	Sulfuracidifex	2705406	G	4	0	4	0.00000
SRR6145059	Sulfolobus	2284	G	12	1	13	0.00000
SRR6145059	Sulfodiicoccus	2017961	G	1	0	1	0.00000
SRR6145059	Suicoccus	2689587	G	4	0	4	0.00000
SRR6145059	Succinivibrio	83770	G	7	0	7	0.00000
SRR6145059	Streptobacillus	34104	G	5	0	5	0.00000
SRR6145059	Steinhofvirus	1982227	G	1	0	1	0.00000
SRR6145059	Staphylothermus	2279	G	5	0	5	0.00000
SRR6145059	Staphylospora	2689589	G	4	0	4	0.00000
SRR6145059	Stanieria	102115	G	16	0	16	0.00000
SRR6145059	Stanholtvirus	1623297	G	1	0	1	0.00000
SRR6145059	Sprivivirus	1513299	G	5	0	5	0.00000
SRR6145059	Sporomusa	2375	G	11	0	11	0.00000
SRR6145059	Sporolactobacillus	2077	G	6	3	9	0.00000
SRR6145059	Spongiibacter	630749	G	17	0	17	0.00000
SRR6145059	Spirochaeta	146	G	19	0	19	0.00000
SRR6145059	Sphaerospermopsis	752201	G	7	0	7	0.00000
SRR6145059	Sphaerochaeta	399320	G	10	0	10	0.00000
SRR6145059	Sourvirus	2560231	G	1	0	1	0.00000
SRR6145059	Sonalivirus	2733214	G	1	0	1	0.00000
SRR6145059	Solitalea	929509	G	20	18	38	0.00000
SRR6145059	Solendovirus	1232640	G	2	2	4	0.00000
SRR6145059	Snodgrassella	1193515	G	14	9	23	0.00000
SRR6145059	Sneathia	168808	G	21	0	21	0.00000
SRR6145059	Smoothievirus	1982557	G	1	0	1	0.00000
SRR6145059	Slopekvirus	1985328	G	1	2	3	0.00000
SRR6145059	Slashvirus	1921709	G	2	0	2	0.00000
SRR6145059	Slackia	84108	G	8	0	8	0.00000
SRR6145059	Skunavirus	1623305	G	2	0	2	0.00000
SRR6145059	Singulisphaera	466152	G	39	1	40	0.00000
SRR6145059	Simplexvirus	10294	G	5	0	5	0.00000
SRR6145059	Simpcentumvirus	2733081	G	1	0	1	0.00000
SRR6145059	Simonsiella	71	G	25	0	25	0.00000
SRR6145059	Simkania	34093	G	4	0	4	0.00000
SRR6145059	Simiduia	447467	G	22	0	22	0.00000
SRR6145059	Silviavirus	1857889	G	7	0	7	0.00000
SRR6145059	Silvanigrella	2024975	G	6	6	12	0.00000
SRR6145059	Sideroxydans	314343	G	15	0	15	0.00000
SRR6145059	Siansivirga	1204360	G	8	0	8	0.00000
SRR6145059	Shimwellia	1335483	G	12	0	12	0.00000
SRR6145059	Shenzhenvirus	2732038	G	1	0	1	0.00000
SRR6145059	Shaspivirus	2501970	G	1	0	1	0.00000
SRR6145059	Shapirovirus	2733155	G	1	1	2	0.00000
SRR6145059	Shalavirus	2560228	G	1	0	1	0.00000
SRR6145059	Sextaecvirus	1922243	G	20	0	20	0.00000
SRR6145059	Seunavirus	1914851	G	1	-1	0	0.00000
SRR6145059	Sepunavirus	1980928	G	20	2	22	0.00000
SRR6145059	Septimatrevirus	1921544	G	20	0	20	0.00000
SRR6145059	Seonamhaeicola	1649495	G	15	0	15	0.00000
SRR6145059	Sediminispirochaeta	1911556	G	6	0	6	0.00000
SRR6145059	Sediminicola	389486	G	12	0	12	0.00000
SRR6145059	Sedimentisphaera	2483368	G	6	1	7	0.00000
SRR6145059	Sedimenticola	349742	G	17	0	17	0.00000
SRR6145059	Sebaldella	32068	G	4	0	4	0.00000
SRR6145059	Scottvirus	2731973	G	2	0	2	0.00000
SRR6145059	Schnabeltiervirus	2733211	G	1	0	1	0.00000
SRR6145059	Scardovia	196081	G	9	0	9	0.00000
SRR6145059	Scapunavirus	2560225	G	1	0	1	0.00000
SRR6145059	Scandinavium	2726810	G	15	0	15	0.00000
SRR6145059	Saprospira	1007	G	5	0	5	0.00000
SRR6145059	Sansavirus	2733209	G	1	0	1	0.00000
SRR6145059	Sanovirus	2560222	G	12	0	12	0.00000
SRR6145059	Samunavirus	2560221	G	3	0	3	0.00000
SRR6145059	Salinivirga	1970191	G	10	0	10	0.00000
SRR6145059	Salinispira	1616789	G	6	0	6	0.00000
SRR6145059	Saliniradius	2661818	G	4	0	4	0.00000
SRR6145059	Salinimonas	288793	G	21	1	22	0.00000
SRR6145059	Salinigranum	1644057	G	34	0	34	0.00000
SRR6145059	Salinibaculum	2732368	G	21	2	23	0.00000
SRR6145059	Salinarchaeum	1269201	G	22	0	22	0.00000
SRR6145059	Salimicrobium	351195	G	3	0	3	0.00000
SRR6145059	Salegentibacter	143222	G	21	0	21	0.00000
SRR6145059	Salarchaeum	1075398	G	17	0	17	0.00000
SRR6145059	Salaquimonas	2712688	G	24	0	24	0.00000
SRR6145059	Saccharospirillum	231683	G	12	0	12	0.00000
SRR6145059	Saccharophagus	316625	G	8	0	8	0.00000
SRR6145059	Saccharolobus	2100760	G	1	0	1	0.00000
SRR6145059	Saccharibacillus	456492	G	19	0	19	0.00000
SRR6145059	Ruthyvirus	2733207	G	2	0	2	0.00000
SRR6145059	Ruthenibacterium	1905344	G	19	1	20	0.00000
SRR6145059	Rummeliibacillus	648802	G	9	0	9	0.00000
SRR6145059	Ruminococcus	1263	G	37	0	37	0.00000
SRR6145059	Ruminiclostridium	1508657	G	5	0	5	0.00000
SRR6145059	Rudivirus	187213	G	1	-1	0	0.00000
SRR6145059	Rubinisphaera	1649490	G	17	0	17	0.00000
SRR6145059	Roufvirus	1982370	G	1	-1	0	0.00000
SRR6145059	Roseolovirus	40272	G	4	0	4	0.00000
SRR6145059	Rosenblumvirus	680287	G	3	14	17	0.00000
SRR6145059	Roseimaritima	1579506	G	15	0	15	0.00000
SRR6145059	Roseiflexus	120961	G	40	1	41	0.00000
SRR6145059	Rosebushvirus	1982900	G	1	0	1	0.00000
SRR6145059	Roseburia	841	G	16	2	18	0.00000
SRR6145059	Romboutsia	1501226	G	26	0	26	0.00000
SRR6145059	Rodentibacter	1960084	G	4	2	6	0.00000
SRR6145059	Robiginitalea	252306	G	12	0	12	0.00000
SRR6145059	Rivularia	373984	G	7	0	7	0.00000
SRR6145059	Risjevirus	2732932	G	1	0	1	0.00000
SRR6145059	Rippkaea	2546365	G	10	0	10	0.00000
SRR6145059	Rimavirus	2560214	G	1	-1	0	0.00000
SRR6145059	Rhodopirellula	265488	G	12	0	12	0.00000
SRR6145059	Rhodoluna	529883	G	30	0	30	0.00000
SRR6145059	Rhodocytophaga	455076	G	26	0	26	0.00000
SRR6145059	Renibacterium	1645	G	18	0	18	0.00000
SRR6145059	Reinekea	230494	G	6	0	6	0.00000
SRR6145059	Ravinvirus	308911	G	1	4	5	0.00000
SRR6145059	Raphidiopsis	244599	G	7	0	7	0.00000
SRR6145059	Raleighvirus	2733203	G	2	0	2	0.00000
SRR6145059	Radnorvirus	1984782	G	4	0	4	0.00000
SRR6145059	Quhwahvirus	2733202	G	1	-1	0	0.00000
SRR6145059	Pyrolobus	54251	G	2	0	2	0.00000
SRR6145059	Pyrodictium	2308	G	1	0	1	0.00000
SRR6145059	Pyrococcus	2260	G	5	5	10	0.00000
SRR6145059	Pyrobaculum	2276	G	24	0	24	0.00000
SRR6145059	Pulverervirus	2169655	G	1	-1	0	0.00000
SRR6145059	Psychroserpens	49277	G	3	0	3	0.00000
SRR6145059	Psychromonas	67572	G	18	0	18	0.00000
SRR6145059	Psychromicrobium	2078575	G	35	0	35	0.00000
SRR6145059	Psychroflexus	83612	G	6	0	6	0.00000
SRR6145059	Psychrobacillus	1221880	G	8	7	15	0.00000
SRR6145059	Pseudovibrio	258255	G	19	0	19	0.00000
SRR6145059	Pseudothermotoga	1643951	G	5	0	5	0.00000
SRR6145059	Pseudopedobacter	1649482	G	34	1	35	0.00000
SRR6145059	Pseudolysobacter	2709666	G	37	0	37	0.00000
SRR6145059	Pseudohongiella	1524249	G	4	0	4	0.00000
SRR6145059	Pseudoclostridium	2304693	G	6	0	6	0.00000
SRR6145059	Pseudobutyrivibrio	46205	G	3	0	3	0.00000
SRR6145059	Pseudobacter	1860196	G	36	2	38	0.00000
SRR6145059	Pseudoarcobacter	2321113	G	11	10	21	0.00000
SRR6145059	Pseudescherichia	2055880	G	21	0	21	0.00000
SRR6145059	Pseudanabaena	1152	G	21	0	21	0.00000
SRR6145059	Przondovirus	1985720	G	1	0	1	0.00000
SRR6145059	Prymnesiovirus	181086	G	2	0	2	0.00000
SRR6145059	Proteiniphilum	294702	G	7	0	7	0.00000
SRR6145059	Prosthecochloris	1101	G	20	0	20	0.00000
SRR6145059	Prochlorococcus	1218	G	34	0	34	0.00000
SRR6145059	Priunavirus	2560210	G	1	0	1	0.00000
SRR6145059	Prasinovirus	181084	G	6	4	10	0.00000
SRR6145059	Pragia	82984	G	4	0	4	0.00000
SRR6145059	Pradovirus	1985733	G	2	0	2	0.00000
SRR6145059	Pradoshia	2651279	G	3	0	3	0.00000
SRR6145059	Potyvirus	12195	G	2	0	2	0.00000
SRR6145059	Pontimonas	1434032	G	12	0	12	0.00000
SRR6145059	Pontibacillus	289201	G	5	0	5	0.00000
SRR6145059	Polybotosvirus	2560207	G	1	1	2	0.00000
SRR6145059	Pokrovskaiavirus	2732916	G	1	0	1	0.00000
SRR6145059	Poindextervirus	2733154	G	1	0	1	0.00000
SRR6145059	Pleurocapsa	44474	G	3	0	3	0.00000
SRR6145059	Plesiomonas	702	G	13	0	13	0.00000
SRR6145059	Planktothrix	54304	G	4	0	4	0.00000
SRR6145059	Planktomarina	1284657	G	10	0	10	0.00000
SRR6145059	Planctopirus	1649480	G	21	0	21	0.00000
SRR6145059	Pistricoccus	1897649	G	31	0	31	0.00000
SRR6145059	Piscirickettsia	1237	G	12	0	12	0.00000
SRR6145059	Pipefishvirus	1982899	G	2	0	2	0.00000
SRR6145059	Picrophilus	46631	G	2	1	3	0.00000
SRR6145059	Picardvirus	2733201	G	2	0	2	0.00000
SRR6145059	Phyllobacterium	28100	G	34	2	36	0.00000
SRR6145059	Photorhabdus	29487	G	10	0	10	0.00000
SRR6145059	Photobacterium	657	G	31	0	31	0.00000
SRR6145059	Phoenicibacter	1981050	G	2	0	2	0.00000
SRR6145059	Phlebovirus	11584	G	1	2	3	0.00000
SRR6145059	Phistoryvirus	2733158	G	8	8	16	0.00000
SRR6145059	Phimunavirus	2560202	G	1	-1	0	0.00000
SRR6145059	Phikzvirus	680115	G	2	-2	0	0.00000
SRR6145059	Phikmvvirus	477967	G	2	-1	1	0.00000
SRR6145059	Phicbkvirus	1623296	G	3	0	3	0.00000
SRR6145059	Phascolarctobacterium	33024	G	10	0	10	0.00000
SRR6145059	Phabquatrovirus	2733123	G	3	0	3	0.00000
SRR6145059	Pettyvirus	2731671	G	1	0	1	0.00000
SRR6145059	Petrotoga	28236	G	3	0	3	0.00000
SRR6145059	Petrocella	2603323	G	4	0	4	0.00000
SRR6145059	Petrimonas	307628	G	13	0	13	0.00000
SRR6145059	Persephonella	182899	G	2	0	2	0.00000
SRR6145059	Permianibacter	1649479	G	14	0	14	0.00000
SRR6145059	Peptoclostridium	1481960	G	1	0	1	0.00000
SRR6145059	Pelosinus	365348	G	4	0	4	0.00000
SRR6145059	Pelolinea	1649478	G	4	0	4	0.00000
SRR6145059	Pelodictyon	1099	G	12	0	12	0.00000
SRR6145059	Pelobacter	18	G	36	1	37	0.00000
SRR6145059	Pelistega	106146	G	5	0	5	0.00000
SRR6145059	Pediococcus	1253	G	37	2	39	0.00000
SRR6145059	Patiencevirus	1982359	G	1	0	1	0.00000
SRR6145059	Parvularcula	208215	G	16	0	16	0.00000
SRR6145059	Parolsenella	2082587	G	18	17	35	0.00000
SRR6145059	Parashewanella	2547964	G	10	0	10	0.00000
SRR6145059	Parasedimentitalea	2738399	G	26	0	26	0.00000
SRR6145059	Parascardovia	196082	G	21	0	21	0.00000
SRR6145059	Parasaccharibacter	1602345	G	11	0	11	0.00000
SRR6145059	Paraprevotella	577309	G	15	2	17	0.00000
SRR6145059	Paraphotobacterium	2042066	G	9	0	9	0.00000
SRR6145059	Paraliobacillus	200903	G	5	0	5	0.00000
SRR6145059	Paraglaciecola	1621534	G	17	0	17	0.00000
SRR6145059	Parageobacillus	1906945	G	22	1	23	0.00000
SRR6145059	Paraclostridium	1849822	G	8	0	8	0.00000
SRR6145059	Parachlamydia	83551	G	3	0	3	0.00000
SRR6145059	Parabacteroides	375288	G	25	2	27	0.00000
SRR6145059	Pandoravirus	2060084	G	30	3	33	0.00000
SRR6145059	Pamexvirus	1982355	G	1	0	1	0.00000
SRR6145059	Paludibacter	346096	G	7	0	7	0.00000
SRR6145059	Pajaroellobacter	1882917	G	3	0	3	0.00000
SRR6145059	Pairvirus	2731963	G	1	0	1	0.00000
SRR6145059	Paenisporosarcina	651660	G	10	0	10	0.00000
SRR6145059	Paeniclostridium	1849828	G	18	0	18	0.00000
SRR6145059	Paadamvirus	2731961	G	1	0	1	0.00000
SRR6145059	Oxynema	1492710	G	11	0	11	0.00000
SRR6145059	Oxalobacter	846	G	4	0	4	0.00000
SRR6145059	Owenweeksia	267986	G	4	0	4	0.00000
SRR6145059	Otariodibacter	1249016	G	7	0	7	0.00000
SRR6145059	Oshimavirus	1623293	G	1	0	1	0.00000
SRR6145059	Oscillibacter	459786	G	12	12	24	0.00000
SRR6145059	Oscillatoria	1158	G	15	0	15	0.00000
SRR6145059	Orthotospovirus	2560196	G	1	0	1	0.00000
SRR6145059	Orthopoxvirus	10242	G	1	0	1	0.00000
SRR6145059	Ornithobacterium	28250	G	19	0	19	0.00000
SRR6145059	Orientia	69474	G	6	0	6	0.00000
SRR6145059	Orchidvirus	2560193	G	2	0	2	0.00000
SRR6145059	Oneupvirus	2733200	G	1	0	1	0.00000
SRR6145059	Omegavirus	1623292	G	3	0	3	0.00000
SRR6145059	Olleya	336276	G	23	1	24	0.00000
SRR6145059	Olivibacter	376469	G	7	16	23	0.00000
SRR6145059	Oligella	90243	G	6	0	6	0.00000
SRR6145059	Oleispira	188907	G	6	0	6	0.00000
SRR6145059	Oleiphilus	141450	G	11	0	11	0.00000
SRR6145059	Oenococcus	46254	G	7	0	7	0.00000
SRR6145059	Odoribacter	283168	G	14	15	29	0.00000
SRR6145059	Oceanobacillus	182709	G	37	0	37	0.00000
SRR6145059	Oceanithermus	208447	G	40	0	40	0.00000
SRR6145059	Oceanispirochaeta	2035349	G	4	0	4	0.00000
SRR6145059	Oceanisphaera	225143	G	13	0	13	0.00000
SRR6145059	Oceanimonas	129577	G	25	0	25	0.00000
SRR6145059	Oceanihabitans	2045416	G	11	0	11	0.00000
SRR6145059	Oceanicoccus	1084558	G	3	0	3	0.00000
SRR6145059	Obolenskvirus	1915205	G	7	0	7	0.00000
SRR6145059	Oblitimonas	1849530	G	10	8	18	0.00000
SRR6145059	Obesumbacterium	82982	G	3	3	6	0.00000
SRR6145059	Nymphadoravirus	2169636	G	7	1	8	0.00000
SRR6145059	Nyceiraevirus	2560192	G	1	0	1	0.00000
SRR6145059	Noxifervirus	2560190	G	2	0	2	0.00000
SRR6145059	Novibacillus	1677050	G	8	0	8	0.00000
SRR6145059	Nonanavirus	1921122	G	13	1	14	0.00000
SRR6145059	Nodularia	159191	G	17	2	19	0.00000
SRR6145059	Nitrososphaera	497726	G	8	0	8	0.00000
SRR6145059	Nitrosopumilus	338191	G	14	0	14	0.00000
SRR6145059	Nitrosococcus	1227	G	27	0	27	0.00000
SRR6145059	Nitrincola	267849	G	15	0	15	0.00000
SRR6145059	Nitratiruptor	269258	G	2	0	2	0.00000
SRR6145059	Nitratifractor	269260	G	9	0	9	0.00000
SRR6145059	Nissabacter	1964366	G	30	0	30	0.00000
SRR6145059	Nipunavirus	1982239	G	1	0	1	0.00000
SRR6145059	Nickievirus	2560188	G	2	0	2	0.00000
SRR6145059	Nibribacter	1649474	G	13	3	16	0.00000
SRR6145059	Niastella	354354	G	35	2	37	0.00000
SRR6145059	Niabella	379899	G	41	1	42	0.00000
SRR6145059	Neptunomonas	75687	G	7	0	7	0.00000
SRR6145059	Neorickettsia	33993	G	3	11	14	0.00000
SRR6145059	Neokomagataea	1223423	G	21	0	21	0.00000
SRR6145059	Neoasaia	320496	G	30	2	32	0.00000
SRR6145059	Ndongobacter	1930845	G	11	1	12	0.00000
SRR6145059	Nazgulvirus	2560186	G	1	0	1	0.00000
SRR6145059	Nautilia	191291	G	7	0	7	0.00000
SRR6145059	Natronorubrum	134813	G	32	1	33	0.00000
SRR6145059	Natronomonas	63743	G	38	0	38	0.00000
SRR6145059	Natronolimnobius	253106	G	21	0	21	0.00000
SRR6145059	Natronobacterium	2256	G	28	1	29	0.00000
SRR6145059	Natrialba	63742	G	18	3	21	0.00000
SRR6145059	Natranaerobius	375928	G	4	0	4	0.00000
SRR6145059	Nanhaivirus	2560183	G	1	0	1	0.00000
SRR6145059	Naesvirus	2733115	G	1	-1	0	0.00000
SRR6145059	Myxoctovirus	2560181	G	1	0	1	0.00000
SRR6145059	Mycoavidus	1810868	G	16	0	16	0.00000
SRR6145059	Muromegalovirus	10365	G	1	1	2	0.00000
SRR6145059	Muriicola	762641	G	7	0	7	0.00000
SRR6145059	Muricauda	111500	G	31	0	31	0.00000
SRR6145059	Muribaculum	1918540	G	17	0	17	0.00000
SRR6145059	Murdochiella	1161127	G	31	3	34	0.00000
SRR6145059	Mupapillomavirus	334202	G	1	19	20	0.00000
SRR6145059	Mucinivorans	1611681	G	12	20	32	0.00000
SRR6145059	Moritella	58050	G	20	0	20	0.00000
SRR6145059	Morganella	581	G	29	3	32	0.00000
SRR6145059	Moorella	44260	G	17	0	17	0.00000
SRR6145059	Moorea	1155738	G	15	0	15	0.00000
SRR6145059	Mooglevirus	1985303	G	2	0	2	0.00000
SRR6145059	Montyvirus	2733196	G	1	1	2	0.00000
SRR6145059	Molluscipoxvirus	10278	G	3	0	3	0.00000
SRR6145059	Moineauvirus	1623304	G	11	2	13	0.00000
SRR6145059	Mimivirus	315393	G	5	2	7	0.00000
SRR6145059	Mieseafarmvirus	1980921	G	1	0	1	0.00000
SRR6145059	Microvirgula	57479	G	38	0	38	0.00000
SRR6145059	Microcystis	1125	G	14	0	14	0.00000
SRR6145059	Microchaete	188910	G	10	9	19	0.00000
SRR6145059	Metrivirus	2560175	G	23	11	34	0.00000
SRR6145059	Methylovulum	762296	G	17	0	17	0.00000
SRR6145059	Methylovorus	81682	G	12	0	12	0.00000
SRR6145059	Methylotenera	359407	G	8	0	8	0.00000
SRR6145059	Methylophilus	16	G	21	1	22	0.00000
SRR6145059	Methylophaga	40222	G	17	0	17	0.00000
SRR6145059	Methylomusa	2093783	G	8	0	8	0.00000
SRR6145059	Methylocaldum	73778	G	24	0	24	0.00000
SRR6145059	Methylacidiphilum	511745	G	12	0	12	0.00000
SRR6145059	Methanotorris	196119	G	3	0	3	0.00000
SRR6145059	Methanothrix	2222	G	12	0	12	0.00000
SRR6145059	Methanothermus	2179	G	5	0	5	0.00000
SRR6145059	Methanothermococcus	155862	G	2	0	2	0.00000
SRR6145059	Methanothermobacter	145260	G	3	0	3	0.00000
SRR6145059	Methanospirillum	2202	G	3	0	3	0.00000
SRR6145059	Methanosphaerula	475087	G	3	0	3	0.00000
SRR6145059	Methanosphaera	2316	G	6	0	6	0.00000
SRR6145059	Methanosalsum	196136	G	4	0	4	0.00000
SRR6145059	Methanoregula	395331	G	8	0	8	0.00000
SRR6145059	Methanopyrus	2319	G	11	0	11	0.00000
SRR6145059	Methanoplanus	2314	G	3	0	3	0.00000
SRR6145059	Methanomethylovorans	101191	G	1	0	1	0.00000
SRR6145059	Methanomassiliicoccus	1080709	G	2	0	2	0.00000
SRR6145059	Methanolinea	499551	G	1	0	1	0.00000
SRR6145059	Methanolacinia	230355	G	2	0	2	0.00000
SRR6145059	Methanohalophilus	2175	G	3	0	3	0.00000
SRR6145059	Methanohalobium	2321	G	2	0	2	0.00000
SRR6145059	Methanofollis	81416	G	10	0	10	0.00000
SRR6145059	Methanofervidicoccus	2607661	G	3	0	3	0.00000
SRR6145059	Methanoculleus	45989	G	27	0	27	0.00000
SRR6145059	Methanocorpusculum	2192	G	1	0	1	0.00000
SRR6145059	Methanococcus	2184	G	24	0	24	0.00000
SRR6145059	Methanococcoides	2225	G	2	0	2	0.00000
SRR6145059	Methanocella	570266	G	18	2	20	0.00000
SRR6145059	Methanocaldococcus	196118	G	13	0	13	0.00000
SRR6145059	Methanobrevibacter	2172	G	18	0	18	0.00000
SRR6145059	Methanobacterium	2160	G	14	0	14	0.00000
SRR6145059	Metallosphaera	41980	G	14	0	14	0.00000
SRR6145059	Mesotoga	1184396	G	8	0	8	0.00000
SRR6145059	Mesoplasma	46239	G	18	0	18	0.00000
SRR6145059	Mesoflavibacter	444051	G	17	-17	0	0.00000
SRR6145059	Melissococcus	33969	G	8	0	8	0.00000
SRR6145059	Melioribacter	1134403	G	6	0	6	0.00000
SRR6145059	Megasphaera	906	G	26	1	27	0.00000
SRR6145059	Mediterraneibacter	2316020	G	33	6	39	0.00000
SRR6145059	Mastadenovirus	10509	G	1	0	1	0.00000
SRR6145059	Massilistercora	2717089	G	9	1	10	0.00000
SRR6145059	Marseillevirus	1513458	G	3	0	3	0.00000
SRR6145059	Marivivens	1759396	G	15	5	20	0.00000
SRR6145059	Marivirga	869806	G	13	3	16	0.00000
SRR6145059	Maritalea	623276	G	18	0	18	0.00000
SRR6145059	Mariprofundus	377315	G	10	0	10	0.00000
SRR6145059	Marinomonas	28253	G	19	0	19	0.00000
SRR6145059	Marinobacterium	48075	G	30	0	30	0.00000
SRR6145059	Marinitoga	160798	G	7	0	7	0.00000
SRR6145059	Marinithermus	186191	G	15	0	15	0.00000
SRR6145059	Marinirhabdus	1862153	G	10	0	10	0.00000
SRR6145059	Marinilactibacillus	191769	G	32	1	33	0.00000
SRR6145059	Mariniflexile	527198	G	14	0	14	0.00000
SRR6145059	Mariniblastus	2005380	G	16	0	16	0.00000
SRR6145059	Mahella	252965	G	4	3	7	0.00000
SRR6145059	Magnetospira	1182780	G	26	0	26	0.00000
SRR6145059	Magnetococcus	162171	G	7	0	7	0.00000
SRR6145059	Mageeibacillus	1637257	G	14	0	14	0.00000
SRR6145059	Lyssavirus	11286	G	1	0	1	0.00000
SRR6145059	Lymphocystivirus	10494	G	3	0	3	0.00000
SRR6145059	Lymphocryptovirus	10375	G	2	0	2	0.00000
SRR6145059	Luzseptimavirus	1982594	G	1	0	1	0.00000
SRR6145059	Lutibacter	358023	G	13	0	13	0.00000
SRR6145059	Lullwatervirus	2731957	G	1	0	1	0.00000
SRR6145059	Luckytenvirus	2733189	G	12	0	12	0.00000
SRR6145059	Lonsdalea	1082702	G	41	1	42	0.00000
SRR6145059	Longibaculum	1918538	G	11	3	14	0.00000
SRR6145059	Litorilituus	1407056	G	6	0	6	0.00000
SRR6145059	Litoricola	418700	G	8	6	14	0.00000
SRR6145059	Limnochorda	1676651	G	32	0	32	0.00000
SRR6145059	Limnobaculum	2172100	G	6	0	6	0.00000
SRR6145059	Limnobacter	131079	G	31	0	31	0.00000
SRR6145059	Limihaloglobus	2690160	G	4	0	4	0.00000
SRR6145059	Limestonevirus	2169534	G	1	-1	0	0.00000
SRR6145059	Limelightvirus	2731954	G	1	0	1	0.00000
SRR6145059	Limdunavirus	2169621	G	1	-1	0	0.00000
SRR6145059	Liefievirus	1623288	G	9	0	9	0.00000
SRR6145059	Liberibacter	34019	G	9	26	35	0.00000
SRR6145059	Libanicoccus	1935188	G	20	14	34	0.00000
SRR6145059	Lessievirus	1720323	G	1	0	1	0.00000
SRR6145059	Leptospirillum	179	G	30	0	30	0.00000
SRR6145059	Leptospira	171	G	41	-10	31	0.00000
SRR6145059	Lentilitoribacter	1649463	G	7	0	7	0.00000
SRR6145059	Lentibacillus	175304	G	3	0	3	0.00000
SRR6145059	Leminorella	82980	G	6	0	6	0.00000
SRR6145059	Leeuwenhoekiella	283735	G	7	0	7	0.00000
SRR6145059	Leadbetterella	319458	G	15	1	16	0.00000
SRR6145059	Laribacter	168470	G	37	3	40	0.00000
SRR6145059	Lacusarxvirus	2560165	G	1	0	1	0.00000
SRR6145059	Lacrimispora	2719231	G	14	0	14	0.00000
SRR6145059	Lacinutrix	291183	G	37	0	37	0.00000
SRR6145059	Lacimicrobium	1751872	G	6	0	6	0.00000
SRR6145059	Lachnospira	28050	G	13	0	13	0.00000
SRR6145059	Lachnoclostridium	1506553	G	29	2	31	0.00000
SRR6145059	Laceyella	292635	G	11	0	11	0.00000
SRR6145059	Labilibaculum	2060722	G	7	0	7	0.00000
SRR6145059	Kyrpidia	1129704	G	19	0	19	0.00000
SRR6145059	Kuttervirus	2169536	G	1	0	1	0.00000
SRR6145059	Kusarnavirus	2560164	G	1	0	1	0.00000
SRR6145059	Ktedonosporobacter	2692417	G	12	0	12	0.00000
SRR6145059	Kroppenstedtia	1274351	G	15	0	15	0.00000
SRR6145059	Krampusvirus	2733184	G	2	0	2	0.00000
SRR6145059	Kozakia	153497	G	32	5	37	0.00000
SRR6145059	Kosmotoga	651456	G	4	0	4	0.00000
SRR6145059	Kordia	221065	G	27	0	27	0.00000
SRR6145059	Kolesnikvirus	1985293	G	3	0	3	0.00000
SRR6145059	Kochitakasuvirus	1982590	G	2	0	2	0.00000
SRR6145059	Kochikohdavirus	2560160	G	1	19	20	0.00000
SRR6145059	Kingella	32257	G	19	0	19	0.00000
SRR6145059	Kineobactrum	2678529	G	36	0	36	0.00000
SRR6145059	Ketobacter	2025617	G	6	0	6	0.00000
SRR6145059	Kerstersia	257820	G	36	1	37	0.00000
SRR6145059	Kelmasvirus	2731950	G	1	0	1	0.00000
SRR6145059	Kelleziovirus	1982236	G	1	34	35	0.00000
SRR6145059	Karamvirus	1913650	G	2	0	2	0.00000
SRR6145059	Kangiella	261963	G	27	0	27	0.00000
SRR6145059	Kagunavirus	1910992	G	1	-1	0	0.00000
SRR6145059	Jwalphavirus	2169642	G	4	0	4	0.00000
SRR6145059	Jonquetella	428711	G	16	0	16	0.00000
SRR6145059	Jonesia	43673	G	30	0	30	0.00000
SRR6145059	Jilinvirus	1918725	G	1	-1	0	0.00000
SRR6145059	Jerseyvirus	1910991	G	1	-1	0	0.00000
SRR6145059	Jeotgalibacillus	157226	G	6	0	6	0.00000
SRR6145059	Jeotgalibaca	1470540	G	34	1	35	0.00000
SRR6145059	Izhakiella	1780190	G	22	0	22	0.00000
SRR6145059	Ithacavirus	2169643	G	2	0	2	0.00000
SRR6145059	Iodobacter	32014	G	8	0	8	0.00000
SRR6145059	Intestinimonas	1392389	G	3	35	38	0.00000
SRR6145059	Intestinibaculum	2679910	G	2	0	2	0.00000
SRR6145059	Ilyobacter	167639	G	8	0	8	0.00000
SRR6145059	Ignicoccus	54258	G	3	0	3	0.00000
SRR6145059	Ignavibacterium	795750	G	4	0	4	0.00000
SRR6145059	Idiomarina	135575	G	27	-7	20	0.00000
SRR6145059	Ichthyobacterium	1755829	G	6	0	6	0.00000
SRR6145059	Hyperthermus	54247	G	1	0	1	0.00000
SRR6145059	Hydrogenovibrio	28884	G	17	2	19	0.00000
SRR6145059	Hydrogenophilus	70774	G	20	0	20	0.00000
SRR6145059	Hydrogenobaculum	168657	G	2	-2	0	0.00000
SRR6145059	Hydrogenobacter	939	G	6	0	6	0.00000
SRR6145059	Hydrocarboniclastica	2650549	G	20	0	20	0.00000
SRR6145059	Hungatella	1649459	G	10	0	10	0.00000
SRR6145059	Hungateiclostridium	2304692	G	12	-1	11	0.00000
SRR6145059	Horusvirus	2733157	G	2	4	6	0.00000
SRR6145059	Histophilus	214906	G	17	1	18	0.00000
SRR6145059	Hirschia	2723	G	5	0	5	0.00000
SRR6145059	Hippea	84404	G	1	0	1	0.00000
SRR6145059	Herminiimonas	303379	G	30	6	36	0.00000
SRR6145059	Herbinix	1663717	G	3	0	3	0.00000
SRR6145059	Heliorestis	79598	G	3	0	3	0.00000
SRR6145059	Heliobacterium	2697	G	11	0	11	0.00000
SRR6145059	Hedwigvirus	2560146	G	7	0	7	0.00000
SRR6145059	Hathewaya	1769729	G	9	10	19	0.00000
SRR6145059	Hapavirus	1972611	G	1	2	3	0.00000
SRR6145059	Halovivax	332951	G	23	0	23	0.00000
SRR6145059	Halothiobacillus	109262	G	28	0	28	0.00000
SRR6145059	Halothermothrix	32636	G	6	0	6	0.00000
SRR6145059	Halothece	76023	G	2	0	2	0.00000
SRR6145059	Halotalea	376488	G	41	1	42	0.00000
SRR6145059	Halostella	1843185	G	15	1	16	0.00000
SRR6145059	Halostagnicola	353799	G	30	0	30	0.00000
SRR6145059	Haloquadratum	293431	G	3	0	3	0.00000
SRR6145059	Haloprofundus	1911573	G	26	0	26	0.00000
SRR6145059	Halopenitus	1209988	G	15	1	16	0.00000
SRR6145059	Halomicronema	170610	G	9	0	9	0.00000
SRR6145059	Halohasta	1450140	G	11	31	42	0.00000
SRR6145059	Halogeometricum	60846	G	13	0	13	0.00000
SRR6145059	Halodesulfurarchaeum	1980514	G	11	24	35	0.00000
SRR6145059	Halocynthiibacter	1579315	G	15	0	15	0.00000
SRR6145059	Halocella	46466	G	9	0	9	0.00000
SRR6145059	Halobellus	1073986	G	30	4	34	0.00000
SRR6145059	Halobacteroides	42417	G	6	0	6	0.00000
SRR6145059	Halobacteriovorax	1652133	G	17	0	17	0.00000
SRR6145059	Halobacillus	45667	G	12	0	12	0.00000
SRR6145059	Haliscomenobacter	2349	G	21	0	21	0.00000
SRR6145059	Halarcobacter	2321115	G	15	0	15	0.00000
SRR6145059	Halapricum	1542963	G	27	0	27	0.00000
SRR6145059	Halanaerobium	2330	G	11	0	11	0.00000
SRR6145059	Halanaeroarchaeum	1656823	G	16	0	16	0.00000
SRR6145059	Halalkalicoccus	332246	G	32	0	32	0.00000
SRR6145059	Halalkaliarchaeum	2678343	G	17	0	17	0.00000
SRR6145059	Hahella	158481	G	27	0	27	0.00000
SRR6145059	Hafnia	568	G	10	4	14	0.00000
SRR6145059	Haematospirillum	1804663	G	7	0	7	0.00000
SRR6145059	Haartmanvirus	2732018	G	1	0	1	0.00000
SRR6145059	Gynuella	1445504	G	11	0	11	0.00000
SRR6145059	Gyeongsanvirus	2731942	G	2	0	2	0.00000
SRR6145059	Guyparkeria	2035712	G	34	1	35	0.00000
SRR6145059	Gustavvirus	2560144	G	2	0	2	0.00000
SRR6145059	Gudongella	2692382	G	3	0	3	0.00000
SRR6145059	Grimontia	246861	G	24	0	24	0.00000
SRR6145059	Granulosicoccus	437504	G	21	0	21	0.00000
SRR6145059	Gracilibacillus	74385	G	2	0	2	0.00000
SRR6145059	Gottschalkia	1505664	G	7	0	7	0.00000
SRR6145059	Goodmanvirus	2733179	G	1	0	1	0.00000
SRR6145059	Glossinavirus	1285591	G	1	0	1	0.00000
SRR6145059	Gloeothece	28070	G	16	0	16	0.00000
SRR6145059	Gloeomargarita	1188227	G	5	4	9	0.00000
SRR6145059	Gloeocapsa	102231	G	29	1	30	0.00000
SRR6145059	Gloeobacter	33071	G	42	0	42	0.00000
SRR6145059	Glaesserella	2094023	G	26	2	28	0.00000
SRR6145059	Glaciecola	89404	G	24	0	24	0.00000
SRR6145059	Gilvibacter	379070	G	7	0	7	0.00000
SRR6145059	Gillisia	244698	G	6	0	6	0.00000
SRR6145059	Gilliamella	1193503	G	9	0	9	0.00000
SRR6145059	Gibbsiella	929812	G	39	0	39	0.00000
SRR6145059	Getalongvirus	2733156	G	10	4	14	0.00000
SRR6145059	Gesputvirus	2560138	G	1	0	1	0.00000
SRR6145059	Gequatrovirus	1910952	G	18	0	18	0.00000
SRR6145059	Geovibrio	46200	G	6	0	6	0.00000
SRR6145059	Geosporobacter	390805	G	5	0	5	0.00000
SRR6145059	Geoglobus	190818	G	6	0	6	0.00000
SRR6145059	Geoalkalibacter	392332	G	4	0	4	0.00000
SRR6145059	Geminocystis	669357	G	31	0	31	0.00000
SRR6145059	Gelderlandvirus	1913653	G	1	-1	0	0.00000
SRR6145059	Geitlerinema	63132	G	21	0	21	0.00000
SRR6145059	Gammaretrovirus	153135	G	5	0	5	0.00000
SRR6145059	Gamaleyavirus	1920753	G	1	0	1	0.00000
SRR6145059	Galunavirus	2560135	G	15	0	15	0.00000
SRR6145059	Gallionella	96	G	32	0	32	0.00000
SRR6145059	Gallibacterium	155493	G	8	0	8	0.00000
SRR6145059	Gallaecimonas	745410	G	13	5	18	0.00000
SRR6145059	Galaxyvirus	2560134	G	1	0	1	0.00000
SRR6145059	Gaiavirus	1982113	G	1	0	1	0.00000
SRR6145059	Fuerstia	1936111	G	25	0	25	0.00000
SRR6145059	Fromanvirus	186764	G	15	0	15	0.00000
SRR6145059	Friunavirus	1985711	G	3	0	3	0.00000
SRR6145059	Frischella	1335631	G	5	0	5	0.00000
SRR6145059	Frederiksenia	1649317	G	12	0	12	0.00000
SRR6145059	Fluviicola	332102	G	20	0	20	0.00000
SRR6145059	Fluviibacterium	2661844	G	31	3	34	0.00000
SRR6145059	Fluoribacter	461	G	4	-4	0	0.00000
SRR6145059	Flintibacter	1918454	G	12	0	12	0.00000
SRR6145059	Flexistipes	2351	G	2	0	2	0.00000
SRR6145059	Fletchervirus	1636618	G	1	-1	0	0.00000
SRR6145059	Flavonifractor	946234	G	24	1	25	0.00000
SRR6145059	Flavivirga	1209327	G	18	0	18	0.00000
SRR6145059	Flavihumibacter	1004301	G	29	1	30	0.00000
SRR6145059	Flagellimonas	444459	G	6	0	6	0.00000
SRR6145059	Fishburnevirus	1983734	G	1	1	2	0.00000
SRR6145059	Fimbriimonas	1005038	G	25	15	40	0.00000
SRR6145059	Filomicrobium	119044	G	20	0	20	0.00000
SRR6145059	Fictibacillus	1329200	G	20	0	20	0.00000
SRR6145059	Fibrobacter	832	G	7	7	14	0.00000
SRR6145059	Fervidobacterium	2422	G	12	0	12	0.00000
SRR6145059	Fervidicoccus	685950	G	1	0	1	0.00000
SRR6145059	Ferroplasma	74968	G	1	6	7	0.00000
SRR6145059	Ferriphaselus	1443590	G	22	0	22	0.00000
SRR6145059	Ferrimonas	44011	G	24	0	24	0.00000
SRR6145059	Fermentimonas	1784836	G	6	0	6	0.00000
SRR6145059	Fastidiosipila	236752	G	32	2	34	0.00000
SRR6145059	Faecalitalea	1573534	G	9	1	10	0.00000
SRR6145059	Faecalibaculum	1729679	G	4	3	7	0.00000
SRR6145059	Fabibacter	446458	G	9	0	9	0.00000
SRR6145059	Eyrevirus	2560129	G	2	0	2	0.00000
SRR6145059	Euzebyella	1287916	G	4	0	4	0.00000
SRR6145059	Euhalothece	65097	G	3	0	3	0.00000
SRR6145059	Ethanoligenens	253238	G	6	6	12	0.00000
SRR6145059	Erysipelothrix	1647	G	25	0	25	0.00000
SRR6145059	Erysipelatoclostridium	1505663	G	11	12	23	0.00000
SRR6145059	Ereboglobus	2028344	G	19	0	19	0.00000
SRR6145059	Epseptimavirus	2732017	G	1	0	1	0.00000
SRR6145059	Ephemerovirus	32613	G	1	0	1	0.00000
SRR6145059	Ephemeroptericola	2680021	G	12	0	12	0.00000
SRR6145059	Entomoplasma	46238	G	9	0	9	0.00000
SRR6145059	Enterovibrio	188143	G	1	0	1	0.00000
SRR6145059	Enterocloster	2719313	G	25	5	30	0.00000
SRR6145059	Eneladusvirus	2560128	G	2	0	2	0.00000
SRR6145059	Endozoicomonas	305899	G	10	0	10	0.00000
SRR6145059	Endomicrobium	1408194	G	4	0	4	0.00000
SRR6145059	Emdodecavirus	1980937	G	1	0	1	0.00000
SRR6145059	Emalynvirus	2560127	G	1	0	1	0.00000
SRR6145059	Elvirus	1984786	G	29	0	29	0.00000
SRR6145059	Elusimicrobium	423604	G	2	1	3	0.00000
SRR6145059	Elerivirus	2560126	G	1	0	1	0.00000
SRR6145059	Ehrlichia	943	G	9	-3	6	0.00000
SRR6145059	Eggerthella	84111	G	36	2	38	0.00000
SRR6145059	Edaphobacter	388463	G	10	0	10	0.00000
SRR6145059	Ectothiorhodospira	1051	G	36	1	37	0.00000
SRR6145059	Echinicola	390846	G	37	2	39	0.00000
SRR6145059	Dysosmobacter	2591381	G	3	4	7	0.00000
SRR6145059	Dysgonomonas	156973	G	11	0	11	0.00000
SRR6145059	Dyokappapapillomavirus	1513238	G	2	0	2	0.00000
SRR6145059	Duncaniella	2518495	G	13	-8	5	0.00000
SRR6145059	Draconibacterium	1471399	G	16	0	16	0.00000
SRR6145059	Doucettevirus	2169653	G	1	4	5	0.00000
SRR6145059	Dolichospermum	748770	G	8	12	20	0.00000
SRR6145059	Dokdonia	326319	G	16	0	16	0.00000
SRR6145059	Dismasvirus	2560122	G	4	0	4	0.00000
SRR6145059	Dinodnavirus	1232647	G	1	0	1	0.00000
SRR6145059	Dictyoglomus	13	G	7	0	7	0.00000
SRR6145059	Dichelobacter	869	G	3	0	3	0.00000
SRR6145059	Dialister	39948	G	39	0	39	0.00000
SRR6145059	Dhillonvirus	1623289	G	2	0	2	0.00000
SRR6145059	Devriesea	472568	G	33	0	33	0.00000
SRR6145059	Desulfurobacterium	64159	G	2	0	2	0.00000
SRR6145059	Desulfurivibrio	427922	G	18	0	18	0.00000
SRR6145059	Desulfurispirillum	393029	G	7	0	7	0.00000
SRR6145059	Desulfurella	33001	G	4	0	4	0.00000
SRR6145059	Desulfotomaculum	1562	G	18	0	18	0.00000
SRR6145059	Desulfotalea	109168	G	4	0	4	0.00000
SRR6145059	Desulfosporosinus	79206	G	15	0	15	0.00000
SRR6145059	Desulfomonile	2357	G	5	0	5	0.00000
SRR6145059	Desulfomicrobium	898	G	30	0	30	0.00000
SRR6145059	Desulfohalobium	45662	G	9	0	9	0.00000
SRR6145059	Desulfoglaeba	361106	G	12	0	12	0.00000
SRR6145059	Desulfofarcimen	2282742	G	5	0	5	0.00000
SRR6145059	Desulfocurvibacter	2582840	G	21	0	21	0.00000
SRR6145059	Desulfococcus	896	G	30	0	30	0.00000
SRR6145059	Desulfocapsa	53318	G	3	0	3	0.00000
SRR6145059	Desulfobacula	28222	G	5	0	5	0.00000
SRR6145059	Desulfobacterium	2295	G	2	0	2	0.00000
SRR6145059	Desulfobacter	2289	G	13	0	13	0.00000
SRR6145059	Desulfobacca	60892	G	7	0	7	0.00000
SRR6145059	Desulfitobacterium	36853	G	21	0	21	0.00000
SRR6145059	Desulfatibacillum	218207	G	19	0	19	0.00000
SRR6145059	Desulfarculus	453229	G	34	4	38	0.00000
SRR6145059	Desulfallas	2282740	G	7	0	7	0.00000
SRR6145059	Dermatophilus	1862	G	25	0	25	0.00000
SRR6145059	Derbicusvirus	2733102	G	4	0	4	0.00000
SRR6145059	Denitrovibrio	117999	G	5	0	5	0.00000
SRR6145059	Denitrobacterium	79603	G	5	0	5	0.00000
SRR6145059	Deltapolyomavirus	1891715	G	9	0	9	0.00000
SRR6145059	Deltaentomopoxvirus	2733302	G	1	0	1	0.00000
SRR6145059	Delepquintavirus	2560121	G	1	0	1	0.00000
SRR6145059	Dehalogenimonas	670486	G	12	0	12	0.00000
SRR6145059	Dehalococcoides	61434	G	5	0	5	0.00000
SRR6145059	Dehalobacterium	51514	G	4	0	4	0.00000
SRR6145059	Dehalobacter	56112	G	3	-1	2	0.00000
SRR6145059	Defluviitoga	1511648	G	3	0	3	0.00000
SRR6145059	Deferribacter	53572	G	6	0	6	0.00000
SRR6145059	Deefgea	400947	G	8	0	8	0.00000
SRR6145059	Dactylococcopsis	13034	G	8	1	9	0.00000
SRR6145059	Cytophaga	978	G	41	0	41	0.00000
SRR6145059	Cytomegalovirus	10358	G	3	0	3	0.00000
SRR6145059	Cyprinivirus	692606	G	4	0	4	0.00000
SRR6145059	Cylindrospermum	56106	G	5	0	5	0.00000
SRR6145059	Cycloclasticus	34067	G	6	0	6	0.00000
SRR6145059	Cyclobacterium	68288	G	20	0	20	0.00000
SRR6145059	Cyanothece	43988	G	19	0	19	0.00000
SRR6145059	Cyanobacterium	102234	G	8	0	8	0.00000
SRR6145059	Cuniculiplasma	1747777	G	3	0	3	0.00000
SRR6145059	Cryptobacterium	84162	G	6	0	6	0.00000
SRR6145059	Crocosphaera	263510	G	6	0	6	0.00000
SRR6145059	Croceibacter	216431	G	7	0	7	0.00000
SRR6145059	Crinalium	241421	G	13	7	20	0.00000
SRR6145059	Crateriforma	2714592	G	7	0	7	0.00000
SRR6145059	Crassaminicella	1848399	G	6	0	6	0.00000
SRR6145059	Coxiella	776	G	7	6	13	0.00000
SRR6145059	Cornellvirus	1910993	G	4	0	4	0.00000
SRR6145059	Corndogvirus	1623285	G	1	-1	0	0.00000
SRR6145059	Coriobacterium	33870	G	8	0	8	0.00000
SRR6145059	Coralvirus	2733171	G	1	-1	0	0.00000
SRR6145059	Coraliomargarita	442430	G	10	0	10	0.00000
SRR6145059	Coopervirus	1982898	G	7	0	7	0.00000
SRR6145059	Congregibacter	393661	G	11	0	11	0.00000
SRR6145059	Conexivisphaera	2613912	G	2	0	2	0.00000
SRR6145059	Commensalibacter	1079922	G	4	-4	0	0.00000
SRR6145059	Colossusvirus	2733153	G	7	0	7	0.00000
SRR6145059	Cohnella	329857	G	35	0	35	0.00000
SRR6145059	Cohaesibacter	655352	G	18	0	18	0.00000
SRR6145059	Coccolithovirus	346673	G	1	0	1	0.00000
SRR6145059	Cloacibacillus	508459	G	16	0	16	0.00000
SRR6145059	Citricoccus	169133	G	412	-412	0	0.00000
SRR6145059	Chthonomonas	1077265	G	7	0	7	0.00000
SRR6145059	Chryseolinea	1433993	G	21	13	34	0.00000
SRR6145059	Christensenella	990721	G	15	0	15	0.00000
SRR6145059	Chondrocystis	268175	G	6	0	6	0.00000
SRR6145059	Chlorovirus	181083	G	2	0	2	0.00000
SRR6145059	Chloroherpeton	100715	G	4	0	4	0.00000
SRR6145059	Chloroflexus	1107	G	19	-12	7	0.00000
SRR6145059	Chlorobium	1091	G	21	0	21	0.00000
SRR6145059	Chlorobaculum	256319	G	31	0	31	0.00000
SRR6145059	Chloriridovirus	10491	G	1	0	1	0.00000
SRR6145059	Chloracidobacterium	458032	G	11	0	11	0.00000
SRR6145059	Chlamydia	810	G	17	0	17	0.00000
SRR6145059	Chenonavirus	1623282	G	1	0	1	0.00000
SRR6145059	Charlievirus	1623280	G	4	-4	0	0.00000
SRR6145059	Changchengzhania	2049301	G	9	0	9	0.00000
SRR6145059	Chamaesiphon	217161	G	11	0	11	0.00000
SRR6145059	Cetia	1775691	G	4	0	4	0.00000
SRR6145059	Certrevirus	1914850	G	4	3	7	0.00000
SRR6145059	Cepunavirus	1982583	G	2	0	2	0.00000
SRR6145059	Cellulosilyticum	698776	G	5	0	5	0.00000
SRR6145059	Cellulophaga	104264	G	38	0	38	0.00000
SRR6145059	Cbastvirus	1918718	G	1	0	1	0.00000
SRR6145059	Catenovulum	1172191	G	16	0	16	0.00000
SRR6145059	Casimicrobium	2706000	G	40	2	42	0.00000
SRR6145059	Carlavirus	12163	G	1	0	1	0.00000
SRR6145059	Carboxydothermus	129957	G	3	0	3	0.00000
SRR6145059	Carboxydocella	178898	G	1	0	1	0.00000
SRR6145059	Caproiciproducens	1738645	G	11	0	11	0.00000
SRR6145059	Candidatus Moranella	1048757	G	2	-2	0	0.00000
SRR6145059	Caminibacter	191301	G	9	0	9	0.00000
SRR6145059	Caloramator	44258	G	5	0	5	0.00000
SRR6145059	Caldivirga	76886	G	1	0	1	0.00000
SRR6145059	Caldithrix	187144	G	8	0	8	0.00000
SRR6145059	Calditerrivibrio	545865	G	6	0	6	0.00000
SRR6145059	Caldisphaera	200414	G	5	0	5	0.00000
SRR6145059	Caldimicrobium	444090	G	3	0	3	0.00000
SRR6145059	Caldilinea	233191	G	21	0	21	0.00000
SRR6145059	Caldicellulosiruptor	44000	G	23	0	23	0.00000
SRR6145059	Caldanaerobacter	249529	G	2	0	2	0.00000
SRR6145059	Cafeteriavirus	1513234	G	1	0	1	0.00000
SRR6145059	Caeruleovirus	1911929	G	1	0	1	0.00000
SRR6145059	Bythopirellula	1400386	G	10	0	10	0.00000
SRR6145059	Butyrivibrio	830	G	17	0	17	0.00000
SRR6145059	Butyricimonas	574697	G	15	6	21	0.00000
SRR6145059	Buttiauxella	82976	G	19	0	19	0.00000
SRR6145059	Brussowvirus	1623303	G	1	-1	0	0.00000
SRR6145059	Brujitavirus	2169611	G	3	0	3	0.00000
SRR6145059	Bronvirus	1623278	G	1	-1	0	0.00000
SRR6145059	Britbratvirus	2560107	G	12	0	12	0.00000
SRR6145059	Brigitvirus	2733097	G	2	0	2	0.00000
SRR6145059	Bridgettevirus	2733170	G	2	0	2	0.00000
SRR6145059	Brevefilum	2019482	G	3	0	3	0.00000
SRR6145059	Bremerella	2714594	G	18	0	18	0.00000
SRR6145059	Brasilonema	383614	G	128	-128	0	0.00000
SRR6145059	Bowservirus	2560106	G	3	0	3	0.00000
SRR6145059	Borreliella	64895	G	14	-1	13	0.00000
SRR6145059	Borrelia	138	G	25	0	25	0.00000
SRR6145059	Bombella	1654741	G	2	0	2	0.00000
SRR6145059	Blattabacterium	34098	G	31	0	31	0.00000
SRR6145059	Bixzunavirus	680114	G	5	-5	0	0.00000
SRR6145059	Biseptimavirus	1623274	G	4	11	15	0.00000
SRR6145059	Bingvirus	2560103	G	3	0	3	0.00000
SRR6145059	Bibersteinia	476528	G	6	0	6	0.00000
SRR6145059	Betabaculovirus	558017	G	6	0	6	0.00000
SRR6145059	Bertelyvirus	2733152	G	1	0	1	0.00000
SRR6145059	Bernardetia	1937972	G	14	0	14	0.00000
SRR6145059	Bermanella	599651	G	5	0	5	0.00000
SRR6145059	Bequatrovirus	1917990	G	1	0	1	0.00000
SRR6145059	Bendigovirus	2560099	G	1	0	1	0.00000
SRR6145059	Belliella	232244	G	14	0	14	0.00000
SRR6145059	Beijerinckia	532	G	29	1	30	0.00000
SRR6145059	Begomovirus	10814	G	1	-1	0	0.00000
SRR6145059	Beggiatoa	1021	G	4	0	4	0.00000
SRR6145059	Baxtervirus	2169635	G	4	0	4	0.00000
SRR6145059	Basilea	1472344	G	6	0	6	0.00000
SRR6145059	Basfia	697331	G	11	17	28	0.00000
SRR6145059	Barbavirus	2733095	G	1	-1	0	0.00000
SRR6145059	Baoshanvirus	2732969	G	7	-7	0	0.00000
SRR6145059	Bantamvirus	2560096	G	1	0	1	0.00000
SRR6145059	Baikalvirus	2733094	G	3	0	3	0.00000
SRR6145059	Bacterioplanes	1537406	G	18	0	18	0.00000
SRR6145059	Avipoxvirus	10260	G	3	0	3	0.00000
SRR6145059	Avibacterium	292486	G	18	0	18	0.00000
SRR6145059	Aviadenovirus	10552	G	1	0	1	0.00000
SRR6145059	Austintatiousvirus	2733169	G	1	0	1	0.00000
SRR6145059	Aurivirus	1513230	G	1	0	1	0.00000
SRR6145059	Aureitalea	1176327	G	3	0	3	0.00000
SRR6145059	Attisvirus	2169652	G	6	-6	0	0.00000
SRR6145059	Athalassotoga	1769718	G	2	0	2	0.00000
SRR6145059	Asteriusvirus	2560094	G	1	0	1	0.00000
SRR6145059	Asaia	91914	G	24	0	24	0.00000
SRR6145059	Arsenophonus	637	G	12	0	12	0.00000
SRR6145059	Arenibacter	178469	G	13	0	13	0.00000
SRR6145059	Arcticibacterium	2173039	G	6	0	6	0.00000
SRR6145059	Archaeoglobus	2233	G	2	-1	1	0.00000
SRR6145059	Arcanobacterium	28263	G	34	1	35	0.00000
SRR6145059	Aquimarina	290174	G	29	0	29	0.00000
SRR6145059	Aquiflexum	280472	G	14	0	14	0.00000
SRR6145059	Aquifex	2713	G	3	0	3	0.00000
SRR6145059	Aqualcavirus	2560093	G	1	1	2	0.00000
SRR6145059	Apricotvirus	2733166	G	2	2	4	0.00000
SRR6145059	Appavirus	2733165	G	2	0	2	0.00000
SRR6145059	Apibacter	1778601	G	34	0	34	0.00000
SRR6145059	Antarcticibacterium	2058174	G	21	0	21	0.00000
SRR6145059	Anseongella	1773450	G	12	0	12	0.00000
SRR6145059	Anoxybacter	1769008	G	5	0	5	0.00000
SRR6145059	Aneurinibacillus	55079	G	14	1	15	0.00000
SRR6145059	Andhravirus	2732589	G	16	1	17	0.00000
SRR6145059	Anaplasma	768	G	7	0	7	0.00000
SRR6145059	Anaerotignum	2039240	G	1	0	1	0.00000
SRR6145059	Anaerostipes	207244	G	33	2	35	0.00000
SRR6145059	Anaerolinea	233189	G	12	0	12	0.00000
SRR6145059	Anaerohalosphaera	2690159	G	6	0	6	0.00000
SRR6145059	Anaerocolumna	1843210	G	9	0	9	0.00000
SRR6145059	Anaerobutyricum	2569097	G	21	2	23	0.00000
SRR6145059	Anabaenopsis	110103	G	5	1	6	0.00000
SRR6145059	Amphibacillus	29331	G	8	0	8	0.00000
SRR6145059	Ammonifex	42837	G	5	0	5	0.00000
SRR6145059	Aminomonas	81411	G	14	0	14	0.00000
SRR6145059	Aminobacterium	81466	G	1	0	1	0.00000
SRR6145059	Aminipila	2060094	G	10	0	10	0.00000
SRR6145059	Alphavirus	11019	G	2	0	2	0.00000
SRR6145059	Alphatristromavirus	2022739	G	1	0	1	0.00000
SRR6145059	Alphatrevirus	1910951	G	11	0	11	0.00000
SRR6145059	Alpharetrovirus	153057	G	1	1	2	0.00000
SRR6145059	Alphapolyomavirus	1891713	G	8	0	8	0.00000
SRR6145059	Alphapleolipovirus	1911604	G	2	0	2	0.00000
SRR6145059	Alphapapillomavirus	333750	G	2	0	2	0.00000
SRR6145059	Alphaentomopoxvirus	62098	G	1	0	1	0.00000
SRR6145059	Alphabaculovirus	558016	G	9	0	9	0.00000
SRR6145059	Allopseudarcicella	2676060	G	4	0	4	0.00000
SRR6145059	Alloprevotella	1283313	G	15	0	15	0.00000
SRR6145059	Allofrancisella	1869285	G	5	0	5	0.00000
SRR6145059	Allochromatium	85072	G	38	2	40	0.00000
SRR6145059	Alkalitalea	1193324	G	17	0	17	0.00000
SRR6145059	Alkaliphilus	114627	G	7	0	7	0.00000
SRR6145059	Aliivibrio	511678	G	24	0	24	0.00000
SRR6145059	Aliiarcobacter	2321111	G	14	0	14	0.00000
SRR6145059	Alicyclobacillus	29330	G	24	0	24	0.00000
SRR6145059	Algoriphagus	246875	G	19	0	19	0.00000
SRR6145059	Algibacter	261827	G	23	0	23	0.00000
SRR6145059	Alexandravirus	2733088	G	4	0	4	0.00000
SRR6145059	Ahniella	2233801	G	34	0	34	0.00000
SRR6145059	Ahduovirus	2560084	G	1	0	1	0.00000
SRR6145059	Agtrevirus	2169532	G	2	0	2	0.00000
SRR6145059	Agricanvirus	1984776	G	1	-1	0	0.00000
SRR6145059	Agarivorans	261825	G	6	0	6	0.00000
SRR6145059	Agarilytica	2036021	G	2	0	2	0.00000
SRR6145059	Aeropyrum	56635	G	6	1	7	0.00000
SRR6145059	Aeribacillus	1055323	G	14	0	14	0.00000
SRR6145059	Aequorivita	153265	G	12	0	12	0.00000
SRR6145059	Advenella	290425	G	39	0	39	0.00000
SRR6145059	Actinobaculum	76833	G	20	0	20	0.00000
SRR6145059	Actinobacillus	713	G	39	2	41	0.00000
SRR6145059	Aciduliprofundum	379546	G	5	0	5	0.00000
SRR6145059	Acidothermus	28048	G	41	0	41	0.00000
SRR6145059	Acidobacterium	33973	G	14	0	14	0.00000
SRR6145059	Acidisarcina	2608728	G	16	0	16	0.00000
SRR6145059	Acidimicrobium	53634	G	32	0	32	0.00000
SRR6145059	Acidilobus	105850	G	6	0	6	0.00000
SRR6145059	Acidiferrobacter	986106	G	20	0	20	0.00000
SRR6145059	Acidianus	12914	G	11	0	11	0.00000
SRR6145059	Acidaminococcus	904	G	13	0	13	0.00000
SRR6145059	Acholeplasma	2147	G	26	0	26	0.00000
SRR6145059	Acetomicrobium	49894	G	2	0	2	0.00000
SRR6145059	Acetohalobium	28186	G	4	0	4	0.00000
SRR6145059	Acetobacterium	33951	G	6	0	6	0.00000
SRR6145059	Acetoanaerobium	186831	G	10	0	10	0.00000
SRR6145059	Acaryochloris	155977	G	8	0	8	0.00000
SRR6145059	Acadianvirus	1982897	G	2	0	2	0.00000
SRR6145059	Absiella	2057233	G	13	0	13	0.00000
