sample	name	taxonomy_id	taxonomy_lvl	kraken_assigned_reads	added_reads	new_est_reads	fraction_total_reads
SRR6145059	Homo sapiens	9606	S	5310201	3274	5313475	0.63250
SRR6145059	Candidatus Saccharibacteria bacterium oral taxon 957	2572088	S	76	39	115	0.00001
SRR6145059	Candidatus Saccharibacteria bacterium oral taxon 955	2572087	S	17	24	41	0.00000
SRR6145059	Nostoc sp. 'Lobaria pulmonaria (5183) cyanobiont'	1618022	S	16	2	18	0.00000
SRR6145059	Blochmannia endosymbiont of Polyrhachis (Hedomyrma) turneri	1505596	S	6	0	6	0.00000
SRR6145059	Deinococcus soli Cha et al. 2016	1309411	S	297	131	428	0.00005
SRR6145059	Nostoc sp. 'Peltigera membranacea cyanobiont' N6	1261031	S	10	2	12	0.00000
SRR6145059	Paraburkholderia fungorum	134537	S	1028935	48039	1076974	0.12820
SRR6145059	Candidatus Saccharibacteria bacterium oral taxon 488	713059	S	178	71	249	0.00003
SRR6145059	Cutibacterium acnes	1747	S	568969	12837	581806	0.06926
SRR6145059	Sphingomonas ginsengisoli An et al. 2013	363835	S	234	4	238	0.00003
SRR6145059	Lymphocystis disease virus - isolate China	256729	S	1	0	1	0.00000
SRR6145059	Micrococcus luteus	1270	S	65138	37777	102915	0.01225
SRR6145059	Moraxella osloensis	34062	S	77705	1936	79641	0.00948
SRR6145059	Klebsiella michiganensis	1134687	S	3384	38256	41640	0.00496
SRR6145059	Staphylococcus epidermidis	1282	S	25491	6551	32042	0.00381
SRR6145059	Corynebacterium segmentosum	43990	S	29368	1214	30582	0.00364
SRR6145059	Tsukamurella tyrosinosolvens	57704	S	20537	1632	22169	0.00264
SRR6145059	Janibacter indicus	857417	S	19089	1661	20750	0.00247
SRR6145059	Dermacoccus nishinomiyaensis	1274	S	16028	664	16692	0.00199
SRR6145059	Cutibacterium granulosum	33011	S	15124	622	15746	0.00187
SRR6145059	Acinetobacter baumannii	470	S	3592	11142	14734	0.00175
SRR6145059	Staphylococcus saprophyticus	29385	S	10925	1332	12257	0.00146
SRR6145059	Gordonia terrae	2055	S	8797	2934	11731	0.00140
SRR6145059	Kytococcus sedentarius	1276	S	10543	693	11236	0.00134
SRR6145059	Staphylococcus hominis	1290	S	10231	936	11167	0.00133
SRR6145059	Micrococcus sp. KBS0714	1179670	S	2898	11167	14065	0.00167
SRR6145059	Gordonia bronchialis	2054	S	9437	530	9967	0.00119
SRR6145059	Paracoccus sanguinis	1545044	S	8975	983	9958	0.00119
SRR6145059	Staphylococcus warneri	1292	S	3322	6473	9795	0.00117
SRR6145059	Staphylococcus capitis	29388	S	8934	821	9755	0.00116
SRR6145059	Halomonas hydrothermalis	115561	S	8676	875	9551	0.00114
SRR6145059	Paracoccus yeei	147645	S	4938	4396	9334	0.00111
SRR6145059	Klebsiella oxytoca	571	S	2445	6873	9318	0.00111
SRR6145059	Klebsiella pneumoniae	573	S	1138	8154	9292	0.00111
SRR6145059	Corynebacterium ureicelerivorans	401472	S	8130	569	8699	0.00104
SRR6145059	Paraburkholderia caffeinilytica	1761016	S	8218	398	8616	0.00103
SRR6145059	Gordonia sp. JH63	2698900	S	7525	8485	16010	0.00191
SRR6145059	Staphylococcus sciuri	1296	S	7912	281	8193	0.00098
SRR6145059	Halomonas elongata	2746	S	8033	65	8098	0.00096
SRR6145059	Paraburkholderia aromaticivorans	2026199	S	7334	719	8053	0.00096
SRR6145059	Serratia marcescens	615	S	4610	2668	7278	0.00087
SRR6145059	Escherichia coli	562	S	375	6425	6800	0.00081
SRR6145059	Acinetobacter junii	40215	S	6139	535	6674	0.00079
SRR6145059	Chryseobacterium taklimakanense	536441	S	6054	435	6489	0.00077
SRR6145059	Acinetobacter johnsonii	40214	S	4223	1852	6075	0.00072
SRR6145059	Dietzia timorensis	499555	S	5164	881	6045	0.00072
SRR6145059	Staphylococcus aureus	1280	S	2074	3902	5976	0.00071
SRR6145059	Streptococcus mitis	28037	S	4825	1023	5848	0.00070
SRR6145059	Cutibacterium avidum	33010	S	5579	207	5786	0.00069
SRR6145059	Kocuria palustris	71999	S	5346	320	5666	0.00067
SRR6145059	Staphylococcus haemolyticus	1283	S	4430	925	5355	0.00064
SRR6145059	Pseudomonas aeruginosa	287	S	913	3928	4841	0.00058
SRR6145059	Microbacterium aurum	36805	S	4487	345	4832	0.00058
SRR6145059	Stenotrophomonas maltophilia	40324	S	2765	2061	4826	0.00057
SRR6145059	Citrobacter koseri	545	S	1848	2590	4438	0.00053
SRR6145059	Deinococcus wulumuqiensis	980427	S	3829	562	4391	0.00052
SRR6145059	Roseomonas mucosa	207340	S	1272	2792	4064	0.00048
SRR6145059	Staphylococcus cohnii	29382	S	3704	323	4027	0.00048
SRR6145059	Corynebacterium kroppenstedtii	161879	S	3586	67	3653	0.00043
SRR6145059	Neisseria mucosa	488	S	3010	579	3589	0.00043
SRR6145059	Kocuria indica	1049583	S	2026	1548	3574	0.00043
SRR6145059	Streptococcus pneumoniae	1313	S	1436	2056	3492	0.00042
SRR6145059	Finegoldia magna	1260	S	3171	312	3483	0.00041
SRR6145059	Staphylococcus pasteuri	45972	S	1531	1921	3452	0.00041
SRR6145059	Streptococcus oralis	1303	S	2491	912	3403	0.00041
SRR6145059	Corynebacterium sanguinis	2594913	S	2790	476	3266	0.00039
SRR6145059	Haemophilus parainfluenzae	729	S	2905	218	3123	0.00037
SRR6145059	Chryseobacterium arthrosphaerae	651561	S	2856	227	3083	0.00037
SRR6145059	Janibacter melonis	262209	S	2772	172	2944	0.00035
SRR6145059	Streptococcus sanguinis	1305	S	2748	126	2874	0.00034
SRR6145059	Janibacter limosus	53458	S	2712	159	2871	0.00034
SRR6145059	Rothia mucilaginosa	43675	S	2809	51	2860	0.00034
SRR6145059	Pseudomonas oryzihabitans	47885	S	2742	80	2822	0.00034
SRR6145059	Actinomyces oris	544580	S	1360	1340	2700	0.00032
SRR6145059	Corynebacterium matruchotii	43768	S	2654	18	2672	0.00032
SRR6145059	Streptococcus salivarius	1304	S	1559	1019	2578	0.00031
SRR6145059	Burkholderia dolosa	152500	S	1	2573	2574	0.00031
SRR6145059	Corynebacterium jeikeium	38289	S	1562	994	2556	0.00030
SRR6145059	Dietzia lutea	546160	S	2296	247	2543	0.00030
SRR6145059	Paraburkholderia terricola	169427	S	2414	112	2526	0.00030
SRR6145059	Corynebacterium striatum	43770	S	1938	546	2484	0.00030
SRR6145059	Paraburkholderia phytofirmans	261302	S	2129	308	2437	0.00029
SRR6145059	Brevundimonas naejangsanensis	588932	S	2148	272	2420	0.00029
SRR6145059	Pseudomonas putida	303	S	1508	855	2363	0.00028
SRR6145059	Actinomyces naeslundii	1655	S	1168	1193	2361	0.00028
SRR6145059	Rothia dentocariosa	2047	S	2248	81	2329	0.00028
SRR6145059	Burkholderia pseudomallei	28450	S	734	1583	2317	0.00028
SRR6145059	Sphingomonas melonis	152682	S	878	1405	2283	0.00027
SRR6145059	Acinetobacter schindleri	108981	S	1968	291	2259	0.00027
SRR6145059	Sphingobacterium daejeonense	371142	S	2119	133	2252	0.00027
SRR6145059	Microbacterium paraoxydans	199592	S	615	1635	2250	0.00027
SRR6145059	Paraburkholderia xenovorans	36873	S	1786	456	2242	0.00027
SRR6145059	Pseudomonas stutzeri	316	S	1904	316	2220	0.00026
SRR6145059	Acinetobacter ursingii	108980	S	2051	147	2198	0.00026
SRR6145059	Brevundimonas diminuta	293	S	942	1254	2196	0.00026
SRR6145059	Chryseobacterium sp. H6466	2487072	S	2455	2186	4641	0.00055
SRR6145059	Corynebacterium simulans	146827	S	1669	485	2154	0.00026
SRR6145059	Veillonella parvula	29466	S	2053	80	2133	0.00025
SRR6145059	Rhodococcus sp. PBTS 1	1653478	S	2102	117	2219	0.00026
SRR6145059	Paracoccus contaminans	1945662	S	1874	189	2063	0.00025
SRR6145059	Chryseobacterium sp. F5649	2487071	S	2409	2059	4468	0.00053
SRR6145059	Streptococcus gordonii	1302	S	1918	111	2029	0.00024
SRR6145059	Acinetobacter pittii	48296	S	1367	656	2023	0.00024
SRR6145059	Prevotella melaninogenica	28132	S	1764	225	1989	0.00024
SRR6145059	Sphingobium yanoikuyae	13690	S	861	1074	1935	0.00023
SRR6145059	Brevundimonas vesicularis	41276	S	852	978	1830	0.00022
SRR6145059	Corynebacterium singulare	161899	S	1535	272	1807	0.00022
SRR6145059	Lysobacter enzymogenes	69	S	1473	330	1803	0.00021
SRR6145059	Enterobacter hormaechei	158836	S	183	1604	1787	0.00021
SRR6145059	Enterobacter roggenkampii	1812935	S	757	995	1752	0.00021
SRR6145059	Chryseobacterium haifense	421525	S	1495	185	1680	0.00020
SRR6145059	Paraburkholderia caledonica	134536	S	1621	52	1673	0.00020
SRR6145059	Lawsonella clevelandensis	1528099	S	1642	27	1669	0.00020
SRR6145059	Schaalia odontolytica	1660	S	1586	59	1645	0.00020
SRR6145059	Neisseria subflava	28449	S	1364	251	1615	0.00019
SRR6145059	Aeromonas caviae	648	S	369	1244	1613	0.00019
SRR6145059	Lysobacter oculi	2698682	S	1454	128	1582	0.00019
SRR6145059	Rhizobium pusense	648995	S	364	1177	1541	0.00018
SRR6145059	Epidermidibacterium keratini	1891644	S	1450	16	1466	0.00017
SRR6145059	Paraburkholderia graminis	60548	S	1393	67	1460	0.00017
SRR6145059	Agrobacterium tumefaciens	358	S	915	528	1443	0.00017
SRR6145059	Gemella haemolysans	1379	S	1378	54	1432	0.00017
SRR6145059	Pseudomonas fluorescens	294	S	1018	403	1421	0.00017
SRR6145059	Brevundimonas vancanneytii	1325724	S	411	998	1409	0.00017
SRR6145059	Acinetobacter indicus	756892	S	1257	143	1400	0.00017
SRR6145059	Klebsiella grimontii	2058152	S	63	1324	1387	0.00017
SRR6145059	Bacillus cereus	1396	S	565	822	1387	0.00017
SRR6145059	Corynebacterium minutissimum	38301	S	1262	119	1381	0.00016
SRR6145059	Xanthomonas campestris	339	S	1150	192	1342	0.00016
SRR6145059	Tsukamurella paurometabola	2061	S	1238	88	1326	0.00016
SRR6145059	Corynebacterium aurimucosum	169292	S	1189	133	1322	0.00016
SRR6145059	Actinomyces viscosus	1656	S	1259	59	1318	0.00016
SRR6145059	Klebsiella variicola	244366	S	149	1153	1302	0.00015
SRR6145059	Deinococcus radiodurans	1299	S	1126	176	1302	0.00015
SRR6145059	Methylorubrum populi	223967	S	992	298	1290	0.00015
SRR6145059	Lautropia mirabilis	47671	S	1259	24	1283	0.00015
SRR6145059	Mycobacteroides chelonae	1774	S	371	885	1256	0.00015
SRR6145059	Roseomonas sp. FDAARGOS_362	2018065	S	764	1251	2015	0.00024
SRR6145059	Brevundimonas mediterranea	74329	S	1072	173	1245	0.00015
SRR6145059	Fusobacterium nucleatum	851	S	1066	152	1218	0.00014
SRR6145059	Prevotella intermedia	28131	S	1112	103	1215	0.00014
SRR6145059	Kocuria sp. KD4	2719588	S	1704	1210	2914	0.00035
SRR6145059	Kocuria rhizophila	72000	S	391	810	1201	0.00014
SRR6145059	Rothia aeria	172042	S	1154	40	1194	0.00014
SRR6145059	Brevibacterium linens	1703	S	778	412	1190	0.00014
SRR6145059	Corynebacterium diphtheriae	1717	S	460	691	1151	0.00014
SRR6145059	Comamonas aquatica	225991	S	1078	68	1146	0.00014
SRR6145059	Corynebacterium glutamicum	1718	S	101	1040	1141	0.00014
SRR6145059	Pseudomonas alcaligenes	43263	S	1092	43	1135	0.00014
SRR6145059	Salmonella enterica	28901	S	207	914	1121	0.00013
SRR6145059	Brachybacterium saurashtrense	556288	S	969	145	1114	0.00013
SRR6145059	Enterobacter cloacae	550	S	375	738	1113	0.00013
SRR6145059	Paraburkholderia terrae	311230	S	897	213	1110	0.00013
SRR6145059	Pseudoxanthomonas suwonensis	314722	S	943	158	1101	0.00013
SRR6145059	Acinetobacter lwoffii	28090	S	554	543	1097	0.00013
SRR6145059	Neisseria elongata	495	S	977	85	1062	0.00013
SRR6145059	Mycolicibacterium gilvum	1804	S	735	315	1050	0.00012
SRR6145059	Burkholderia sp. OLGA172	1804984	S	21607	1047	22654	0.00270
SRR6145059	Corynebacterium mycetoides	38302	S	889	155	1044	0.00012
SRR6145059	Halomonas meridiana	29570	S	939	80	1019	0.00012
SRR6145059	Brevibacterium luteolum	199591	S	932	82	1014	0.00012
SRR6145059	Klebsiella sp. M5al	1934254	S	48	995	1043	0.00012
SRR6145059	Gordonia alkanivorans	84096	S	335	649	984	0.00012
SRR6145059	Sphingopyxis macrogoltabida	33050	S	729	223	952	0.00011
SRR6145059	Paraburkholderia caribensis	75105	S	857	80	937	0.00011
SRR6145059	Acinetobacter sp. DUT-2	1809055	S	596	937	1533	0.00018
SRR6145059	Gordonia polyisoprenivorans	84595	S	899	21	920	0.00011
SRR6145059	Mycobacterium sp. QIA-37	1561223	S	195	907	1102	0.00013
SRR6145059	Microbacterium hominis	162426	S	845	59	904	0.00011
SRR6145059	Brachybacterium faecium	43669	S	756	143	899	0.00011
SRR6145059	Achromobacter xylosoxidans	85698	S	575	306	881	0.00010
SRR6145059	Massilia oculi	945844	S	802	67	869	0.00010
SRR6145059	Delftia tsuruhatensis	180282	S	497	363	860	0.00010
SRR6145059	Gardnerella vaginalis	2702	S	835	18	853	0.00010
SRR6145059	Mycolicibacterium phocaicum	319706	S	709	139	848	0.00010
SRR6145059	Brevundimonas sp. 'scallop'	2562582	S	1058	848	1906	0.00023
SRR6145059	Variovorax paradoxus	34073	S	699	146	845	0.00010
SRR6145059	Rhodococcus erythropolis	1833	S	232	605	837	0.00010
SRR6145059	Paraburkholderia sp. Msb3	2604047	S	4614	837	5451	0.00065
SRR6145059	Sphingobacterium hotanense	649196	S	808	28	836	0.00010
SRR6145059	Paraburkholderia megapolitana	420953	S	827	9	836	0.00010
SRR6145059	Corynebacterium xerosis	1725	S	759	77	836	0.00010
SRR6145059	Mycolicibacterium aurum	1791	S	761	74	835	0.00010
SRR6145059	Brevundimonas sp. DS20	1532555	S	475	824	1299	0.00015
SRR6145059	Staphylococcus caprae	29380	S	750	72	822	0.00010
SRR6145059	Gordonia iterans	1004901	S	759	55	814	0.00010
SRR6145059	Actinomyces radicidentis	111015	S	756	50	806	0.00010
SRR6145059	Acinetobacter haemolyticus	29430	S	695	110	805	0.00010
SRR6145059	Conexibacter woesei	191495	S	795	7	802	0.00010
SRR6145059	Rhodopseudomonas palustris	1076	S	675	123	798	0.00009
SRR6145059	Streptococcus gwangjuense	1433513	S	602	194	796	0.00009
SRR6145059	Kocuria sp. BT304	1702043	S	384	796	1180	0.00014
SRR6145059	Haematobacter massiliensis	195105	S	624	170	794	0.00009
SRR6145059	Paraburkholderia sprentiae	948107	S	763	27	790	0.00009
SRR6145059	Paraburkholderia hospita	169430	S	660	123	783	0.00009
SRR6145059	Mycolicibacterium psychrotolerans	216929	S	713	69	782	0.00009
SRR6145059	Mycobacterium tuberculosis	1773	S	12	769	781	0.00009
SRR6145059	Neisseria meningitidis	487	S	282	493	775	0.00009
SRR6145059	Brevundimonas sp. GW460-12-10-14-LB2	1827469	S	1057	775	1832	0.00022
SRR6145059	Methylorubrum extorquens	408	S	396	376	772	0.00009
SRR6145059	Ralstonia solanacearum	305	S	450	318	768	0.00009
SRR6145059	Sorangium cellulosum	56	S	736	29	765	0.00009
SRR6145059	Sphingomonas koreensis	93064	S	579	185	764	0.00009
SRR6145059	Brachybacterium ginsengisoli	1331682	S	640	124	764	0.00009
SRR6145059	Rhodobacter sphaeroides	1063	S	689	74	763	0.00009
SRR6145059	Streptococcus cristatus	45634	S	711	50	761	0.00009
SRR6145059	Paracoccus zhejiangensis	1077935	S	666	95	761	0.00009
SRR6145059	Paraburkholderia phenoliruptrix	252970	S	430	328	758	0.00009
SRR6145059	Deinococcus ficus	317577	S	735	11	746	0.00009
SRR6145059	Aeromonas sp. ASNIH7	1920107	S	99	737	836	0.00010
SRR6145059	Paracoccus aminovorans	34004	S	653	81	734	0.00009
SRR6145059	Mycobacterium grossiae	1552759	S	671	63	734	0.00009
SRR6145059	Nakamurella multipartita	53461	S	715	18	733	0.00009
SRR6145059	Gordonia rubripertincta	36822	S	583	146	729	0.00009
SRR6145059	Roseomonas gilardii	257708	S	672	55	727	0.00009
SRR6145059	Microbacterium sp. PAMC 28756	1795053	S	719	475	1194	0.00014
SRR6145059	Corynebacterium glaucum	187491	S	689	25	714	0.00008
SRR6145059	Peptoniphilus harei	54005	S	676	37	713	0.00008
SRR6145059	Dietzia sp. DQ12-45-1b	912801	S	127	713	840	0.00010
SRR6145059	Corynebacterium imitans	156978	S	663	50	713	0.00008
SRR6145059	Janthinobacterium svalbardensis	368607	S	444	267	711	0.00008
SRR6145059	Dietzia psychralcaliphila	139021	S	670	39	709	0.00008
SRR6145059	Stenotrophomonas acidaminiphila	128780	S	555	148	703	0.00008
SRR6145059	Acidovorax avenae	80867	S	517	185	702	0.00008
SRR6145059	Corynebacterium genitalium	38288	S	668	33	701	0.00008
SRR6145059	Chryseobacterium indologenes	253	S	644	55	699	0.00008
SRR6145059	Klebsiella quasipneumoniae	1463165	S	128	564	692	0.00008
SRR6145059	Brevundimonas sp. SGAir0440	2579977	S	2313	689	3002	0.00036
SRR6145059	Paracoccus pantotrophus	82367	S	604	77	681	0.00008
SRR6145059	Burkholderia cenocepacia	95486	S	518	159	677	0.00008
SRR6145059	Gordonia insulae	2420509	S	649	26	675	0.00008
SRR6145059	Dolosigranulum pigrum	29394	S	663	12	675	0.00008
SRR6145059	Brevundimonas sp. Bb-A	2560058	S	386	665	1051	0.00013
SRR6145059	Acinetobacter nosocomialis	106654	S	547	118	665	0.00008
SRR6145059	Cloacibacterium normanense	237258	S	641	21	662	0.00008
SRR6145059	Marmoricola scoriae	642780	S	565	87	652	0.00008
SRR6145059	Chryseobacterium gleum	250	S	558	94	652	0.00008
SRR6145059	Klebsiella aerogenes	548	S	516	135	651	0.00008
SRR6145059	Rhizobium oryzihabitans	2267833	S	75	569	644	0.00008
SRR6145059	Pseudomonas mendocina	300	S	588	55	643	0.00008
SRR6145059	Pimelobacter simplex	2045	S	534	104	638	0.00008
SRR6145059	Deinococcus actinosclerus	1768108	S	503	129	632	0.00008
SRR6145059	Streptomyces venezuelae	54571	S	555	75	630	0.00007
SRR6145059	Pseudopropionibacterium propionicum	1750	S	619	7	626	0.00007
SRR6145059	Caulobacter flavus	1679497	S	537	89	626	0.00007
SRR6145059	Klebsiella sp. LTGPAF-6F	1905288	S	11	617	628	0.00007
SRR6145059	Serinicoccus profundi	1078471	S	538	68	606	0.00007
SRR6145059	Paracoccus denitrificans	266	S	529	77	606	0.00007
SRR6145059	Enterobacteriaceae bacterium ENNIH2	1920109	S	5	606	611	0.00007
SRR6145059	Methylobacterium currus	2051553	S	499	101	600	0.00007
SRR6145059	Cupriavidus malaysiensis	367825	S	194	403	597	0.00007
SRR6145059	Sinorhizobium meliloti	382	S	157	437	594	0.00007
SRR6145059	Micropruina glycogenica	75385	S	579	15	594	0.00007
SRR6145059	Corynebacterium casei	160386	S	433	159	592	0.00007
SRR6145059	Streptococcus australis	113107	S	477	112	589	0.00007
SRR6145059	Mycobacteroides abscessus	36809	S	401	185	586	0.00007
SRR6145059	Sphingobium cloacae	120107	S	310	275	585	0.00007
SRR6145059	Corynebacterium variabile	1727	S	511	74	585	0.00007
SRR6145059	Sphingomonas sanxanigenens	397260	S	468	116	584	0.00007
SRR6145059	Methylobacterium radiotolerans	31998	S	150	432	582	0.00007
SRR6145059	Arthrospira platensis	118562	S	319	261	580	0.00007
SRR6145059	Brevundimonas subvibrioides	74313	S	552	26	578	0.00007
SRR6145059	Janthinobacterium agaricidamnosum	55508	S	463	114	577	0.00007
SRR6145059	Prevotella jejuni	1177574	S	513	62	575	0.00007
SRR6145059	Nocardia cyriacigeorgica	135487	S	487	86	573	0.00007
SRR6145059	Phenylobacterium zucineum	284016	S	523	47	570	0.00007
SRR6145059	Rhizobium sp. S41	1869170	S	132	568	700	0.00008
SRR6145059	Cupriavidus taiwanensis	164546	S	521	45	566	0.00007
SRR6145059	Citrobacter freundii	546	S	134	431	565	0.00007
SRR6145059	Brachybacterium vulturis	2017484	S	428	137	565	0.00007
SRR6145059	Arthrobacter sp. NEB 688	904039	S	561	29	590	0.00007
SRR6145059	Aquabacterium olei	1296669	S	516	43	559	0.00007
SRR6145059	Corynebacterium camporealensis	161896	S	520	38	558	0.00007
SRR6145059	Nocardia brasiliensis	37326	S	478	77	555	0.00007
SRR6145059	Bosea vaviloviae	1526658	S	490	62	552	0.00007
SRR6145059	Brachybacterium avium	2017485	S	420	131	551	0.00007
SRR6145059	Azospirillum brasilense	192	S	382	168	550	0.00007
SRR6145059	Microbacterium chocolatum	84292	S	520	29	549	0.00007
SRR6145059	Nocardioides humi	449461	S	478	70	548	0.00007
SRR6145059	Mycolicibacterium vanbaalenii	110539	S	400	147	547	0.00007
SRR6145059	Mycobacterium sp. KMS	189918	S	86	546	632	0.00008
SRR6145059	Paracoccus jeotgali	2065379	S	512	32	544	0.00006
SRR6145059	Gordonia sp. 135	2676309	S	302	544	846	0.00010
SRR6145059	Abiotrophia defectiva	46125	S	539	5	544	0.00006
SRR6145059	Cupriavidus pauculus	82633	S	522	21	543	0.00006
SRR6145059	Brevibacterium aurantiacum	273384	S	430	108	538	0.00006
SRR6145059	Acinetobacter soli	487316	S	524	13	537	0.00006
SRR6145059	Burkholderia cepacia	292	S	465	71	536	0.00006
SRR6145059	Sphingomonas paucimobilis	13689	S	487	48	535	0.00006
SRR6145059	Mycolicibacterium parafortuitum	39692	S	475	59	534	0.00006
SRR6145059	Nocardioides dokdonensis	450734	S	418	114	532	0.00006
SRR6145059	Sphingobacterium sp. G1-14	2003121	S	579	530	1109	0.00013
SRR6145059	Elizabethkingia anophelis	1117645	S	448	82	530	0.00006
SRR6145059	Neisseria flavescens	484	S	408	121	529	0.00006
SRR6145059	Methylobacterium sp. XJLW	739141	S	56	529	585	0.00007
SRR6145059	Comamonas testosteroni	285	S	363	163	526	0.00006
SRR6145059	Streptococcus pseudopneumoniae	257758	S	363	162	525	0.00006
SRR6145059	Janthinobacterium sp. SNU WT3	2590869	S	523	332	855	0.00010
SRR6145059	Mycolicibacterium mageritense	53462	S	469	52	521	0.00006
SRR6145059	Geodermatophilus obscurus	1861	S	476	38	514	0.00006
SRR6145059	Staphylococcus lugdunensis	28035	S	484	27	511	0.00006
SRR6145059	Rhizobium leguminosarum	384	S	393	117	510	0.00006
SRR6145059	Deinococcus gobiensis	502394	S	498	12	510	0.00006
SRR6145059	Veillonella atypica	39777	S	491	18	509	0.00006
SRR6145059	Sphingopyxis granuli	267128	S	106	400	506	0.00006
SRR6145059	Chroococcidiopsis thermalis	54299	S	490	16	506	0.00006
SRR6145059	Blastococcus saxobsidens	138336	S	472	34	506	0.00006
SRR6145059	Acinetobacter radioresistens	40216	S	486	19	505	0.00006
SRR6145059	Haemophilus haemolyticus	726	S	424	80	504	0.00006
SRR6145059	Raoultella terrigena	577	S	336	167	503	0.00006
SRR6145059	Microbacterium sp. No. 7	1714373	S	503	52	555	0.00007
SRR6145059	Veillonella dispar	39778	S	476	26	502	0.00006
SRR6145059	Sphingobium amiense	135719	S	251	250	501	0.00006
SRR6145059	Burkholderia gladioli	28095	S	474	21	495	0.00006
SRR6145059	Sphingomonas taxi	1549858	S	470	22	492	0.00006
SRR6145059	Anaerococcus prevotii	33034	S	454	35	489	0.00006
SRR6145059	Mycolicibacterium poriferae	39694	S	122	363	485	0.00006
SRR6145059	Pantoea dispersa	59814	S	396	88	484	0.00006
SRR6145059	Corynebacterium urealyticum	43771	S	397	86	483	0.00006
SRR6145059	Mycolicibacterium gadium	1794	S	377	105	482	0.00006
SRR6145059	Pseudomonas monteilii	76759	S	144	336	480	0.00006
SRR6145059	Haemophilus influenzae	727	S	293	180	473	0.00006
SRR6145059	Fusobacterium pseudoperiodonticum	2663009	S	386	87	473	0.00006
SRR6145059	Alicycliphilus denitrificans	179636	S	303	170	473	0.00006
SRR6145059	Luteipulveratus mongoliensis	571913	S	467	5	472	0.00006
SRR6145059	Ramlibacter tataouinensis	94132	S	451	19	470	0.00006
SRR6145059	Mycolicibacterium vaccae	1810	S	417	52	469	0.00006
SRR6145059	Citrobacter sp. SL156	2079228	S	4	467	471	0.00006
SRR6145059	Sphingopyxis lindanitolerans	2054227	S	350	116	466	0.00006
SRR6145059	Massilia putida	1141883	S	379	87	466	0.00006
SRR6145059	Modestobacter marinus	477641	S	433	30	463	0.00006
SRR6145059	Sphingopyxis fribergensis	1515612	S	351	111	462	0.00005
SRR6145059	Paraburkholderia phymatum	148447	S	439	23	462	0.00005
SRR6145059	Microbacterium foliorum	104336	S	435	27	462	0.00005
SRR6145059	Pseudomonas otitidis	319939	S	447	12	459	0.00005
SRR6145059	Stenotrophomonas rhizophila	216778	S	385	73	458	0.00005
SRR6145059	Proteus mirabilis	584	S	398	60	458	0.00005
SRR6145059	Mycolicibacterium frederiksbergense	117567	S	341	116	457	0.00005
SRR6145059	Lysobacter capsici	435897	S	375	80	455	0.00005
SRR6145059	Methylobacterium terrae	2202827	S	390	63	453	0.00005
SRR6145059	Methylobacterium aquaticum	270351	S	396	57	453	0.00005
SRR6145059	Corynebacterium resistens	258224	S	392	57	449	0.00005
SRR6145059	Corynebacterium flavescens	28028	S	425	24	449	0.00005
SRR6145059	Acidipropionibacterium acidipropionici	1748	S	351	93	444	0.00005
SRR6145059	Sulfitobacter donghicola	421000	S	2	438	440	0.00005
SRR6145059	Clavibacter michiganensis	28447	S	415	23	438	0.00005
SRR6145059	Streptococcus sp. NPS 308	1902136	S	437	99	536	0.00006
SRR6145059	Propionibacterium freudenreichii	1744	S	321	116	437	0.00005
SRR6145059	Mycolicibacterium chubuense	1800	S	379	55	434	0.00005
SRR6145059	Pseudomonas fragi	296	S	219	210	429	0.00005
SRR6145059	Gemella morbillorum	29391	S	379	49	428	0.00005
SRR6145059	Xanthomonas citri	346	S	82	343	425	0.00005
SRR6145059	Agrococcus carbonis	684552	S	387	38	425	0.00005
SRR6145059	Streptococcus thermophilus	1308	S	339	85	424	0.00005
SRR6145059	Bosea sp. Tri-49	1867715	S	3376	424	3800	0.00045
SRR6145059	Defluviimonas alba	1335048	S	346	77	423	0.00005
SRR6145059	Mycolicibacterium fortuitum	1766	S	361	61	422	0.00005
SRR6145059	Corynebacterium timonense	441500	S	406	15	421	0.00005
SRR6145059	Corynebacterium riegelii	156976	S	392	26	418	0.00005
SRR6145059	Bosea sp. PAMC 26642	1792307	S	418	47	465	0.00006
SRR6145059	Ornithinimicrobium flavum	1288636	S	361	56	417	0.00005
SRR6145059	Burkholderia multivorans	87883	S	381	36	417	0.00005
SRR6145059	Mycolicibacterium duvalii	39688	S	366	50	416	0.00005
SRR6145059	Mycobacterium avium	1764	S	257	158	415	0.00005
SRR6145059	Acinetobacter bereziniae	106648	S	408	5	413	0.00005
SRR6145059	Methylobacterium brachiatum	269660	S	350	62	412	0.00005
SRR6145059	Paracoccus mutanolyticus	1499308	S	133	278	411	0.00005
SRR6145059	Acidovorax sp. JS42	232721	S	52	410	462	0.00005
SRR6145059	Kocuria rosea	1275	S	389	20	409	0.00005
SRR6145059	Sinorhizobium fredii	380	S	278	130	408	0.00005
SRR6145059	Staphylococcus kloosii	29384	S	389	14	403	0.00005
SRR6145059	Sphingobium hydrophobicum	1673076	S	250	152	402	0.00005
SRR6145059	Nocardioides daphniae	402297	S	313	89	402	0.00005
SRR6145059	Acinetobacter towneri	202956	S	234	167	401	0.00005
SRR6145059	Lactococcus lactis	1358	S	310	90	400	0.00005
SRR6145059	Methylobacterium sp. CLZ	2696060	S	1	399	400	0.00005
SRR6145059	Microvirga ossetica	1882682	S	368	30	398	0.00005
SRR6145059	Mycolicibacterium monacense	85693	S	51	346	397	0.00005
SRR6145059	Phycicoccus dokdonensis	443156	S	374	22	396	0.00005
SRR6145059	Prevotella oris	28135	S	372	23	395	0.00005
SRR6145059	Methylobacterium durans	2202825	S	375	20	395	0.00005
SRR6145059	Streptococcus parasanguinis	1318	S	337	55	392	0.00005
SRR6145059	Microbacterium oxydans	82380	S	352	40	392	0.00005
SRR6145059	Sphingomonas sp. NIC1	1961362	S	462	389	851	0.00010
SRR6145059	Ottowia oryzae	2109914	S	375	14	389	0.00005
SRR6145059	Nocardia farcinica	37329	S	303	86	389	0.00005
SRR6145059	Pannonibacter phragmitetus	121719	S	286	102	388	0.00005
SRR6145059	Leptotrichia wadei	157687	S	342	46	388	0.00005
SRR6145059	Serinicoccus marinus	247333	S	301	86	387	0.00005
SRR6145059	Chryseobacterium shandongense	1493872	S	342	45	387	0.00005
SRR6145059	Methylobacterium mesophilicum	39956	S	359	26	385	0.00005
SRR6145059	Sphingomonas insulae	424800	S	370	14	384	0.00005
SRR6145059	Mycolicibacterium smegmatis	1772	S	302	82	384	0.00005
SRR6145059	Intrasporangium calvum	53358	S	372	12	384	0.00005
SRR6145059	Caballeronia sp. SBC1	2705548	S	36	384	420	0.00005
SRR6145059	Nocardioides sp. KUDC 5002	2589074	S	383	42	425	0.00005
SRR6145059	Mesorhizobium loti	381	S	118	264	382	0.00005
SRR6145059	Aerococcus viridans	1377	S	293	85	378	0.00004
SRR6145059	Skermanella pratensis	2233999	S	356	20	376	0.00004
SRR6145059	Corynebacterium doosanense	1121358	S	338	37	375	0.00004
SRR6145059	Nocardioides euryhalodurans	2518370	S	332	41	373	0.00004
SRR6145059	Betapapillomavirus 2	333924	S	372	0	372	0.00004
SRR6145059	Porphyromonas gingivalis	837	S	342	29	371	0.00004
SRR6145059	Corallococcus coralloides	184914	S	348	23	371	0.00004
SRR6145059	Caulobacter mirabilis	69666	S	346	25	371	0.00004
SRR6145059	Capnocytophaga sputigena	1019	S	336	35	371	0.00004
SRR6145059	Tessaracoccus flavescens	399497	S	337	33	370	0.00004
SRR6145059	Sphingomonas hengshuiensis	1609977	S	363	7	370	0.00004
SRR6145059	Deinococcus proteolyticus	55148	S	359	10	369	0.00004
SRR6145059	Sphingobacterium sp. B29	1933220	S	432	368	800	0.00010
SRR6145059	Rhizobium rhizoryzae	451876	S	347	21	368	0.00004
SRR6145059	Burkholderia ubonensis	101571	S	329	39	368	0.00004
SRR6145059	Rhodococcus opacus	37919	S	308	56	364	0.00004
SRR6145059	Corynebacterium endometrii	2488819	S	351	12	363	0.00004
SRR6145059	Deinococcus metallilatus	1211322	S	350	12	362	0.00004
SRR6145059	Staphylococcus equorum	246432	S	137	224	361	0.00004
SRR6145059	Pseudomonas nitroreducens	46680	S	276	84	360	0.00004
SRR6145059	Kocuria flava	446860	S	340	20	360	0.00004
SRR6145059	Nocardia asteroides	1824	S	270	87	357	0.00004
SRR6145059	Kocuria turfanensis	388357	S	335	22	357	0.00004
SRR6145059	Rubrivivax gelatinosus	28068	S	321	33	354	0.00004
SRR6145059	Asticcacaulis excentricus	78587	S	348	6	354	0.00004
SRR6145059	Staphylococcus sp. AntiMn-1	1715860	S	15	353	368	0.00004
SRR6145059	Sphaerotilus natans	34103	S	312	39	351	0.00004
SRR6145059	Rhizobacter gummiphilus	946333	S	330	21	351	0.00004
SRR6145059	Aeromicrobium erythreum	2041	S	325	25	350	0.00004
SRR6145059	Sphingomonas panacis	1560345	S	341	8	349	0.00004
SRR6145059	Paracoccus kondratievae	135740	S	318	31	349	0.00004
SRR6145059	Erythrobacter flavus	192812	S	207	141	348	0.00004
SRR6145059	Aggregatibacter segnis	739	S	328	20	348	0.00004
SRR6145059	Mycolicibacterium rutilum	370526	S	276	71	347	0.00004
SRR6145059	Methylobacterium nodulans	114616	S	332	12	344	0.00004
SRR6145059	Nocardioides seonyuensis	2518371	S	294	49	343	0.00004
SRR6145059	Rhizorhabdus dicambivorans	1850238	S	213	129	342	0.00004
SRR6145059	Streptomyces hygroscopicus	1912	S	120	220	340	0.00004
SRR6145059	Pseudomonas chlororaphis	587753	S	264	76	340	0.00004
SRR6145059	Mycolicibacterium phlei	1771	S	264	75	339	0.00004
SRR6145059	Acidipropionibacterium jensenii	1749	S	276	62	338	0.00004
SRR6145059	Pauljensenia hongkongensis	178339	S	314	22	336	0.00004
SRR6145059	Croceicoccus naphthovorans	1348774	S	150	186	336	0.00004
SRR6145059	Leclercia adecarboxylata	83655	S	147	187	334	0.00004
SRR6145059	Nocardia terpenica	455432	S	307	26	333	0.00004
SRR6145059	Staphylococcus pettenkoferi	170573	S	321	9	330	0.00004
SRR6145059	Staphylococcus arlettae	29378	S	308	22	330	0.00004
SRR6145059	Pseudoxanthomonas spadix	415229	S	279	49	328	0.00004
SRR6145059	Deinococcus swuensis	1182571	S	320	8	328	0.00004
SRR6145059	Lysobacter lycopersici	1324796	S	304	23	327	0.00004
SRR6145059	Ensifer adhaerens	106592	S	300	27	327	0.00004
SRR6145059	Aggregatibacter aphrophilus	732	S	307	20	327	0.00004
SRR6145059	Caulobacter segnis	88688	S	262	63	325	0.00004
SRR6145059	Pseudonocardia autotrophica	2074	S	287	36	323	0.00004
SRR6145059	Deinococcus geothermalis	68909	S	301	21	322	0.00004
SRR6145059	Lysobacter soli	453783	S	294	27	321	0.00004
SRR6145059	Burkholderia contaminans	488447	S	291	30	321	0.00004
SRR6145059	Gordonia phthalatica	1136941	S	299	21	320	0.00004
SRR6145059	Clostridium botulinum	1491	S	302	18	320	0.00004
SRR6145059	Protaetiibacter intestinalis	2419774	S	287	32	319	0.00004
SRR6145059	Gemella sanguinis	84135	S	304	15	319	0.00004
SRR6145059	Erythrobacter litoralis	39960	S	234	85	319	0.00004
SRR6145059	Pseudomonas luteola	47886	S	244	74	318	0.00004
SRR6145059	Methylobacterium sp. C1	1479019	S	92	317	409	0.00005
SRR6145059	Raoultella ornithinolytica	54291	S	88	228	316	0.00004
SRR6145059	Friedmanniella sagamiharensis	546874	S	302	14	316	0.00004
SRR6145059	Bradyrhizobium lablabi	722472	S	102	214	316	0.00004
SRR6145059	Novosphingobium resinovorum	158500	S	238	76	314	0.00004
SRR6145059	Lysobacter antibioticus	84531	S	269	45	314	0.00004
SRR6145059	Acidovorax citrulli	80869	S	204	110	314	0.00004
SRR6145059	Burkholderia lata	482957	S	276	35	311	0.00004
SRR6145059	Acidovorax carolinensis	553814	S	241	70	311	0.00004
SRR6145059	Streptomyces lydicus	47763	S	204	106	310	0.00004
SRR6145059	Mycolicibacterium arabiense	1286181	S	292	18	310	0.00004
SRR6145059	Lactobacillus iners	147802	S	297	13	310	0.00004
SRR6145059	Cupriavidus necator	106590	S	288	20	308	0.00004
SRR6145059	Caulobacter vibrioides	155892	S	233	75	308	0.00004
SRR6145059	Sphingomonas sp. MM-1	745310	S	358	306	664	0.00008
SRR6145059	Mycolicibacterium doricum	126673	S	218	86	304	0.00004
SRR6145059	Paracoccus aminophilus	34003	S	289	14	303	0.00004
SRR6145059	Empedobacter brevis	247	S	299	4	303	0.00004
SRR6145059	Bacillus subtilis	1423	S	81	219	300	0.00004
SRR6145059	Sphingobium baderi	1332080	S	169	130	299	0.00004
SRR6145059	Rhodococcus ruber	1830	S	271	28	299	0.00004
SRR6145059	Humibacter sp. BT305	2282656	S	63	298	361	0.00004
SRR6145059	Cnuibacter physcomitrellae	1619308	S	59	239	298	0.00004
SRR6145059	Cellulosimicrobium cellulans	1710	S	174	124	298	0.00004
SRR6145059	Streptococcus anginosus	1328	S	146	150	296	0.00004
SRR6145059	Lysobacter maris	1605891	S	263	33	296	0.00004
SRR6145059	Herbaspirillum huttiense	863372	S	257	38	295	0.00004
SRR6145059	Lysobacter gummosus	262324	S	239	55	294	0.00003
SRR6145059	Luteimonas yindakuii	2565782	S	262	32	294	0.00003
SRR6145059	Dermabacter vaginalis	1630135	S	247	45	292	0.00003
SRR6145059	Mycolicibacterium litorale	758802	S	236	55	291	0.00003
SRR6145059	Leptothrix cholodnii	34029	S	262	29	291	0.00003
SRR6145059	Propionibacterium virus Pirate	1982303	S	51	289	340	0.00004
SRR6145059	Dermabacter jinjuensis	1667168	S	164	125	289	0.00003
SRR6145059	Pseudonocardia dioxanivorans	240495	S	265	23	288	0.00003
SRR6145059	Xanthobacter autotrophicus	280	S	242	45	287	0.00003
SRR6145059	Mycobacterium gallinarum	39689	S	236	51	287	0.00003
SRR6145059	Burkholderia glumae	337	S	221	65	286	0.00003
SRR6145059	Capnocytophaga gingivalis	1017	S	276	9	285	0.00003
SRR6145059	Celeribacter indicus	1208324	S	182	102	284	0.00003
SRR6145059	Rhodococcus sp. p52	935199	S	85	283	368	0.00004
SRR6145059	Paraburkholderia dokdonella	2211211	S	270	11	281	0.00003
SRR6145059	Mycolicibacterium sediminis	1286180	S	258	23	281	0.00003
SRR6145059	Dermabacter hominis	36740	S	174	107	281	0.00003
SRR6145059	Baekduia soli	496014	S	279	2	281	0.00003
SRR6145059	Luteimonas sp. YGD11-2	2508168	S	1884	280	2164	0.00026
SRR6145059	Roseateles depolymerans	76731	S	255	24	279	0.00003
SRR6145059	Bosea sp. ANAM02	2020412	S	1071	278	1349	0.00016
SRR6145059	Aeromicrobium choanae	1736691	S	258	20	278	0.00003
SRR6145059	Streptomyces sp. ICC1	2099583	S	7	277	284	0.00003
SRR6145059	Microbacterium testaceum	2033	S	266	11	277	0.00003
SRR6145059	Acinetobacter gyllenbergii	134534	S	271	6	277	0.00003
SRR6145059	Staphylococcus xylosus	1288	S	267	9	276	0.00003
SRR6145059	Corynebacterium stationis	1705	S	248	28	276	0.00003
SRR6145059	Pseudomonas psychrotolerans	237610	S	267	7	274	0.00003
SRR6145059	Bradyrhizobium erythrophlei	1437360	S	261	13	274	0.00003
SRR6145059	Acidovorax ebreus	721785	S	38	236	274	0.00003
SRR6145059	Neisseria cinerea	483	S	222	51	273	0.00003
SRR6145059	Tannerella forsythia	28112	S	252	19	271	0.00003
SRR6145059	Saccharothrix syringae	103733	S	243	28	271	0.00003
SRR6145059	Mycobacterium sp. THAF192	2587868	S	99	271	370	0.00004
SRR6145059	Mycobacterium dioxanotrophicus	482462	S	252	19	271	0.00003
SRR6145059	Sphingomonas indica	941907	S	264	6	270	0.00003
SRR6145059	Rhodococcus sp. NJ-530	2490853	S	66	270	336	0.00004
SRR6145059	Rhodococcus fascians	1828	S	245	25	270	0.00003
SRR6145059	Serinicoccus chungangensis	767452	S	237	32	269	0.00003
SRR6145059	Raoultella electrica	1259973	S	224	45	269	0.00003
SRR6145059	Corynebacterium ammoniagenes	1697	S	244	24	268	0.00003
SRR6145059	Aeromonas hydrophila	644	S	128	140	268	0.00003
SRR6145059	Streptomyces albus	1888	S	252	15	267	0.00003
SRR6145059	Microbacterium sp. str. 'China'	2103230	S	267	873	1140	0.00014
SRR6145059	Azospirillum lipoferum	193	S	190	77	267	0.00003
SRR6145059	Mycolicibacterium tokaiense	39695	S	252	14	266	0.00003
SRR6145059	Mycolicibacterium rhodesiae	36814	S	217	49	266	0.00003
SRR6145059	Agrococcus jejuensis	399736	S	233	33	266	0.00003
SRR6145059	Corynebacterium frankenforstense	1230998	S	257	8	265	0.00003
SRR6145059	Archangium gephyra	48	S	247	18	265	0.00003
SRR6145059	Ralstonia pickettii	329	S	183	81	264	0.00003
SRR6145059	Devosia ginsengisoli	400770	S	244	20	264	0.00003
SRR6145059	Mycolicibacterium madagascariense	212765	S	250	12	262	0.00003
SRR6145059	Burkholderia vietnamiensis	60552	S	110	152	262	0.00003
SRR6145059	Sphingomonas wittichii	160791	S	196	65	261	0.00003
SRR6145059	Parvimonas micra	33033	S	236	25	261	0.00003
SRR6145059	Porphyrobacter neustonensis	1112	S	233	27	260	0.00003
SRR6145059	Diaphorobacter sp. JS3050	2735554	S	31	260	291	0.00003
SRR6145059	Sphingopyxis alaskensis	117207	S	231	28	259	0.00003
SRR6145059	Burkholderia sp. PAMC 26561	1795043	S	259	162	421	0.00005
SRR6145059	Mycolicibacterium goodii	134601	S	211	47	258	0.00003
SRR6145059	Acinetobacter dispersus	70348	S	253	5	258	0.00003
SRR6145059	Xanthomonas translucens	343	S	228	29	257	0.00003
SRR6145059	Diaphorobacter polyhydroxybutyrativorans	1546149	S	47	210	257	0.00003
SRR6145059	Corynebacterium halotolerans	225326	S	247	10	257	0.00003
SRR6145059	Burkholderia plantarii	41899	S	244	13	257	0.00003
SRR6145059	Corynebacterium vitaeruminis	38305	S	215	40	255	0.00003
SRR6145059	Corynebacterium sp. ATCC 6931	1487956	S	255	112	367	0.00004
SRR6145059	Mycolicibacterium hassiacum	46351	S	179	75	254	0.00003
SRR6145059	Mycolicibacterium chitae	1792	S	212	42	254	0.00003
SRR6145059	Actinosynnema pretiosum	42197	S	105	149	254	0.00003
SRR6145059	Mycolicibacterium aubagnense	319707	S	206	47	253	0.00003
SRR6145059	Pantoea vagans	470934	S	190	62	252	0.00003
SRR6145059	[Polyangium] brachysporum	413882	S	246	5	251	0.00003
SRR6145059	Jiangella alkaliphila	419479	S	225	26	251	0.00003
SRR6145059	Leifsonia xyli	1575	S	224	26	250	0.00003
SRR6145059	Nonomuraea sp. ATCC 55076	1909395	S	249	15	264	0.00003
SRR6145059	Enterobacter asburiae	61645	S	90	158	248	0.00003
SRR6145059	Rhodobacteraceae bacterium	1904441	S	175	72	247	0.00003
SRR6145059	Pseudomonas oleovorans	301	S	129	118	247	0.00003
SRR6145059	Mycobacterium chimaera	222805	S	181	66	247	0.00003
SRR6145059	Tessaracoccus aquimaris	1332264	S	230	16	246	0.00003
SRR6145059	Staphylococcus sp. M0911	2025492	S	84	246	330	0.00004
SRR6145059	Streptococcus pyogenes	1314	S	86	159	245	0.00003
SRR6145059	Cupriavidus metallidurans	119219	S	203	42	245	0.00003
SRR6145059	Mycolicibacterium boenickei	146017	S	200	44	244	0.00003
SRR6145059	Actinomadura verrucosospora	46165	S	223	19	242	0.00003
SRR6145059	Salipiger profundus	1229727	S	162	79	241	0.00003
SRR6145059	Kribbella flavida	182640	S	234	7	241	0.00003
SRR6145059	Corynebacterium phocae	161895	S	237	3	240	0.00003
SRR6145059	Streptococcus sp. HSISS1	1316410	S	9	239	248	0.00003
SRR6145059	Staphylococcus auricularis	29379	S	233	6	239	0.00003
SRR6145059	Shigella flexneri	623	S	6	233	239	0.00003
SRR6145059	Lysobacter alkalisoli	2591633	S	220	19	239	0.00003
SRR6145059	Caulobacter rhizosphaerae	2010972	S	191	48	239	0.00003
SRR6145059	Rhodobacter blasticus	1075	S	228	10	238	0.00003
SRR6145059	Amycolatopsis methanolica	1814	S	216	22	238	0.00003
SRR6145059	Microbacterium lemovicicum	1072463	S	226	11	237	0.00003
SRR6145059	Brevibacterium sandarakinum	629680	S	208	29	237	0.00003
SRR6145059	Qipengyuania sediminis	1532023	S	227	9	236	0.00003
SRR6145059	Paraoceanicella profunda	2579971	S	201	35	236	0.00003
SRR6145059	Nocardia nova	37330	S	220	16	236	0.00003
SRR6145059	Streptococcus koreensis	2382163	S	123	111	234	0.00003
SRR6145059	Streptococcus agalactiae	1311	S	40	194	234	0.00003
SRR6145059	Saccharopolyspora erythraea	1836	S	214	19	233	0.00003
SRR6145059	Prevotella denticola	28129	S	216	17	233	0.00003
SRR6145059	Rhodococcus pyridinivorans	103816	S	67	165	232	0.00003
SRR6145059	Leptotrichia buccalis	40542	S	204	28	232	0.00003
SRR6145059	Cardiobacterium hominis	2718	S	229	3	232	0.00003
SRR6145059	Microterricola viridarii	412690	S	217	14	231	0.00003
SRR6145059	Cystobacter fuscus	43	S	202	28	230	0.00003
SRR6145059	Nocardia arthritidis	228602	S	213	16	229	0.00003
SRR6145059	Microbacterium sediminis	904291	S	204	25	229	0.00003
SRR6145059	Amycolatopsis keratiniphila	129921	S	143	86	229	0.00003
SRR6145059	Propionibacterium phage PHL085N00	1500812	S	9	228	237	0.00003
SRR6145059	Rhodococcus hoagii	43767	S	208	19	227	0.00003
SRR6145059	Pseudomonas sp. VLB120	69328	S	35	227	262	0.00003
SRR6145059	Ochrobactrum anthropi	529	S	148	79	227	0.00003
SRR6145059	Mixta calida	665913	S	191	36	227	0.00003
SRR6145059	Croceicoccus marinus	450378	S	152	75	227	0.00003
SRR6145059	Limnospira indica	147322	S	58	168	226	0.00003
SRR6145059	Aeromonas sp. ASNIH5	1758179	S	48	226	274	0.00003
SRR6145059	Paracoccus sp. Arc7-R13	2500532	S	1476	225	1701	0.00020
SRR6145059	Nocardia mangyaensis	2213200	S	184	41	225	0.00003
SRR6145059	Methylobacterium oryzae	334852	S	16	209	225	0.00003
SRR6145059	Treponema denticola	158	S	215	9	224	0.00003
SRR6145059	Streptomyces alfalfae	1642299	S	5	219	224	0.00003
SRR6145059	Mycobacterium paragordonae	1389713	S	221	3	224	0.00003
SRR6145059	Microlunatus phosphovorus	29405	S	219	5	224	0.00003
SRR6145059	Cellulomonas fimi	1708	S	184	40	224	0.00003
SRR6145059	Burkholderia pyrrocinia	60550	S	199	25	224	0.00003
SRR6145059	Stella humosa	94	S	218	5	223	0.00003
SRR6145059	Sphingomonas sp. FARSPH	2219696	S	535	223	758	0.00009
SRR6145059	Microbacterium oleivorans	273677	S	214	9	223	0.00003
SRR6145059	Corynebacterium marinum	349751	S	199	24	223	0.00003
SRR6145059	Bordetella bronchiseptica	518	S	51	172	223	0.00003
SRR6145059	Amycolatopsis albispora	1804986	S	166	57	223	0.00003
SRR6145059	Streptococcus dysgalactiae	1334	S	56	166	222	0.00003
SRR6145059	Methylibium petroleiphilum	105560	S	131	91	222	0.00003
SRR6145059	Aeromonas sp. ASNIH1	1636606	S	39	222	261	0.00003
SRR6145059	Corynebacterium testudinoris	136857	S	212	9	221	0.00003
SRR6145059	Friedmanniella luteola	546871	S	212	8	220	0.00003
SRR6145059	Rhodococcus rhodochrous	1829	S	181	38	219	0.00003
SRR6145059	Novosphingobium pentaromativorans	205844	S	86	133	219	0.00003
SRR6145059	Burkholderia insecticola	758793	S	216	3	219	0.00003
SRR6145059	Tessaracoccus timonensis	2161816	S	204	14	218	0.00003
SRR6145059	Mycolicibacterium thermoresistibile	1797	S	178	40	218	0.00003
SRR6145059	Pseudomonas sp. BJP69	2597770	S	145	217	362	0.00004
SRR6145059	Acinetobacter wuhouensis	1879050	S	197	20	217	0.00003
SRR6145059	Acinetobacter venetianus	52133	S	204	13	217	0.00003
SRR6145059	Rhodovulum sulfidophilum	35806	S	162	54	216	0.00003
SRR6145059	Rhodoferax sediminis	2509614	S	208	8	216	0.00003
SRR6145059	Kineococcus radiotolerans	131568	S	210	6	216	0.00003
SRR6145059	Corynebacterium humireducens	1223514	S	206	10	216	0.00003
SRR6145059	Aerococcus urinaeequi	51665	S	184	32	216	0.00003
SRR6145059	Mycolicibacterium pulveris	36813	S	194	21	215	0.00003
SRR6145059	Mycolicibacterium confluentis	28047	S	203	12	215	0.00003
SRR6145059	Auraticoccus monumenti	675864	S	211	4	215	0.00003
SRR6145059	Bacillus amyloliquefaciens	1390	S	120	94	214	0.00003
SRR6145059	Xanthomonas sacchari	56458	S	180	32	212	0.00003
SRR6145059	Streptomyces coelicolor	1902	S	11	201	212	0.00003
SRR6145059	Sphingopyxis sp. MG	1866325	S	29	212	241	0.00003
SRR6145059	Streptomyces rimosus	1927	S	132	79	211	0.00003
SRR6145059	Pluralibacter gergoviae	61647	S	196	15	211	0.00003
SRR6145059	Staphylococcus nepalensis	214473	S	202	8	210	0.00002
SRR6145059	Rhizobium sp. Y9	1914541	S	70	210	280	0.00003
SRR6145059	Pseudomonas citronellolis	53408	S	187	22	209	0.00002
SRR6145059	Dechlorosoma suillum	146939	S	115	92	207	0.00002
SRR6145059	Burkholderia thailandensis	57975	S	85	122	207	0.00002
SRR6145059	Rhizobium sp. IRBG74	424182	S	56	205	261	0.00003
SRR6145059	Phreatobacter cathodiphilus	1868589	S	187	18	205	0.00002
SRR6145059	Cellulomonas flavigena	1711	S	190	15	205	0.00002
SRR6145059	Neorhizobium galegae	399	S	193	11	204	0.00002
SRR6145059	Burkholderia stabilis	95485	S	174	30	204	0.00002
SRR6145059	Phytohabitans suffuscus	624315	S	184	19	203	0.00002
SRR6145059	Mycolicibacterium fallax	1793	S	161	42	203	0.00002
SRR6145059	Lentzea guizhouensis	1586287	S	190	13	203	0.00002
SRR6145059	Rathayibacter festucae	110937	S	117	85	202	0.00002
SRR6145059	Macrococcus caseolyticus	69966	S	183	19	202	0.00002
SRR6145059	Acidipropionibacterium virtanenii	2057246	S	182	19	201	0.00002
SRR6145059	Mycolicibacterium alvei	67081	S	159	41	200	0.00002
SRR6145059	Jiangella sp. DSM 45060	1798224	S	200	24	224	0.00003
SRR6145059	Bradyrhizobium sp.	376	S	68	132	200	0.00002
SRR6145059	Xylophilus sp. KACC 21265	2697032	S	199	13	212	0.00003
SRR6145059	Streptomyces viridifaciens	48665	S	38	161	199	0.00002
SRR6145059	Rhodoferax koreense	1842727	S	179	20	199	0.00002
SRR6145059	Rhizobium flavum	1335061	S	103	96	199	0.00002
SRR6145059	Enterobacter kobei	208224	S	42	157	199	0.00002
SRR6145059	Deinococcus deserti	310783	S	196	3	199	0.00002
SRR6145059	Microbacterium pygmaeum	370764	S	194	4	198	0.00002
SRR6145059	Bradyrhizobium japonicum	375	S	86	112	198	0.00002
SRR6145059	Mycolicibacterium moriokaense	39691	S	186	11	197	0.00002
SRR6145059	Frankia inefficax	298654	S	194	3	197	0.00002
SRR6145059	Cellulomonas shaoxiangyii	2566013	S	180	17	197	0.00002
SRR6145059	Anaerococcus mediterraneensis	1870984	S	171	26	197	0.00002
SRR6145059	Streptosporangium roseum	2001	S	178	18	196	0.00002
SRR6145059	Sandaracinus amylolyticus	927083	S	195	1	196	0.00002
SRR6145059	Pseudomonas syringae	317	S	95	101	196	0.00002
SRR6145059	Catenulispora acidiphila	304895	S	193	3	196	0.00002
SRR6145059	Rhodobacter capsulatus	1061	S	168	27	195	0.00002
SRR6145059	Mycolicibacterium anyangense	1431246	S	183	12	195	0.00002
SRR6145059	Nocardia seriolae	37332	S	159	35	194	0.00002
SRR6145059	Micromonospora aurantiaca	47850	S	33	160	193	0.00002
SRR6145059	Kutzneria albida	43357	S	183	10	193	0.00002
SRR6145059	Rhodococcus qingshengii	334542	S	35	157	192	0.00002
SRR6145059	Pseudarthrobacter phenanthrenivorans	361575	S	175	17	192	0.00002
SRR6145059	Agromyces aureus	453304	S	171	21	192	0.00002
SRR6145059	Minicystis rosea	888845	S	185	6	191	0.00002
SRR6145059	Nocardia otitidiscaviarum	1823	S	171	19	190	0.00002
SRR6145059	Filifactor alocis	143361	S	175	15	190	0.00002
SRR6145059	Polymorphum gilvum	991904	S	171	18	189	0.00002
SRR6145059	Phreatobacter stygius	1940610	S	182	7	189	0.00002
SRR6145059	Nocardiopsis dassonvillei	2014	S	178	11	189	0.00002
SRR6145059	Acinetobacter guillouiae	106649	S	187	2	189	0.00002
SRR6145059	Labilithrix luteola	1391654	S	186	2	188	0.00002
SRR6145059	Caballeronia sp. SBC2	2705547	S	24	188	212	0.00003
SRR6145059	Streptomyces chartreusis	1969	S	157	30	187	0.00002
SRR6145059	Propionibacterium acidifaciens	556499	S	174	13	187	0.00002
SRR6145059	Novosphingobium aromaticivorans	48935	S	158	29	187	0.00002
SRR6145059	Microbacterium oryzae	743009	S	177	10	187	0.00002
SRR6145059	Haemophilus parahaemolyticus	735	S	180	7	187	0.00002
SRR6145059	Nocardioides sp. CF8	110319	S	491	185	676	0.00008
SRR6145059	Mycolicibacterium insubricum	444597	S	159	26	185	0.00002
SRR6145059	Klebsiella huaxiensis	2153354	S	157	28	185	0.00002
SRR6145059	Azospirillum sp. CFH 70021	2202148	S	184	20	204	0.00002
SRR6145059	Streptomyces niveus	193462	S	162	21	183	0.00002
SRR6145059	Saccharothrix espanaensis	103731	S	166	17	183	0.00002
SRR6145059	Prevotella scopos	589437	S	154	29	183	0.00002
SRR6145059	Corynebacterium maris	575200	S	179	4	183	0.00002
SRR6145059	Azorhizobium caulinodans	7	S	169	14	183	0.00002
SRR6145059	Streptococcus vestibularis	1343	S	149	33	182	0.00002
SRR6145059	Stenotrophomonas sp. pho	2211160	S	55	182	237	0.00003
SRR6145059	Tardibacter chloracetimidivorans	1921510	S	107	74	181	0.00002
SRR6145059	Stigmatella aurantiaca	41	S	167	14	181	0.00002
SRR6145059	Rhodococcus sp. YL-1	1045808	S	46	181	227	0.00003
SRR6145059	Pseudonocardia sp. EC080619-01	1096856	S	1	181	182	0.00002
SRR6145059	Microbacterium protaetiae	2509458	S	172	9	181	0.00002
SRR6145059	Cupriavidus gilardii	82541	S	157	24	181	0.00002
SRR6145059	Burkholderia stagnalis	1503054	S	171	10	181	0.00002
SRR6145059	Actinoplanes friuliensis	196914	S	174	7	181	0.00002
SRR6145059	Variovorax boronicumulans	436515	S	108	72	180	0.00002
SRR6145059	Salinivibrio kushneri	1908198	S	176	4	180	0.00002
SRR6145059	Pelagibaca abyssi	1250539	S	129	51	180	0.00002
SRR6145059	Actinoplanes teichomyceticus	1867	S	159	21	180	0.00002
SRR6145059	Porphyrobacter sp. CACIAM 03H1	2003315	S	179	42	221	0.00003
SRR6145059	Mogibacterium diversum	114527	S	171	8	179	0.00002
SRR6145059	Massilia flava	871742	S	163	16	179	0.00002
SRR6145059	Chryseobacterium indoltheticum	254	S	168	11	179	0.00002
SRR6145059	Agrobacterium fabrum	1176649	S	144	35	179	0.00002
SRR6145059	Klebsiella sp. FDAARGOS_511	2488567	S	242	177	419	0.00005
SRR6145059	Actinomyces howellii	52771	S	175	2	177	0.00002
SRR6145059	Paucibacter sp. KCTC 42545	1768242	S	176	12	188	0.00002
SRR6145059	Comamonas serinivorans	1082851	S	168	8	176	0.00002
SRR6145059	Aeromonas veronii	654	S	150	26	176	0.00002
SRR6145059	Actinoplanes missouriensis	1866	S	155	21	176	0.00002
SRR6145059	Yangia pacifica	311180	S	156	19	175	0.00002
SRR6145059	Melittangium boletus	83453	S	153	22	175	0.00002
SRR6145059	Aeromicrobium marinum	219314	S	163	11	174	0.00002
SRR6145059	Streptomyces sp. CC0208	2306165	S	3	173	176	0.00002
SRR6145059	Pulveribacter suum	2116657	S	159	14	173	0.00002
SRR6145059	Pseudomonas entomophila	312306	S	161	12	173	0.00002
SRR6145059	Mycolicibacterium celeriflavum	1249101	S	153	20	173	0.00002
SRR6145059	Corynebacterium nuruki	1032851	S	168	5	173	0.00002
SRR6145059	Corynebacterium efficiens	152794	S	167	6	173	0.00002
SRR6145059	Amycolatopsis sp. YIM 10	2653857	S	173	24	197	0.00002
SRR6145059	Agromyces flavus	589382	S	155	18	173	0.00002
SRR6145059	Actinopolymorpha singaporensis	117157	S	171	2	173	0.00002
SRR6145059	Streptomyces griseorubiginosus	67304	S	150	22	172	0.00002
SRR6145059	Corynebacterium glyciniphilum	1404244	S	169	3	172	0.00002
SRR6145059	Actinoplanes derwentensis	113562	S	165	7	172	0.00002
SRR6145059	Silicimonas algicola	1826607	S	169	2	171	0.00002
SRR6145059	Microlunatus soli	630515	S	163	8	171	0.00002
SRR6145059	Mesorhizobium oceanicum	1670800	S	157	14	171	0.00002
SRR6145059	Klebsiella sp. MPUS7	2697371	S	11	171	182	0.00002
SRR6145059	Gemmatirosa kalamazoonesis	861299	S	166	5	171	0.00002
SRR6145059	Acidovorax cattleyae	80868	S	119	52	171	0.00002
SRR6145059	Luteimicrobium xylanilyticum	1133546	S	165	5	170	0.00002
SRR6145059	Kibdelosporangium phytohabitans	860235	S	165	5	170	0.00002
SRR6145059	Isoptericola variabilis	139208	S	156	14	170	0.00002
SRR6145059	Isoptericola dokdonensis	372663	S	160	10	170	0.00002
SRR6145059	Actinomyces slackii	52774	S	168	2	170	0.00002
SRR6145059	Pseudonocardia sp. EC080625-04	1096868	S	8	168	176	0.00002
SRR6145059	Massilia armeniaca	2072590	S	124	44	168	0.00002
SRR6145059	Lactobacillus crispatus	47770	S	109	59	168	0.00002
SRR6145059	Bradyrhizobium guangdongense	1325090	S	103	65	168	0.00002
SRR6145059	Bradyrhizobium elkanii	29448	S	140	28	168	0.00002
SRR6145059	Aminobacter aminovorans	83263	S	136	32	168	0.00002
SRR6145059	Sphingobium sp. RSMS	520734	S	49	167	216	0.00003
SRR6145059	Delftia acidovorans	80866	S	64	103	167	0.00002
SRR6145059	Streptomyces spectabilis	68270	S	140	25	165	0.00002
SRR6145059	Serpentinomonas mccroryi	1458426	S	152	13	165	0.00002
SRR6145059	Iamiaceae bacterium SCSIO 58843	2664374	S	164	2	166	0.00002
SRR6145059	Beutenbergia cavernae	84757	S	162	2	164	0.00002
SRR6145059	Pseudomonas sp. LTGT-11-2Z	2479393	S	8	163	171	0.00002
SRR6145059	Porphyromonas asaccharolytica	28123	S	163	0	163	0.00002
SRR6145059	Mesorhizobium ciceri	39645	S	55	108	163	0.00002
SRR6145059	Bradyrhizobium diazoefficiens	1355477	S	44	119	163	0.00002
SRR6145059	Allokutzneria albata	211114	S	153	10	163	0.00002
SRR6145059	Alcaligenes faecalis	511	S	143	20	163	0.00002
SRR6145059	Achromobacter denitrificans	32002	S	122	41	163	0.00002
SRR6145059	Sulfitobacter pseudonitzschiae	1402135	S	133	29	162	0.00002
SRR6145059	Starkeya novella	921	S	134	28	162	0.00002
SRR6145059	Microbacterium wangchenii	2541726	S	153	9	162	0.00002
SRR6145059	Labrys neptuniae	376174	S	157	5	162	0.00002
SRR6145059	Dyadobacter fermentans	94254	S	156	6	162	0.00002
SRR6145059	Blastomonas fulva	1550728	S	69	93	162	0.00002
SRR6145059	Arenimonas daejeonensis	370777	S	153	9	162	0.00002
SRR6145059	Actinomadura amylolytica	1411117	S	148	14	162	0.00002
SRR6145059	Gemmataceae bacterium	2052164	S	148	13	161	0.00002
SRR6145059	Eikenella corrodens	539	S	145	16	161	0.00002
SRR6145059	Cellulomonas gilvus	11	S	147	14	161	0.00002
SRR6145059	Rhodococcus coprophilus	38310	S	154	6	160	0.00002
SRR6145059	Rhizobium etli	29449	S	86	74	160	0.00002
SRR6145059	Methylobacterium phyllosphaerae	418223	S	47	113	160	0.00002
SRR6145059	Massilia violaceinigra	2045208	S	153	7	160	0.00002
SRR6145059	Leptotrichia hofstadii	157688	S	137	23	160	0.00002
SRR6145059	Fusobacterium hwasookii	1583098	S	120	40	160	0.00002
SRR6145059	Burkholderia sp. RPE67	758796	S	142	160	302	0.00004
SRR6145059	Brevibacterium siliguriense	1136497	S	131	29	160	0.00002
SRR6145059	Xanthomonas hyacinthi	56455	S	129	30	159	0.00002
SRR6145059	Acinetobacter sp. ACNIH1	1636603	S	843	159	1002	0.00012
SRR6145059	Sinomonas atrocyanea	37927	S	156	2	158	0.00002
SRR6145059	Novosphingobium sp. Gsoil 351	2675225	S	158	3	161	0.00002
SRR6145059	Kitasatospora setae	2066	S	150	8	158	0.00002
SRR6145059	Tessaracoccus flavus	1610493	S	146	11	157	0.00002
SRR6145059	Streptomyces tsukubensis	83656	S	148	9	157	0.00002
SRR6145059	Deinococcus puniceus	1182568	S	156	1	157	0.00002
SRR6145059	Corynebacterium ulcerans	65058	S	148	9	157	0.00002
SRR6145059	Acinetobacter tandoii	202954	S	154	3	157	0.00002
SRR6145059	Sphingobium chlorophenolicum	46429	S	124	32	156	0.00002
SRR6145059	Pantoea agglomerans	549	S	142	14	156	0.00002
SRR6145059	Massilia albidiflava	321983	S	125	31	156	0.00002
SRR6145059	Limnoglobus roseus	2598579	S	154	2	156	0.00002
SRR6145059	Comamonas thiooxydans	363952	S	75	81	156	0.00002
SRR6145059	Pseudomonas sp. phDV1	253237	S	100	155	255	0.00003
SRR6145059	Micromonospora echinaurantiaca	47857	S	130	25	155	0.00002
SRR6145059	Deinococcus irradiatisoli	2202254	S	153	2	155	0.00002
SRR6145059	Tistrella mobilis	171437	S	140	14	154	0.00002
SRR6145059	Sphingosinicella microcystinivorans	335406	S	152	2	154	0.00002
SRR6145059	Microbacterium sp. TPU 3598	1938334	S	154	12	166	0.00002
SRR6145059	Massilia lutea	321985	S	132	22	154	0.00002
SRR6145059	Leptotrichia trevisanii	109328	S	139	15	154	0.00002
SRR6145059	[Mycobacterium] stephanolepidis	1520670	S	120	33	153	0.00002
SRR6145059	Sphingobium sp. YBL2	484429	S	58	153	211	0.00003
SRR6145059	Ancylobacter pratisalsi	1745854	S	136	17	153	0.00002
SRR6145059	Thermomonas sp. SY21	2202149	S	585	152	737	0.00009
SRR6145059	Streptococcus viridans	78535	S	116	36	152	0.00002
SRR6145059	Rhizobium phaseoli	396	S	55	97	152	0.00002
SRR6145059	Corynebacterium callunae	1721	S	136	16	152	0.00002
SRR6145059	Brevibacterium sp. CS2	2575923	S	2523	152	2675	0.00032
SRR6145059	Xanthomonas phaseoli	1985254	S	9	142	151	0.00002
SRR6145059	Tabrizicola piscis	2494374	S	146	5	151	0.00002
SRR6145059	Massilia umbonata	864828	S	122	29	151	0.00002
SRR6145059	Bradyrhizobium ottawaense	931866	S	14	137	151	0.00002
SRR6145059	Xylanimonas allomyrinae	2509459	S	138	12	150	0.00002
SRR6145059	Streptomyces globisporus	1908	S	95	55	150	0.00002
SRR6145059	Corynebacterium sphenisci	191493	S	146	4	150	0.00002
SRR6145059	Campylobacter concisus	199	S	149	1	150	0.00002
SRR6145059	Halovulum dunhuangense	1505036	S	143	6	149	0.00002
SRR6145059	Glutamicibacter creatinolyticus	162496	S	146	3	149	0.00002
SRR6145059	Caulobacter henricii	69395	S	134	15	149	0.00002
SRR6145059	Bosea sp. F3-2	2599640	S	708	149	857	0.00010
SRR6145059	Aquisphaera giovannonii	406548	S	142	7	149	0.00002
SRR6145059	Sanguibacter keddieii	60920	S	144	4	148	0.00002
SRR6145059	Roseovarius indicus	540747	S	110	38	148	0.00002
SRR6145059	Parvibaculum lavamentivorans	256618	S	120	28	148	0.00002
SRR6145059	Hypericibacter adhaerens	2602016	S	135	13	148	0.00002
SRR6145059	Cupriavidus pinatubonensis	248026	S	140	8	148	0.00002
SRR6145059	Novosphingobium tardaugens	169176	S	114	33	147	0.00002
SRR6145059	Cupriavidus oxalaticus	96344	S	137	10	147	0.00002
SRR6145059	Brevirhabdus pacifica	1267768	S	105	42	147	0.00002
SRR6145059	Acinetobacter sp. WCHA45	2004644	S	919	147	1066	0.00013
SRR6145059	Mycolicibacterium aichiense	1799	S	118	28	146	0.00002
SRR6145059	Amycolatopsis orientalis	31958	S	123	23	146	0.00002
SRR6145059	Agromyces protaetiae	2509455	S	130	16	146	0.00002
SRR6145059	Pseudomonas fulva	47880	S	120	25	145	0.00002
SRR6145059	Dinoroseobacter shibae	215813	S	101	44	145	0.00002
SRR6145059	Arthrobacter alpinus	656366	S	76	69	145	0.00002
SRR6145059	Altererythrobacter dongtanensis	692370	S	131	14	145	0.00002
SRR6145059	Aeromonas sp. ASNIH2	1636607	S	32	144	176	0.00002
SRR6145059	Leucobacter triazinivorans	1784719	S	134	9	143	0.00002
SRR6145059	Achromobacter spanius	217203	S	128	15	143	0.00002
SRR6145059	Achromobacter pestifer	1353889	S	121	22	143	0.00002
SRR6145059	Streptococcus sp. I-P16	1156433	S	93	142	235	0.00003
SRR6145059	Streptococcus sp. 1643	2576376	S	268	142	410	0.00005
SRR6145059	Pseudomonas psychrophila	122355	S	137	5	142	0.00002
SRR6145059	Faecalibacterium prausnitzii	853	S	121	21	142	0.00002
SRR6145059	Xylanimonas cellulosilytica	186189	S	131	10	141	0.00002
SRR6145059	Pseudomonas resinovorans	53412	S	134	7	141	0.00002
SRR6145059	Pandoraea pnomenusa	93220	S	121	20	141	0.00002
SRR6145059	Nitrospirillum amazonense	28077	S	135	6	141	0.00002
SRR6145059	Streptomyces sp. SCSIO 03032	1109743	S	140	3	143	0.00002
SRR6145059	Streptomyces bingchenggensis	379067	S	134	6	140	0.00002
SRR6145059	Dokdonella koreensis	323415	S	135	5	140	0.00002
SRR6145059	Micromonospora echinofusca	47858	S	120	19	139	0.00002
SRR6145059	Haliangium ochraceum	80816	S	138	1	139	0.00002
SRR6145059	Frankia alni	1859	S	115	24	139	0.00002
SRR6145059	Curtobacterium pusillum	69373	S	121	18	139	0.00002
SRR6145059	Burkholderia territorii	1503055	S	126	13	139	0.00002
SRR6145059	Bradyrhizobium oligotrophicum	44255	S	127	12	139	0.00002
SRR6145059	Streptomyces cattleya	29303	S	132	6	138	0.00002
SRR6145059	Pseudomonas multiresinivorans	95301	S	114	24	138	0.00002
SRR6145059	Myxococcus xanthus	34	S	109	29	138	0.00002
SRR6145059	Mycobacterium saskatchewanense	220927	S	134	4	138	0.00002
SRR6145059	Corynebacterium uterequi	1072256	S	136	2	138	0.00002
SRR6145059	Variovorax sp. PAMC 28711	1795631	S	137	5	142	0.00002
SRR6145059	Paracoccus sp. AK26	2589076	S	2034	137	2171	0.00026
SRR6145059	Altererythrobacter atlanticus	1267766	S	91	46	137	0.00002
SRR6145059	Thioclava nitratireducens	1915078	S	125	11	136	0.00002
SRR6145059	Mycobacterium branderi	43348	S	132	4	136	0.00002
SRR6145059	Micromonospora auratinigra	261654	S	113	23	136	0.00002
SRR6145059	Gemmata obscuriglobus	114	S	131	5	136	0.00002
SRR6145059	Chryseobacterium bernardetii	1241978	S	117	19	136	0.00002
SRR6145059	Atlantibacter hermannii	565	S	132	4	136	0.00002
SRR6145059	Streptococcus sp. I-G2	1156431	S	88	135	223	0.00003
SRR6145059	Nocardioides sp. HDW12A	2714938	S	261	135	396	0.00005
SRR6145059	Marinovum algicola	42444	S	101	34	135	0.00002
SRR6145059	Komagataeibacter xylinus	28448	S	78	57	135	0.00002
SRR6145059	Corynebacterium atypicum	191610	S	127	8	135	0.00002
SRR6145059	Capnocytophaga leadbetteri	327575	S	108	27	135	0.00002
SRR6145059	Burkholderia seminalis	488731	S	123	12	135	0.00002
SRR6145059	Streptococcus intermedius	1338	S	105	29	134	0.00002
SRR6145059	Novosphingobium ginsenosidimutans	1176536	S	131	3	134	0.00002
SRR6145059	Mycolicibacterium sarraceniae	1534348	S	120	14	134	0.00002
SRR6145059	Corynebacterium epidermidicanis	1050174	S	130	4	134	0.00002
SRR6145059	Beijerinckiaceae bacterium RH AL1	2572036	S	134	14	148	0.00002
SRR6145059	Sphingobium sp. TKS	1315974	S	199	133	332	0.00004
SRR6145059	Shewanella algae	38313	S	115	18	133	0.00002
SRR6145059	Exiguobacterium acetylicum	41170	S	88	45	133	0.00002
SRR6145059	Corynebacterium renale	1724	S	132	1	133	0.00002
SRR6145059	Streptomyces griseus	1911	S	101	31	132	0.00002
SRR6145059	Streptomyces alboflavus	67267	S	118	14	132	0.00002
SRR6145059	Rhizobium pseudoryzae	379684	S	123	9	132	0.00002
SRR6145059	Phytohabitans flavus	1076124	S	121	10	131	0.00002
SRR6145059	Pandoraea faecigallinarum	656179	S	108	23	131	0.00002
SRR6145059	Leucobacter sp. DSM 101948	1935379	S	131	8	139	0.00002
SRR6145059	Azospirillum thiophilum	528244	S	108	23	131	0.00002
SRR6145059	Sphingobium herbicidovorans	76947	S	94	36	130	0.00002
SRR6145059	Rhodospirillum centenum	34018	S	117	13	130	0.00002
SRR6145059	Nakamurella panacisegetis	1090615	S	128	2	130	0.00002
SRR6145059	Microbacterium paludicola	300019	S	39	91	130	0.00002
SRR6145059	Chryseobacterium balustinum	246	S	118	12	130	0.00002
SRR6145059	Chryseobacterium aureum	2497456	S	125	5	130	0.00002
SRR6145059	Altererythrobacter marensis	543877	S	123	7	130	0.00002
SRR6145059	Staphylococcus argenteus	985002	S	21	108	129	0.00002
SRR6145059	Porphyrobacter sp. YT40	2547601	S	201	129	330	0.00004
SRR6145059	Pandoraea norimbergensis	93219	S	120	9	129	0.00002
SRR6145059	Neisseria lactamica	486	S	79	50	129	0.00002
SRR6145059	Mycolicibacterium helvum	1534349	S	117	12	129	0.00002
SRR6145059	Massilia sp. WG5	1707785	S	410	129	539	0.00006
SRR6145059	Massilia sp. NR 4-1	1678028	S	129	10	139	0.00002
SRR6145059	Leptotrichia hongkongensis	554406	S	111	18	129	0.00002
SRR6145059	Cupriavidus basilensis	68895	S	126	3	129	0.00002
SRR6145059	Corynebacterium deserti	1408191	S	114	15	129	0.00002
SRR6145059	Corynebacterium aquilae	203263	S	127	2	129	0.00002
SRR6145059	Aeromonas sp. ASNIH3	1636608	S	28	129	157	0.00002
SRR6145059	Actinoplanes sp. OR16	946334	S	176	129	305	0.00004
SRR6145059	Shinella sp. HZN7	879274	S	419	128	547	0.00007
SRR6145059	Rhodococcus aetherivorans	191292	S	26	102	128	0.00002
SRR6145059	Mycobacterium cookii	1775	S	127	1	128	0.00002
SRR6145059	Chryseobacterium carnipullorum	1124835	S	116	12	128	0.00002
SRR6145059	Streptomyces lavendulae	1914	S	111	16	127	0.00002
SRR6145059	Roseibacterium elongatum	159346	S	123	4	127	0.00002
SRR6145059	Mycobacterium shigaense	722731	S	117	10	127	0.00002
SRR6145059	Deinococcus maricopensis	309887	S	126	1	127	0.00002
SRR6145059	Burkholderia sp. KK1	1855726	S	212	127	339	0.00004
SRR6145059	Weissella cibaria	137591	S	120	6	126	0.00001
SRR6145059	Streptomyces noursei	1971	S	79	47	126	0.00001
SRR6145059	Stappia indica	538381	S	120	6	126	0.00001
SRR6145059	Sphingobium fuliginis	336203	S	43	83	126	0.00001
SRR6145059	Oligotropha carboxidovorans	40137	S	102	24	126	0.00001
SRR6145059	Micromonospora purpureochromogenes	47872	S	105	21	126	0.00001
SRR6145059	Microcella alkaliphila	279828	S	121	5	126	0.00001
SRR6145059	Mameliella alba	561184	S	107	19	126	0.00001
SRR6145059	Inhella inkyongensis	392593	S	119	7	126	0.00001
SRR6145059	Elizabethkingia meningoseptica	238	S	124	2	126	0.00001
SRR6145059	Bosea sp. AS-1	2015316	S	579	126	705	0.00008
SRR6145059	Streptomyces qaidamensis	1783515	S	107	18	125	0.00001
SRR6145059	Streptomyces ambofaciens	1889	S	100	25	125	0.00001
SRR6145059	Sphingopyxis sp. EG6	1874061	S	296	125	421	0.00005
SRR6145059	Pseudomonas plecoglossicida	70775	S	70	55	125	0.00001
SRR6145059	Prauserella marina	530584	S	122	3	125	0.00001
SRR6145059	Micromonospora echinospora	1877	S	116	9	125	0.00001
SRR6145059	Bradyrhizobium guangzhouense	1325095	S	87	38	125	0.00001
SRR6145059	Variovorax sp. PBL-E5	434014	S	59	124	183	0.00002
SRR6145059	Saccharomonospora azurea	40988	S	105	19	124	0.00001
SRR6145059	Micromonospora krabiensis	307121	S	111	13	124	0.00001
SRR6145059	Hydrogenophaga pseudoflava	47421	S	64	60	124	0.00001
SRR6145059	Corynebacterium lactis	1231000	S	122	2	124	0.00001
SRR6145059	Streptomyces scabiei	1930	S	111	12	123	0.00001
SRR6145059	Corallococcus macrosporus	35	S	82	41	123	0.00001
SRR6145059	Verminephrobacter eiseniae	364317	S	121	1	122	0.00001
SRR6145059	Streptomyces fradiae	1906	S	17	105	122	0.00001
SRR6145059	Micromonospora chokoriensis	356851	S	109	13	122	0.00001
SRR6145059	Herbaspirillum seropedicae	964	S	108	14	122	0.00001
SRR6145059	Blastomonas sp. RAC04	1842535	S	107	122	229	0.00003
SRR6145059	Sphingomonas sp. C8-2	2492837	S	169	121	290	0.00003
SRR6145059	Polaromonas sp. JS666	296591	S	103	121	224	0.00003
SRR6145059	Nordella sp. HKS 07	2712222	S	121	2	123	0.00001
SRR6145059	Mycobacterium parmense	185642	S	116	5	121	0.00001
SRR6145059	Leclercia sp. 1106151	2681309	S	30	121	151	0.00002
SRR6145059	Frondihabitans sp. PAMC 28766	1795630	S	121	4	125	0.00001
SRR6145059	Anaeromyxobacter dehalogenans	161493	S	90	31	121	0.00001
SRR6145059	Youhaiella tibetensis	1447062	S	111	9	120	0.00001
SRR6145059	Weissella confusa	1583	S	115	5	120	0.00001
SRR6145059	Streptomyces albireticuli	1940	S	110	10	120	0.00001
SRR6145059	Streptococcus mutans	1309	S	109	11	120	0.00001
SRR6145059	Ralstonia insidiosa	190721	S	108	12	120	0.00001
SRR6145059	Micromonospora terminaliae	1914461	S	101	19	120	0.00001
SRR6145059	Herbaspirillum rubrisubalbicans	80842	S	107	13	120	0.00001
SRR6145059	Corynebacterium terpenotabidum	89154	S	114	6	120	0.00001
SRR6145059	Brevibacterium sp. YB235	1496080	S	164	120	284	0.00003
SRR6145059	Altererythrobacter mangrovi	1982042	S	113	7	120	0.00001
SRR6145059	Aerosticca soli	2010829	S	91	29	120	0.00001
SRR6145059	Streptacidiphilus bronchialis	2126346	S	115	4	119	0.00001
SRR6145059	Pseudomonas furukawaii	1149133	S	111	8	119	0.00001
SRR6145059	Nocardioides baekrokdamisoli	1804624	S	116	3	119	0.00001
SRR6145059	Mycolicibacter terrae	1788	S	103	16	119	0.00001
SRR6145059	Micromonospora narathiwatensis	299146	S	100	19	119	0.00001
SRR6145059	Massilia plicata	321984	S	106	13	119	0.00001
SRR6145059	Thiomonas intermedia	926	S	83	35	118	0.00001
SRR6145059	Saccharomonospora marina	632569	S	99	19	118	0.00001
SRR6145059	Pseudomonas brassicacearum	930166	S	41	77	118	0.00001
SRR6145059	Mycobacteroides immunogenum	83262	S	104	14	118	0.00001
SRR6145059	Lysinimonas sp. KACC 19322	2592654	S	118	12	130	0.00002
SRR6145059	Bosea sp. RAC05	1842539	S	594	118	712	0.00008
SRR6145059	Streptomyces aureoverticillatus	66871	S	105	12	117	0.00001
SRR6145059	Streptomyces albulus	68570	S	105	12	117	0.00001
SRR6145059	Sphingopyxis sp. PAMC25046	2565556	S	310	117	427	0.00005
SRR6145059	Microbacterium sp. 1S1	2606451	S	390	117	507	0.00006
SRR6145059	Campylobacter ureolyticus	827	S	114	3	117	0.00001
SRR6145059	Blastochloris tepida	2233851	S	101	16	117	0.00001
SRR6145059	[Eubacterium] sulci	143393	S	115	1	116	0.00001
SRR6145059	Streptomyces xinghaiensis	1038928	S	109	7	116	0.00001
SRR6145059	Streptomyces subrutilus	36818	S	101	15	116	0.00001
SRR6145059	Streptomyces parvulus	146923	S	95	21	116	0.00001
SRR6145059	Streptomyces olivaceus	47716	S	18	98	116	0.00001
SRR6145059	Stackebrandtia nassauensis	283811	S	116	0	116	0.00001
SRR6145059	Sphingobium japonicum	332056	S	54	62	116	0.00001
SRR6145059	Ruegeria pomeroyi	89184	S	111	5	116	0.00001
SRR6145059	Pseudomonas knackmussii	65741	S	100	16	116	0.00001
SRR6145059	Mycobacterium simiae	1784	S	113	3	116	0.00001
SRR6145059	Celeribacter manganoxidans	1411902	S	100	16	116	0.00001
SRR6145059	Bifidobacterium longum	216816	S	87	29	116	0.00001
SRR6145059	Mycolicibacillus koreensis	1069220	S	105	10	115	0.00001
SRR6145059	Chondromyces crocatus	52	S	113	2	115	0.00001
SRR6145059	Chelatococcus daeguensis	444444	S	80	35	115	0.00001
SRR6145059	Streptomyces atratus	1893	S	108	6	114	0.00001
SRR6145059	Janthinobacterium sp. LM6	1938606	S	280	114	394	0.00005
SRR6145059	Corynebacterium argentoratense	42817	S	111	3	114	0.00001
SRR6145059	Brachybacterium sp. SGAir0954	2571029	S	1202	114	1316	0.00016
SRR6145059	Xanthomonas euvesicatoria	456327	S	28	85	113	0.00001
SRR6145059	Verrucosispora maris	1003110	S	97	16	113	0.00001
SRR6145059	Streptomyces griseoviridis	45398	S	102	11	113	0.00001
SRR6145059	Streptomyces ficellus	1977088	S	102	11	113	0.00001
SRR6145059	Micromonospora viridifaciens	1881	S	96	17	113	0.00001
SRR6145059	Micromonospora inositola	47865	S	95	18	113	0.00001
SRR6145059	Methylosinus trichosporium	426	S	100	13	113	0.00001
SRR6145059	Amycolatopsis japonica	208439	S	61	52	113	0.00001
SRR6145059	Thermobispora bispora	2006	S	111	1	112	0.00001
SRR6145059	Streptomyces lividans	1916	S	5	107	112	0.00001
SRR6145059	Streptomyces lincolnensis	1915	S	100	12	112	0.00001
SRR6145059	Micromonospora siamensis	299152	S	95	17	112	0.00001
SRR6145059	Micromonospora coxensis	356852	S	92	20	112	0.00001
SRR6145059	Ezakiella massiliensis	1852374	S	101	11	112	0.00001
SRR6145059	Corynebacterium cystitidis	35757	S	112	0	112	0.00001
SRR6145059	Streptomyces cacaoi	1898	S	98	13	111	0.00001
SRR6145059	Lachnospiraceae bacterium	1898203	S	14	97	111	0.00001
SRR6145059	Bradyrhizobium sp. ORS 3257	167468	S	111	15	126	0.00001
SRR6145059	Bordetella hinzii	103855	S	101	10	111	0.00001
SRR6145059	Bacteroides vulgatus	821	S	75	36	111	0.00001
SRR6145059	Bacillus megaterium	1404	S	86	25	111	0.00001
SRR6145059	Agromyces sp. KACC 19306	2592652	S	111	12	123	0.00001
SRR6145059	Leifsonia sp. 21MFCrub1.1	1798223	S	84	110	194	0.00002
SRR6145059	Egicoccus halophilus	1670830	S	110	0	110	0.00001
SRR6145059	Corynebacterium provencense	1737425	S	107	3	110	0.00001
SRR6145059	Bradyrhizobium paxllaeri	190148	S	97	13	110	0.00001
SRR6145059	Bradyrhizobium guangxiense	1325115	S	75	35	110	0.00001
SRR6145059	Actinoalloteichus hoggarensis	1470176	S	106	4	110	0.00001
SRR6145059	Sphingobium indicum	332055	S	45	64	109	0.00001
SRR6145059	Schaalia meyeri	52773	S	106	3	109	0.00001
SRR6145059	Rhodanobacter denitrificans	666685	S	95	14	109	0.00001
SRR6145059	Indioceanicola profundi	2220096	S	102	7	109	0.00001
SRR6145059	Yoonia vestfoldensis	245188	S	88	20	108	0.00001
SRR6145059	White spot syndrome virus	342409	S	108	0	108	0.00001
SRR6145059	Phaeobacter inhibens	221822	S	80	28	108	0.00001
SRR6145059	Nocardioides sp. zg-579	2663857	S	440	108	548	0.00007
SRR6145059	Gordonia sp. KTR9	337191	S	1448	108	1556	0.00019
SRR6145059	Blastochloris viridis	1079	S	96	12	108	0.00001
SRR6145059	Mycobacterium kansasii	1768	S	105	2	107	0.00001
SRR6145059	Mycobacterium heidelbergense	53376	S	100	7	107	0.00001
SRR6145059	Luteitalea pratensis	1855912	S	107	0	107	0.00001
SRR6145059	Georhizobium profundi	2341112	S	94	13	107	0.00001
SRR6145059	Agrobacterium rhizogenes	359	S	91	16	107	0.00001
SRR6145059	Aeromonas media	651	S	62	45	107	0.00001
SRR6145059	Actinomyces gaoshouyii	1960083	S	103	4	107	0.00001
SRR6145059	Streptomyces clavuligerus	1901	S	101	5	106	0.00001
SRR6145059	Staphylococcus simulans	1286	S	102	4	106	0.00001
SRR6145059	Rathayibacter sp. VKM Ac-2759	2609252	S	106	15	121	0.00001
SRR6145059	Porphyrobacter sp. LM 6	1896196	S	106	27	133	0.00002
SRR6145059	Herbaspirillum robiniae	2014887	S	97	9	106	0.00001
SRR6145059	Cupriavidus campinensis	151783	S	99	7	106	0.00001
SRR6145059	Caulobacter sp. FWC26	69665	S	336	106	442	0.00005
SRR6145059	Acetobacteraceae bacterium	1909293	S	105	1	106	0.00001
SRR6145059	Xanthomonas oryzae	347	S	93	12	105	0.00001
SRR6145059	Streptomyces sp. YIM 121038	2136401	S	105	19	124	0.00001
SRR6145059	Sphingobium sp. PAMC28499	2565554	S	94	105	199	0.00002
SRR6145059	Pseudomonas denitrificans (nomen rejiciendum)	43306	S	105	8	113	0.00001
SRR6145059	Mycolicibacter hiberniae	29314	S	98	7	105	0.00001
SRR6145059	Mycobacterium sp. WY10	1920667	S	43	105	148	0.00002
SRR6145059	Mycobacterium florentinum	292462	S	92	13	105	0.00001
SRR6145059	Methylibium sp. Pch-M	2082386	S	133	105	238	0.00003
SRR6145059	Capnocytophaga endodontalis	2708117	S	88	17	105	0.00001
SRR6145059	Bradyrhizobium symbiodeficiens	1404367	S	82	23	105	0.00001
SRR6145059	Bradyrhizobium sp. ORS 285	115808	S	105	13	118	0.00001
SRR6145059	Acidovorax sp. T1	1858609	S	118	105	223	0.00003
SRR6145059	Xanthomonas arboricola	56448	S	71	33	104	0.00001
SRR6145059	Streptomyces pristinaespiralis	38300	S	80	24	104	0.00001
SRR6145059	Streptomyces actuosus	1885	S	89	15	104	0.00001
SRR6145059	Prevotella enoeca	76123	S	94	10	104	0.00001
SRR6145059	Pasteurella multocida	747	S	78	26	104	0.00001
SRR6145059	Hydrogenophaga sp. NH-16	2184519	S	86	104	190	0.00002
SRR6145059	Cupriavidus sp. USMAHM13	1389192	S	51	104	155	0.00002
SRR6145059	Corynebacterium pseudopelargi	2080757	S	90	14	104	0.00001
SRR6145059	Acinetobacter calcoaceticus	471	S	99	5	104	0.00001
SRR6145059	Xanthomonas vesicatoria	56460	S	82	21	103	0.00001
SRR6145059	Streptococcus sobrinus	1310	S	102	1	103	0.00001
SRR6145059	Polaromonas naphthalenivorans	216465	S	97	6	103	0.00001
SRR6145059	Phaeobacter gallaeciensis	60890	S	72	31	103	0.00001
SRR6145059	Bradyrhizobium sp. ORS 278	114615	S	103	13	116	0.00001
SRR6145059	Bradyrhizobium icense	1274631	S	94	9	103	0.00001
SRR6145059	Auricoccus indicus	1849491	S	100	3	103	0.00001
SRR6145059	Atopobium parvulum	1382	S	102	1	103	0.00001
SRR6145059	Streptomyces collinus	42684	S	88	14	102	0.00001
SRR6145059	Simplicispira suum	2109915	S	95	7	102	0.00001
SRR6145059	Rubrobacter sp. SCSIO 52909	2653851	S	102	2	104	0.00001
SRR6145059	Paludisphaera borealis	1387353	S	95	7	102	0.00001
SRR6145059	Orrella dioscoreae	1851544	S	95	7	102	0.00001
SRR6145059	Exiguobacterium mexicanum	340146	S	99	3	102	0.00001
SRR6145059	Corynebacterium pelargi	1471400	S	89	13	102	0.00001
SRR6145059	Azospirillum humicireducens	1226968	S	68	34	102	0.00001
SRR6145059	Acinetobacter sp. SWBY1	2079596	S	134	102	236	0.00003
SRR6145059	Streptomyces antibioticus	1890	S	88	13	101	0.00001
SRR6145059	Sphingobium sp. CAP-1	2676077	S	193	101	294	0.00003
SRR6145059	Pseudolabrys taiwanensis	331696	S	94	7	101	0.00001
SRR6145059	Prevotella fusca	589436	S	94	7	101	0.00001
SRR6145059	Phytobacter ursingii	1972431	S	60	41	101	0.00001
SRR6145059	Campylobacter showae	204	S	100	1	101	0.00001
SRR6145059	Treponema sp. OMZ 804	120683	S	100	10	110	0.00001
SRR6145059	Streptomyces xiamenensis	408015	S	97	3	100	0.00001
SRR6145059	Stenotrophomonas sp. ASS1	2282124	S	55	100	155	0.00002
SRR6145059	Rhodococcus sp. 008	1723645	S	24	100	124	0.00001
SRR6145059	Pseudomonas sp. 02C 26	2054914	S	100	3	103	0.00001
SRR6145059	Propionibacterium australiense	119981	S	94	6	100	0.00001
SRR6145059	Nocardiopsis alba	53437	S	95	5	100	0.00001
SRR6145059	Niveispirillum cyanobacteriorum	1612173	S	95	5	100	0.00001
SRR6145059	Mycobacterium colombiense	339268	S	98	2	100	0.00001
SRR6145059	Hartmannibacter diazotrophicus	1482074	S	94	6	100	0.00001
SRR6145059	Bordetella flabilis	463014	S	99	1	100	0.00001
SRR6145059	Bacillus thuringiensis	1428	S	47	53	100	0.00001
SRR6145059	Achromobacter insolitus	217204	S	92	8	100	0.00001
SRR6145059	Streptomyces fungicidicus	68203	S	83	16	99	0.00001
SRR6145059	Pseudomonas koreensis	198620	S	82	17	99	0.00001
SRR6145059	Mycobacterium mantenii	560555	S	98	1	99	0.00001
SRR6145059	Micromonospora sp. L5	648999	S	13	99	112	0.00001
SRR6145059	Erythrobacter seohaensis	266951	S	85	14	99	0.00001
SRR6145059	Collimonas arenae	279058	S	91	8	99	0.00001
SRR6145059	Streptomyces exfoliatus	1905	S	86	12	98	0.00001
SRR6145059	Streptomyces cinereoruber	67260	S	10	88	98	0.00001
SRR6145059	Streptococcus equinus	1335	S	51	47	98	0.00001
SRR6145059	Myxococcus stipitatus	83455	S	94	4	98	0.00001
SRR6145059	Mycobacterium conspicuum	44010	S	97	1	98	0.00001
SRR6145059	Burkholderia sp. CCGE1001	640510	S	128	98	226	0.00003
SRR6145059	Acinetobacter defluvii	1871111	S	86	12	98	0.00001
SRR6145059	Acidovorax sp. KKS102	358220	S	405	98	503	0.00006
SRR6145059	Streptomyces olivoreticuli	68246	S	90	7	97	0.00001
SRR6145059	Streptomyces lunaelactis	1535768	S	92	5	97	0.00001
SRR6145059	Streptococcus suis	1307	S	88	9	97	0.00001
SRR6145059	Saccharomonospora cyanea	40989	S	74	23	97	0.00001
SRR6145059	Methylobacterium sp. DM1	2067957	S	136	97	233	0.00003
SRR6145059	Ilumatobacter coccineus	467094	S	96	1	97	0.00001
SRR6145059	Enterococcus casseliflavus	37734	S	72	25	97	0.00001
SRR6145059	Dyella thiooxydans	445710	S	85	12	97	0.00001
SRR6145059	Chryseobacterium sp. NEB161	2724619	S	553	97	650	0.00008
SRR6145059	Burkholderia sp. YI23	1097668	S	85	97	182	0.00002
SRR6145059	Burkholderia metallica	488729	S	89	8	97	0.00001
SRR6145059	Streptomyces sp. DSM 40868	2721173	S	96	14	110	0.00001
SRR6145059	Streptomyces luteoverticillatus	66425	S	89	7	96	0.00001
SRR6145059	Streptomyces fodineus	1904616	S	82	14	96	0.00001
SRR6145059	Rhizobium sp. TCK	136098	S	15	96	111	0.00001
SRR6145059	Pseudomonas protegens	380021	S	87	9	96	0.00001
SRR6145059	Leuconostoc lactis	1246	S	74	22	96	0.00001
SRR6145059	Hypericibacter terrae	2602015	S	90	6	96	0.00001
SRR6145059	Chryseobacterium gallinarum	1324352	S	92	4	96	0.00001
SRR6145059	Streptomyces vietnamensis	362257	S	82	13	95	0.00001
SRR6145059	Streptomyces sp. VN1	1821625	S	18	95	113	0.00001
SRR6145059	Streptomyces qinzhouensis	2599401	S	87	8	95	0.00001
SRR6145059	Raoultella planticola	575	S	79	16	95	0.00001
SRR6145059	Pseudomonas sihuiensis	1274359	S	62	33	95	0.00001
SRR6145059	Pseudomonas azotoformans	47878	S	72	23	95	0.00001
SRR6145059	Erythrobacter gangjinensis	502682	S	93	2	95	0.00001
SRR6145059	Cryobacterium arcticum	670052	S	78	17	95	0.00001
SRR6145059	Streptomyces katrae	68223	S	81	13	94	0.00001
SRR6145059	Mycolicibacter sinensis	875328	S	86	8	94	0.00001
SRR6145059	Enterococcus faecalis	1351	S	86	8	94	0.00001
SRR6145059	Curtobacterium flaccumfaciens	2035	S	86	8	94	0.00001
SRR6145059	Corynebacterium geronticis	2079234	S	89	5	94	0.00001
SRR6145059	Collimonas fungivorans	158899	S	84	10	94	0.00001
SRR6145059	Streptomyces globosus	68209	S	84	9	93	0.00001
SRR6145059	Streptomyces cavourensis	67258	S	28	65	93	0.00001
SRR6145059	Sagittula sp. P11	2009329	S	166	93	259	0.00003
SRR6145059	Pseudomonas versuta	1788301	S	89	4	93	0.00001
SRR6145059	Paraburkholderia sp. 7MH5	2547399	S	1794	93	1887	0.00022
SRR6145059	Pandoraea vervacti	656178	S	75	18	93	0.00001
SRR6145059	Nocardiopsis gilva	280236	S	90	3	93	0.00001
SRR6145059	Neisseria polysaccharea	489	S	50	43	93	0.00001
SRR6145059	Myxococcus hansupus	1297742	S	77	16	93	0.00001
SRR6145059	Moraxella catarrhalis	480	S	92	1	93	0.00001
SRR6145059	Micromonospora coriariae	285665	S	83	10	93	0.00001
SRR6145059	Mesorhizobium amorphae	71433	S	82	11	93	0.00001
SRR6145059	Martelella mediterranea	293089	S	73	20	93	0.00001
SRR6145059	Luteibacter pinisoli	2589080	S	85	8	93	0.00001
SRR6145059	Azospira sp. I09	1765049	S	106	93	199	0.00002
SRR6145059	Aeromonas salmonicida	645	S	75	18	93	0.00001
SRR6145059	Variovorax sp. SRS16	282217	S	50	92	142	0.00002
SRR6145059	Streptomyces nigra	1827580	S	80	12	92	0.00001
SRR6145059	Rubrobacter sp. SCSIO 52915	2653852	S	92	3	95	0.00001
SRR6145059	Rhodococcus jostii	132919	S	78	14	92	0.00001
SRR6145059	Rathayibacter sp. VKM Ac-2760	2609253	S	92	30	122	0.00001
SRR6145059	Rahnella aquatilis	34038	S	57	35	92	0.00001
SRR6145059	Pseudomonas balearica	74829	S	71	21	92	0.00001
SRR6145059	Propionibacterium virus PHL071N05	1982280	S	79	92	171	0.00002
SRR6145059	Pandoraea fibrosis	1891094	S	71	21	92	0.00001
SRR6145059	Mycobacterium stomatepiae	470076	S	78	14	92	0.00001
SRR6145059	Mycobacterium marseillense	701042	S	88	4	92	0.00001
SRR6145059	Microbacterium sp. SGAir0570	2070348	S	41	92	133	0.00002
SRR6145059	Marisediminicola antarctica	674079	S	90	2	92	0.00001
SRR6145059	Leisingera aquaemixtae	1396826	S	82	10	92	0.00001
SRR6145059	Gluconacetobacter diazotrophicus	33996	S	87	5	92	0.00001
SRR6145059	Chryseobacterium nakagawai	1241982	S	66	26	92	0.00001
SRR6145059	Chryseobacterium lactis	1241981	S	82	10	92	0.00001
SRR6145059	Cellulosimicrobium sp. TH-20	1980001	S	37	92	129	0.00002
SRR6145059	Actinomyces qiguomingii	2057800	S	91	1	92	0.00001
SRR6145059	Actinoalloteichus hymeniacidonis	340345	S	90	2	92	0.00001
SRR6145059	Acinetobacter sp. WCHA55	2004646	S	371	92	463	0.00006
SRR6145059	Acinetobacter cumulans	2136182	S	86	6	92	0.00001
SRR6145059	Streptomyces gilvosporeus	553510	S	82	9	91	0.00001
SRR6145059	Streptomyces asterosporus	285570	S	76	15	91	0.00001
SRR6145059	Streptomyces anulatus	1892	S	69	22	91	0.00001
SRR6145059	Streptomyces antimycoticus	68175	S	61	30	91	0.00001
SRR6145059	Roseitalea porphyridii	1852022	S	85	6	91	0.00001
SRR6145059	Prevotella dentalis	52227	S	86	5	91	0.00001
SRR6145059	Mycobacterium intracellulare	1767	S	50	41	91	0.00001
SRR6145059	Mesorhizobium japonicum	2066070	S	57	34	91	0.00001
SRR6145059	Chryseobacterium carnis	1241979	S	87	4	91	0.00001
SRR6145059	Burkholderia pseudomultivorans	1207504	S	79	12	91	0.00001
SRR6145059	Brevibacterium sp. 'Marine'	2725563	S	145	91	236	0.00003
SRR6145059	Bradyrhizobium sp. TM102	2599819	S	10	91	101	0.00001
SRR6145059	Bradyrhizobium sp. CCBAU 051011	858422	S	91	11	102	0.00001
SRR6145059	Bradyrhizobium betae	244734	S	62	29	91	0.00001
SRR6145059	Austwickia chelonae	100225	S	89	2	91	0.00001
SRR6145059	Actinomyces pacaensis	1852377	S	90	1	91	0.00001
SRR6145059	Thermomonospora curvata	2020	S	84	6	90	0.00001
SRR6145059	Sphingopyxis sp. 113P3	292913	S	299	90	389	0.00005
SRR6145059	Sphingobacterium mizutaii	1010	S	89	1	90	0.00001
SRR6145059	Pseudorhodoplanes sinuspersici	1235591	S	88	2	90	0.00001
SRR6145059	Pandoraea sputorum	93222	S	64	26	90	0.00001
SRR6145059	Pandoraea oxalativorans	573737	S	62	28	90	0.00001
SRR6145059	Micromonospora zamorensis	709883	S	81	9	90	0.00001
SRR6145059	Micromonospora rifamycinica	291594	S	77	13	90	0.00001
SRR6145059	Arthrobacter crystallopoietes	37928	S	89	1	90	0.00001
SRR6145059	Streptomyces dengpaensis	2049881	S	81	8	89	0.00001
SRR6145059	Streptomyces davaonensis	348043	S	80	9	89	0.00001
SRR6145059	Streptomyces coeruleorubidus	116188	S	71	18	89	0.00001
SRR6145059	Mobiluncus curtisii	2051	S	87	2	89	0.00001
SRR6145059	Methylocystis rosea	173366	S	76	13	89	0.00001
SRR6145059	Methylocella silvestris	199596	S	85	4	89	0.00001
SRR6145059	Leptotrichia shahii	157691	S	76	13	89	0.00001
SRR6145059	Flaviflexus salsibiostraticola	1282737	S	86	3	89	0.00001
SRR6145059	Azospirillum oryzae	286727	S	48	41	89	0.00001
SRR6145059	Truepera radiovictrix	332249	S	88	0	88	0.00001
SRR6145059	Tardiphaga sp. vice304	2592817	S	5	88	93	0.00001
SRR6145059	Streptomyces peucetius	1950	S	81	7	88	0.00001
SRR6145059	Streptococcus sp. 116-D4	2598453	S	517	88	605	0.00007
SRR6145059	Spirosoma montaniterrae	1178516	S	85	3	88	0.00001
SRR6145059	Sphingomonas sp. IC081	304378	S	279	88	367	0.00004
SRR6145059	Rhodococcus sp. 2G	1570939	S	36	88	124	0.00001
SRR6145059	Pseudomonas alcaliphila	101564	S	58	30	88	0.00001
SRR6145059	Planctomycetes bacterium K2D	2527962	S	6	88	94	0.00001
SRR6145059	Novosphingobium sp. ABRDHK2	2571749	S	257	88	345	0.00004
SRR6145059	Neisseria gonorrhoeae	485	S	62	26	88	0.00001
SRR6145059	Micromonospora tulbaghiae	479978	S	54	34	88	0.00001
SRR6145059	Lachnoanaerobaculum umeaense	617123	S	87	1	88	0.00001
SRR6145059	Gemmata massiliana	1210884	S	64	24	88	0.00001
SRR6145059	Cellulosimicrobium sp. 72-3	2731680	S	38	88	126	0.00001
SRR6145059	Castellaniella defragrans	75697	S	81	7	88	0.00001
SRR6145059	Bacteroides fragilis	817	S	80	8	88	0.00001
SRR6145059	Zhihengliuella sp. ISTPL4	2058657	S	201	87	288	0.00003
SRR6145059	Streptomyces hundungensis	1077946	S	81	6	87	0.00001
SRR6145059	Streptomyces alboniger	132473	S	73	14	87	0.00001
SRR6145059	Sinorhizobium americanum	194963	S	77	10	87	0.00001
SRR6145059	Pelagibacterium halotolerans	531813	S	63	24	87	0.00001
SRR6145059	Paenarthrobacter aurescens	43663	S	22	65	87	0.00001
SRR6145059	Hyphomicrobium denitrificans	53399	S	79	8	87	0.00001
SRR6145059	Hylemonella gracilis	80880	S	86	1	87	0.00001
SRR6145059	Celeribacter ethanolicus	1758178	S	62	25	87	0.00001
SRR6145059	Campylobacter rectus	203	S	86	1	87	0.00001
SRR6145059	Bordetella bronchialis	463025	S	85	2	87	0.00001
SRR6145059	Arthrobacter dokdonellae	2211210	S	86	1	87	0.00001
SRR6145059	Alienimonas californiensis	2527989	S	87	0	87	0.00001
SRR6145059	Streptomyces tirandamycinicus	2174846	S	76	10	86	0.00001
SRR6145059	Streptomyces seoulensis	73044	S	76	10	86	0.00001
SRR6145059	Streptomyces formicae	1616117	S	69	17	86	0.00001
SRR6145059	Streptomyces cyaneochromogenes	2496836	S	76	10	86	0.00001
SRR6145059	Streptomyces bacillaris	68179	S	16	70	86	0.00001
SRR6145059	Streptococcus phage phiARI0131-1	1701813	S	2	86	88	0.00001
SRR6145059	Neomicrococcus aestuarii	556325	S	83	3	86	0.00001
SRR6145059	Mycolicibacter minnesotensis	1118379	S	82	4	86	0.00001
SRR6145059	Leuconostoc pseudomesenteroides	33968	S	79	7	86	0.00001
SRR6145059	Lactobacillus gasseri	1596	S	21	65	86	0.00001
SRR6145059	Lacipirellula parvula	2650471	S	83	3	86	0.00001
SRR6145059	Streptomyces pactum	68249	S	70	15	85	0.00001
SRR6145059	Streptomyces nitrosporeus	28894	S	78	7	85	0.00001
SRR6145059	Sphingobacterium lactis	797291	S	81	4	85	0.00001
SRR6145059	Halomonas sp. JS92-SW72	2306583	S	155	85	240	0.00003
SRR6145059	Erythrobacter aureus	2182384	S	80	5	85	0.00001
SRR6145059	Betapapillomavirus 3	334207	S	85	0	85	0.00001
SRR6145059	Sulfitobacter sp. AM1-D1	1917485	S	110	84	194	0.00002
SRR6145059	Streptomyces nodosus	40318	S	79	5	84	0.00001
SRR6145059	Streptomyces malaysiensis	92644	S	18	66	84	0.00001
SRR6145059	Salinispora arenicola	168697	S	77	7	84	0.00001
SRR6145059	Paraoerskovia marina	545619	S	81	3	84	0.00001
SRR6145059	Halomonas beimenensis	475662	S	83	1	84	0.00001
SRR6145059	Flavobacterium album	2175091	S	83	1	84	0.00001
SRR6145059	Ferrovibrio terrae	2594003	S	83	1	84	0.00001
SRR6145059	Corynebacterium rouxii	2719119	S	64	20	84	0.00001
SRR6145059	Bradyrhizobium canariense	255045	S	81	3	84	0.00001
SRR6145059	Streptomyces sp. RLB1-9	2594454	S	2	83	85	0.00001
SRR6145059	Streptomyces fulvissimus	68202	S	64	19	83	0.00001
SRR6145059	Streptomyces aquilus	2548456	S	73	10	83	0.00001
SRR6145059	Streptococcus sp. FDAARGOS_192	1839799	S	53	83	136	0.00002
SRR6145059	Streptococcus pseudoporcinus	361101	S	35	48	83	0.00001
SRR6145059	Sphingomonas sp. CL5.1	2653203	S	647	83	730	0.00009
SRR6145059	Mycobacterium lacus	169765	S	83	0	83	0.00001
SRR6145059	Chryseobacterium jeonii	266749	S	83	0	83	0.00001
SRR6145059	Bordetella petrii	94624	S	64	19	83	0.00001
SRR6145059	[Pseudomonas] mesoacidophila	265293	S	77	5	82	0.00001
SRR6145059	Streptomyces violaceusniger	68280	S	51	31	82	0.00001
SRR6145059	Streptomyces sp. S1D4-20	2594462	S	4	82	86	0.00001
SRR6145059	Pseudomonas sp. 13159349	2662034	S	19	82	101	0.00001
SRR6145059	Mycobacteroides salmoniphilum	404941	S	79	3	82	0.00001
SRR6145059	Collimonas pratensis	279113	S	71	11	82	0.00001
SRR6145059	Chryseobacterium glaciei	1685010	S	78	4	82	0.00001
SRR6145059	Bacillus flexus	86664	S	81	1	82	0.00001
SRR6145059	Altererythrobacter namhicola	645517	S	78	4	82	0.00001
SRR6145059	Streptomyces violaceoruber	1935	S	67	14	81	0.00001
SRR6145059	Streptomyces tendae	1932	S	70	11	81	0.00001
SRR6145059	Selenomonas sputigena	69823	S	81	0	81	0.00001
SRR6145059	Rhodospirillum rubrum	1085	S	75	6	81	0.00001
SRR6145059	Rathayibacter tanaceti	1671680	S	73	8	81	0.00001
SRR6145059	Ralstonia mannitolilytica	105219	S	63	18	81	0.00001
SRR6145059	Methylobacterium sp. 17Sr1-1	2202826	S	470	81	551	0.00007
SRR6145059	Mesorhizobium australicum	536018	S	62	19	81	0.00001
SRR6145059	Lichenihabitans psoromatis	2528642	S	79	2	81	0.00001
SRR6145059	Janthinobacterium sp. 1_2014MBL_MicDiv	1644131	S	352	81	433	0.00005
SRR6145059	Gluconobacter oxydans	442	S	57	24	81	0.00001
SRR6145059	Corynebacterium suranareeae	2506452	S	72	9	81	0.00001
SRR6145059	Comamonas kerstersii	225992	S	75	6	81	0.00001
SRR6145059	Burkholderia ambifaria	152480	S	53	28	81	0.00001
SRR6145059	Acinetobacter chinensis	2004650	S	66	15	81	0.00001
SRR6145059	Achromobacter sp. MFA1 R4	1881016	S	81	9	90	0.00001
SRR6145059	Streptomyces vinaceus	1960	S	69	11	80	0.00001
SRR6145059	Streptomyces sp. WAC00288	2094021	S	11	80	91	0.00001
SRR6145059	Streptomyces cyaneogriseus	68192	S	47	33	80	0.00001
SRR6145059	Streptomyces avermitilis	33903	S	72	8	80	0.00001
SRR6145059	Ensifer alkalisoli	1752398	S	68	12	80	0.00001
SRR6145059	Corynebacterium crudilactis	1652495	S	65	15	80	0.00001
SRR6145059	Bifidobacterium adolescentis	1680	S	74	6	80	0.00001
SRR6145059	Variibacter gotjawalensis	1333996	S	77	2	79	0.00001
SRR6145059	Streptomyces prasinus	67345	S	71	8	79	0.00001
SRR6145059	Mycobacteroides saopaulense	1578165	S	74	5	79	0.00001
SRR6145059	Mycobacterium shinjukuense	398694	S	79	0	79	0.00001
SRR6145059	Leisingera methylohalidivorans	133924	S	66	13	79	0.00001
SRR6145059	Chryseobacterium camelliae	1265445	S	76	3	79	0.00001
SRR6145059	Bradyrhizobium amphicarpaeae	1404768	S	59	20	79	0.00001
SRR6145059	Azoarcus communis	41977	S	75	4	79	0.00001
SRR6145059	Agrobacterium larrymoorei	160699	S	75	4	79	0.00001
SRR6145059	Actinobacteria bacterium YIM 96077	2487353	S	79	0	79	0.00001
SRR6145059	Thauera humireducens	1134435	S	72	6	78	0.00001
SRR6145059	Streptomyces sp. WAC 01529	2203205	S	78	15	93	0.00001
SRR6145059	Streptococcus milleri	33040	S	39	39	78	0.00001
SRR6145059	Sinorhizobium medicae	110321	S	73	5	78	0.00001
SRR6145059	Saccharomonospora glauca	40990	S	64	14	78	0.00001
SRR6145059	Martelella endophytica	1486262	S	70	8	78	0.00001
SRR6145059	Cupriavidus nantongensis	1796606	S	52	26	78	0.00001
SRR6145059	Bradyrhizobium zhanjiangense	1325107	S	69	9	78	0.00001
SRR6145059	Bradyrhizobium sp. SG09	2599805	S	8	78	86	0.00001
SRR6145059	Shewanella putrefaciens	24	S	33	44	77	0.00001
SRR6145059	Pseudomonas synxantha	47883	S	57	20	77	0.00001
SRR6145059	Mycobacterium paraseoulense	590652	S	76	1	77	0.00001
SRR6145059	Frankia casuarinae	106370	S	75	2	77	0.00001
SRR6145059	Acidibrevibacterium fodinaquatile	1969806	S	75	2	77	0.00001
SRR6145059	Streptomyces viridosporus	67581	S	64	12	76	0.00001
SRR6145059	Streptomyces griseochromogenes	68214	S	68	8	76	0.00001
SRR6145059	Staphylococcus virus IPLA5	1197952	S	7	76	83	0.00001
SRR6145059	Staphylococcus succinus	61015	S	75	1	76	0.00001
SRR6145059	Sphingomonas sp. KC8	1030157	S	181	76	257	0.00003
SRR6145059	Rhodoferax saidenbachensis	1484693	S	74	2	76	0.00001
SRR6145059	Pseudomonas parafulva	157782	S	66	10	76	0.00001
SRR6145059	Mycobacterium noviomagense	459858	S	76	0	76	0.00001
SRR6145059	Microbacterium sp. CGR1	1696072	S	26	76	102	0.00001
SRR6145059	Magnetospirillum magneticum	84159	S	62	14	76	0.00001
SRR6145059	Enterobacter bugandensis	881260	S	61	15	76	0.00001
SRR6145059	Campylobacter gracilis	824	S	76	0	76	0.00001
SRR6145059	Burkholderia oklahomensis	342113	S	70	6	76	0.00001
SRR6145059	Acinetobacter sp. NEB149	2725684	S	56	76	132	0.00002
SRR6145059	Trueperella pyogenes	1661	S	70	5	75	0.00001
SRR6145059	Thauera chlorobenzoica	96773	S	56	19	75	0.00001
SRR6145059	Streptomyces spongiicola	1690221	S	66	9	75	0.00001
SRR6145059	Streptomyces roseochromogenus	285450	S	66	9	75	0.00001
SRR6145059	Staphylococcus virus PH15	399185	S	8	75	83	0.00001
SRR6145059	Sphingobium sp. LF-16	2185111	S	6	75	81	0.00001
SRR6145059	Serinicoccus sp. JLT9	1758689	S	265	75	340	0.00004
SRR6145059	Rhodococcus sp. AQ5-07	2054902	S	24	75	99	0.00001
SRR6145059	Rhodococcus biphenylivorans	1500843	S	12	63	75	0.00001
SRR6145059	Nocardioides sp. dk884	2662361	S	330	75	405	0.00005
SRR6145059	Elizabethkingia bruuniana	1756149	S	29	46	75	0.00001
SRR6145059	Cronobacter sakazakii	28141	S	52	23	75	0.00001
SRR6145059	Chryseobacterium sp.	1871047	S	71	4	75	0.00001
SRR6145059	Burkholderia anthina	179879	S	68	7	75	0.00001
SRR6145059	Streptomyces sp. FR-008	206662	S	9	74	83	0.00001
SRR6145059	Streptococcus sp. LPB0220	2610896	S	218	74	292	0.00003
SRR6145059	Staphylococcus simiae	308354	S	72	2	74	0.00001
SRR6145059	Sphingopyxis sp. FD7	1914525	S	255	74	329	0.00004
SRR6145059	Rubrobacter xylanophilus	49319	S	74	0	74	0.00001
SRR6145059	Riemerella anatipestifer	34085	S	69	5	74	0.00001
SRR6145059	Rhodobacter sp. LPB0142	1850250	S	291	74	365	0.00004
SRR6145059	Kitasatospora albolonga	68173	S	57	17	74	0.00001
SRR6145059	Erythrobacter atlanticus	1648404	S	55	19	74	0.00001
SRR6145059	Bradymonas sediminis	1548548	S	22	52	74	0.00001
SRR6145059	Actinomyces israelii	1659	S	73	1	74	0.00001
SRR6145059	Acinetobacter sp. FDAARGOS_493	2420300	S	5	74	79	0.00001
SRR6145059	Schaalia cardiffensis	181487	S	72	1	73	0.00001
SRR6145059	Pseudomonas rhodesiae	76760	S	62	11	73	0.00001
SRR6145059	Pseudomonas oryzae	1392877	S	70	3	73	0.00001
SRR6145059	Pseudomonas moraviensis	321662	S	61	12	73	0.00001
SRR6145059	Pantoea ananatis	553	S	69	4	73	0.00001
SRR6145059	Pandoraea thiooxydans	445709	S	73	0	73	0.00001
SRR6145059	Mycobacterium basiliense	2094119	S	73	0	73	0.00001
SRR6145059	Microbacterium amylolyticum	936337	S	71	2	73	0.00001
SRR6145059	Methylocystis heyeri	391905	S	69	4	73	0.00001
SRR6145059	Mesorhizobium huakuii	28104	S	12	61	73	0.00001
SRR6145059	Leclercia sp. LSNIH1	1920114	S	15	73	88	0.00001
SRR6145059	Bradyrhizobium sp. LCT2	2493093	S	18	73	91	0.00001
SRR6145059	Altererythrobacter epoxidivorans	361183	S	62	11	73	0.00001
SRR6145059	Actinopolyspora erythraea	414996	S	73	0	73	0.00001
SRR6145059	Xanthomonas albilineans	29447	S	70	2	72	0.00001
SRR6145059	Variovorax sp. WDL1	207745	S	127	72	199	0.00002
SRR6145059	Treponema sp. OMZ 838	1539298	S	72	7	79	0.00001
SRR6145059	Thauera aromatica	59405	S	52	20	72	0.00001
SRR6145059	Streptomyces sp. Tu 2975	2676871	S	72	12	84	0.00001
SRR6145059	Streptomyces sp. SM17	565560	S	6	72	78	0.00001
SRR6145059	Streptomyces kanamyceticus	1967	S	59	13	72	0.00001
SRR6145059	Sphingobium sp. MI1205	407020	S	91	72	163	0.00002
SRR6145059	Rhodoferax ferrireducens	192843	S	70	2	72	0.00001
SRR6145059	Kitasatospora aureofaciens	1894	S	11	61	72	0.00001
SRR6145059	Actinoplanes sp. N902-109	649831	S	188	72	260	0.00003
SRR6145059	Streptomyces sp. S1D4-23	2594463	S	2	71	73	0.00001
SRR6145059	Streptomyces glaucescens	1907	S	60	11	71	0.00001
SRR6145059	Stenotrophomonas sp. Pemsol	2040586	S	26	71	97	0.00001
SRR6145059	Staphylococcus virus CNPH82	398839	S	3	71	74	0.00001
SRR6145059	Sphingobium sp. YG1	2082188	S	272	71	343	0.00004
SRR6145059	Propionibacterium virus PHL009M11	1982273	S	62	71	133	0.00002
SRR6145059	Mycobacterium xenopi	1789	S	69	2	71	0.00001
SRR6145059	Gordonia sp. YC-JH1	2059875	S	325	71	396	0.00005
SRR6145059	Glutamicibacter halophytocola	1933880	S	68	3	71	0.00001
SRR6145059	Chryseobacterium sp. NBC 122	2547600	S	71	1	72	0.00001
SRR6145059	Chryseobacterium joostei	112234	S	63	8	71	0.00001
SRR6145059	Streptomyces pluripotens	1355015	S	66	4	70	0.00001
SRR6145059	Streptomyces autolyticus	75293	S	15	55	70	0.00001
SRR6145059	Staphylococcus pseudintermedius	283734	S	58	12	70	0.00001
SRR6145059	Rathayibacter sp. VKM Ac-2804	2609257	S	70	42	112	0.00001
SRR6145059	Microlunatus sp. Gsoil 973	2672569	S	70	2	72	0.00001
SRR6145059	Methylocystis parvus	134	S	66	4	70	0.00001
SRR6145059	Klebsiella sp. PO552	1972757	S	9	70	79	0.00001
SRR6145059	Hymenobacter nivis	1850093	S	55	15	70	0.00001
SRR6145059	Ensifer sojae	716925	S	52	18	70	0.00001
SRR6145059	Chromohalobacter salexigens	158080	S	70	0	70	0.00001
SRR6145059	Agrobacterium vitis	373	S	68	2	70	0.00001
SRR6145059	Xanthomonas hortorum	56454	S	36	33	69	0.00001
SRR6145059	Streptomyces leeuwenhoekii	1437453	S	42	27	69	0.00001
SRR6145059	Streptococcus sp. HSISM1	1316408	S	212	69	281	0.00003
SRR6145059	Staphylococcus condimenti	70255	S	64	5	69	0.00001
SRR6145059	Rhodobacteraceae bacterium 9Alg 56	2683284	S	69	0	69	0.00001
SRR6145059	Novosphingobium sp. PP1Y	702113	S	72	69	141	0.00002
SRR6145059	Nocardioides sp. 603	2483798	S	317	69	386	0.00005
SRR6145059	Magnetospirillum gryphiswaldense	55518	S	67	2	69	0.00001
SRR6145059	Enterobacteriaceae bacterium ENNIH1	2066051	S	108	69	177	0.00002
SRR6145059	Buchnera aphidicola	9	S	70	-1	69	0.00001
SRR6145059	Streptomyces sp. WAC 01438	2203204	S	68	9	77	0.00001
SRR6145059	Rhizobium tropici	398	S	58	10	68	0.00001
SRR6145059	Rhizobium favelukesii	348824	S	61	7	68	0.00001
SRR6145059	Pseudonocardia sp. EC080610-09	1688404	S	1	68	69	0.00001
SRR6145059	Pseudomonas alkylphenolica	237609	S	65	3	68	0.00001
SRR6145059	Paenibacillus polymyxa	1406	S	17	51	68	0.00001
SRR6145059	Nocardioides sp. S-1144	2582905	S	434	68	502	0.00006
SRR6145059	Mycobacterium seoulense	386911	S	67	1	68	0.00001
SRR6145059	Mesorhizobium erdmanii	1777866	S	54	14	68	0.00001
SRR6145059	Bifidobacterium breve	1685	S	46	22	68	0.00001
SRR6145059	Bdellovibrio bacteriovorus	959	S	62	6	68	0.00001
SRR6145059	Azotobacter salinestris	69964	S	50	18	68	0.00001
SRR6145059	Afipia sp. GAS231	1882747	S	73	68	141	0.00002
SRR6145059	Streptomyces sampsonii	42239	S	7	60	67	0.00001
SRR6145059	Pseudomonas orientalis	76758	S	57	10	67	0.00001
SRR6145059	Methylovirgula ligni	569860	S	64	3	67	0.00001
SRR6145059	Lactococcus raffinolactis	1366	S	62	5	67	0.00001
SRR6145059	Lactobacillus plantarum	1590	S	30	37	67	0.00001
SRR6145059	Elizabethkingia miricola	172045	S	40	27	67	0.00001
SRR6145059	Chromobacterium violaceum	536	S	58	9	67	0.00001
SRR6145059	Bacteriovorax stolpii	960	S	67	0	67	0.00001
SRR6145059	Acinetobacter baylyi	202950	S	66	1	67	0.00001
SRR6145059	Streptomyces sp. DUT11	1914992	S	19	66	85	0.00001
SRR6145059	Streptomyces sp. 11-1-2	1851167	S	23	66	89	0.00001
SRR6145059	Streptomyces galilaeus	33899	S	59	7	66	0.00001
SRR6145059	Pyruvatibacter mobilis	1712261	S	65	1	66	0.00001
SRR6145059	Pseudomonas taetrolens	47884	S	64	2	66	0.00001
SRR6145059	Mesorhizobium sp. M2A.F.Ca.ET.046.03.2.1	2493674	S	22	66	88	0.00001
SRR6145059	Mesorhizobium opportunistum	593909	S	50	16	66	0.00001
SRR6145059	Immundisolibacter cernigliae	1810504	S	65	1	66	0.00001
SRR6145059	Frateuria aurantia	81475	S	62	4	66	0.00001
SRR6145059	Bordetella pertussis	520	S	14	52	66	0.00001
SRR6145059	Azotobacter chroococcum	353	S	51	15	66	0.00001
SRR6145059	Actinosynnema mirum	40567	S	8	58	66	0.00001
SRR6145059	Streptomyces sp. RLB3-6	2594457	S	3	65	68	0.00001
SRR6145059	Streptomyces rochei	1928	S	36	29	65	0.00001
SRR6145059	Stenotrophomonas sp. SAU14A_NAIMI4_8	2072409	S	16	65	81	0.00001
SRR6145059	Saccharomonospora viridis	1852	S	62	3	65	0.00001
SRR6145059	Rhodothermaceae bacterium	2026787	S	33	32	65	0.00001
SRR6145059	Rhizobium sp. CCGE531	2364271	S	3	65	68	0.00001
SRR6145059	Rhizobium daejeonense	240521	S	60	5	65	0.00001
SRR6145059	Pseudomonas guangdongensis	1245526	S	63	2	65	0.00001
SRR6145059	Microbacterium sp. 1.5R	1916917	S	23	65	88	0.00001
SRR6145059	Micavibrio aeruginosavorus	349221	S	65	0	65	0.00001
SRR6145059	Metakosakonia sp. MRY16-398	2487150	S	13	65	78	0.00001
SRR6145059	Massilia sp. YMA4	1593482	S	176	65	241	0.00003
SRR6145059	Corynebacterium pseudotuberculosis	1719	S	62	3	65	0.00001
SRR6145059	Brochothrix thermosphacta	2756	S	64	1	65	0.00001
SRR6145059	Bergeyella cardium	1585976	S	64	1	65	0.00001
SRR6145059	Acidiphilium multivorum	62140	S	22	43	65	0.00001
SRR6145059	Spirosoma pollinicola	2057025	S	60	4	64	0.00001
SRR6145059	Sphingomonas sp. LK11	1390395	S	560	64	624	0.00007
SRR6145059	Serpentinomonas raichei	1458425	S	59	5	64	0.00001
SRR6145059	Rhodococcus sp. BH4	1807790	S	15	64	79	0.00001
SRR6145059	Rhizobium jaguaris	1312183	S	62	2	64	0.00001
SRR6145059	Rathayibacter rathayi	33887	S	56	8	64	0.00001
SRR6145059	Natronococcus occultus	29288	S	63	1	64	0.00001
SRR6145059	Ketogulonicigenium robustum	92947	S	60	4	64	0.00001
SRR6145059	Hymenobacter swuensis	1446467	S	53	11	64	0.00001
SRR6145059	Hoyosella subflava	639313	S	64	0	64	0.00001
SRR6145059	Chromobacterium vaccinii	1108595	S	57	7	64	0.00001
SRR6145059	Actinoalloteichus fjordicus	1612552	S	5	59	64	0.00001
SRR6145059	Thermobifida fusca	2021	S	62	1	63	0.00001
SRR6145059	Streptomyces albidoflavus	1886	S	6	57	63	0.00001
SRR6145059	Staphylococcus virus IPLA7	1197953	S	6	63	69	0.00001
SRR6145059	Rhodococcus imtechensis	262776	S	35	28	63	0.00001
SRR6145059	Plantibacter flavus	150123	S	32	31	63	0.00001
SRR6145059	Plantactinospora sp. BB1	2071627	S	29	63	92	0.00001
SRR6145059	Phycisphaera mikurensis	547188	S	63	0	63	0.00001
SRR6145059	Mycobacterium sp. PYR15	2051552	S	26	63	89	0.00001
SRR6145059	Methylobacterium sp. AMS5	925818	S	119	63	182	0.00002
SRR6145059	Ketogulonicigenium vulgare	92945	S	59	4	63	0.00001
SRR6145059	Confluentimicrobium sp. EMB200-NS6	1609966	S	117	63	180	0.00002
SRR6145059	Bradyrhizobium sp. 1S5	1404402	S	30	63	93	0.00001
SRR6145059	Acinetobacter lactucae	1785128	S	54	9	63	0.00001
SRR6145059	Streptomyces sp. 2114.2	1881022	S	6	62	68	0.00001
SRR6145059	Streptomyces pratensis	1169025	S	10	52	62	0.00001
SRR6145059	Staphylococcus phage StB20-like	1732064	S	2	62	64	0.00001
SRR6145059	Segniliparus rotundus	286802	S	62	0	62	0.00001
SRR6145059	Pseudomonas pelagia	553151	S	62	0	62	0.00001
SRR6145059	Methylobacterium sp. 17Sr1-43	2202828	S	719	62	781	0.00009
SRR6145059	Egibacter rhizosphaerae	1670831	S	62	0	62	0.00001
SRR6145059	Clostridium tetani	1513	S	58	4	62	0.00001
SRR6145059	Chelatococcus sp. CO-6	1702325	S	146	62	208	0.00002
SRR6145059	Bacillus velezensis	492670	S	18	44	62	0.00001
SRR6145059	Vulgatibacter incomptus	1391653	S	61	0	61	0.00001
SRR6145059	Verrucomicrobium spinosum	2736	S	60	1	61	0.00001
SRR6145059	Tateyamaria omphalii	299262	S	61	0	61	0.00001
SRR6145059	Streptomyces koyangensis	188770	S	35	26	61	0.00001
SRR6145059	Rhodothermus marinus	29549	S	59	2	61	0.00001
SRR6145059	Methylocystis bryophila	655015	S	58	3	61	0.00001
SRR6145059	Mesorhizobium sp. M2A.F.Ca.ET.043.02.1.1	2493670	S	22	61	83	0.00001
SRR6145059	Kosakonia cowanii	208223	S	52	9	61	0.00001
SRR6145059	Hyphomicrobium nitrativorans	1427356	S	60	1	61	0.00001
SRR6145059	Dyella japonica	231455	S	56	5	61	0.00001
SRR6145059	Dickeya dadantii	204038	S	49	12	61	0.00001
SRR6145059	Deinococcus peraridilitoris	432329	S	61	0	61	0.00001
SRR6145059	Clostridioides difficile	1496	S	40	21	61	0.00001
SRR6145059	Variovorax sp. PBL-H6	434009	S	101	60	161	0.00002
SRR6145059	Roseivivax sp. THAF197b	2588299	S	5	60	65	0.00001
SRR6145059	Rhodococcus sp. DMU1	2722825	S	21	60	81	0.00001
SRR6145059	Rhizobium gallicum	56730	S	56	4	60	0.00001
SRR6145059	Propionibacterium virus Keiki	1982255	S	12	60	72	0.00001
SRR6145059	Pandoraea apista	93218	S	47	13	60	0.00001
SRR6145059	Nitrobacter hamburgensis	912	S	56	4	60	0.00001
SRR6145059	Luteibacter rhizovicinus	242606	S	56	4	60	0.00001
SRR6145059	Lacunisphaera limnophila	1838286	S	55	5	60	0.00001
SRR6145059	Halomonas socia	1081866	S	60	0	60	0.00001
SRR6145059	Cronobacter malonaticus	413503	S	43	17	60	0.00001
SRR6145059	Chryseobacterium piperi	558152	S	59	1	60	0.00001
SRR6145059	Bacillus paralicheniformis	1648923	S	58	2	60	0.00001
SRR6145059	Agrobacterium sp. MA01	2664893	S	35	60	95	0.00001
SRR6145059	Acidiphilium cryptum	524	S	19	41	60	0.00001
SRR6145059	Rouxiella badensis	1646377	S	58	1	59	0.00001
SRR6145059	Rhodanobacter glycinis	582702	S	54	5	59	0.00001
SRR6145059	Pseudarthrobacter chlorophenolicus	85085	S	51	8	59	0.00001
SRR6145059	Lactobacillus delbrueckii	1584	S	57	2	59	0.00001
SRR6145059	Azospirillum sp. TSA2s	709810	S	75	59	134	0.00002
SRR6145059	Actinotignum schaalii	59505	S	59	0	59	0.00001
SRR6145059	Acetobacter orientalis	146474	S	57	2	59	0.00001
SRR6145059	Vitreoscilla filiformis	63	S	58	0	58	0.00001
SRR6145059	Sphingobacterium thalpophilum	259	S	54	4	58	0.00001
SRR6145059	Rhodoferax antarcticus	81479	S	57	1	58	0.00001
SRR6145059	Pseudarthrobacter sulfonivorans	121292	S	36	22	58	0.00001
SRR6145059	Opitutus terrae	107709	S	57	1	58	0.00001
SRR6145059	Lactobacillus paracasei	1597	S	10	48	58	0.00001
SRR6145059	Haemophilus pittmaniae	249188	S	56	2	58	0.00001
SRR6145059	Crenobacter cavernae	2290923	S	57	1	58	0.00001
SRR6145059	Chryseobacterium sp. SNU WT5	2594269	S	58	4	62	0.00001
SRR6145059	Antarctobacter heliothermus	74033	S	57	1	58	0.00001
SRR6145059	Vibrio cholerae	666	S	21	36	57	0.00001
SRR6145059	Sphingosinithalassobacter sp. zrk23	2711215	S	209	57	266	0.00003
SRR6145059	Serratia liquefaciens	614	S	40	17	57	0.00001
SRR6145059	Salinispora tropica	168695	S	52	5	57	0.00001
SRR6145059	Rhizobium grahamii	1120045	S	54	3	57	0.00001
SRR6145059	Pseudomonas libanensis	75588	S	28	29	57	0.00001
SRR6145059	Pseudarthrobacter equi	728066	S	48	9	57	0.00001
SRR6145059	Planctomycetes bacterium Spa11	2528022	S	4	57	61	0.00001
SRR6145059	Listeria monocytogenes	1639	S	22	35	57	0.00001
SRR6145059	Klebsiella quasivariicola	2026240	S	6	51	57	0.00001
SRR6145059	Enterobacter chengduensis	2494701	S	46	11	57	0.00001
SRR6145059	Collinsella aerofaciens	74426	S	53	4	57	0.00001
SRR6145059	Citrobacter amalonaticus	35703	S	34	23	57	0.00001
SRR6145059	Calothrix sp. NIES-2098	1954171	S	15	57	72	0.00001
SRR6145059	Azospirillum sp. TSH58	664962	S	48	57	105	0.00001
SRR6145059	[Enterobacter] lignolyticus	1334193	S	53	3	56	0.00001
SRR6145059	Xanthomonas cucurbitae	56453	S	52	4	56	0.00001
SRR6145059	Sulfurifustis variabilis	1675686	S	56	0	56	0.00001
SRR6145059	Rickettsia bellii	33990	S	51	5	56	0.00001
SRR6145059	Pseudomonas antarctica	219572	S	49	7	56	0.00001
SRR6145059	Nibricoccus aquaticus	2576891	S	54	2	56	0.00001
SRR6145059	Glutamicibacter nicotianae	37929	S	20	36	56	0.00001
SRR6145059	Exiguobacterium sp. U13-1	1849031	S	29	56	85	0.00001
SRR6145059	Delftia sp. Cs1-4	742013	S	30	56	86	0.00001
SRR6145059	Chitinolyticbacter meiyuanensis	682798	S	56	0	56	0.00001
SRR6145059	Burkholderia sp. KBS0801	1179675	S	37	56	93	0.00001
SRR6145059	Bordetella trematum	123899	S	52	4	56	0.00001
SRR6145059	Streptomyces sp. SUK 48	2582831	S	55	19	74	0.00001
SRR6145059	Rickettsia felis	42862	S	51	4	55	0.00001
SRR6145059	Rhizobium sp. Khangiran2	1435607	S	56	55	111	0.00001
SRR6145059	Rathayibacter iranicus	59737	S	52	3	55	0.00001
SRR6145059	Paraflavitalea soli	2315862	S	53	2	55	0.00001
SRR6145059	Oryzomicrobium terrae	1735038	S	55	0	55	0.00001
SRR6145059	Ornithinimicrobium sp. HY006	2508882	S	300	55	355	0.00004
SRR6145059	Granulibacter bethesdensis	364410	S	55	0	55	0.00001
SRR6145059	Corynebacterium kutscheri	35755	S	54	1	55	0.00001
SRR6145059	Burkholderia sp. JP2-270	2217913	S	214	55	269	0.00003
SRR6145059	Bifidobacterium bifidum	1681	S	52	3	55	0.00001
SRR6145059	Roseovarius mucosus	215743	S	20	34	54	0.00001
SRR6145059	Plantactinospora sp. BC1	2108470	S	25	54	79	0.00001
SRR6145059	Pandoraea pulmonicola	93221	S	49	5	54	0.00001
SRR6145059	Mycobacterium sp. YC-RL4	1682113	S	373	54	427	0.00005
SRR6145059	Mucilaginibacter rubeus	2027860	S	24	30	54	0.00001
SRR6145059	Enterobacteriaceae bacterium A-F18	2045202	S	11	54	65	0.00001
SRR6145059	Xanthomonas cassavae	56450	S	46	7	53	0.00001
SRR6145059	Streptococcus periodonticum	2490633	S	25	28	53	0.00001
SRR6145059	Salinicola tamaricis	1771309	S	53	0	53	0.00001
SRR6145059	Rhodomicrobium vannielii	1069	S	52	1	53	0.00001
SRR6145059	Psychrobacter alimentarius	261164	S	2	51	53	0.00001
SRR6145059	Phytobacter diazotrophicus	395631	S	8	45	53	0.00001
SRR6145059	Pararhodospirillum photometricum	1084	S	51	2	53	0.00001
SRR6145059	Methylocella tundrae	227605	S	51	2	53	0.00001
SRR6145059	Glutamicibacter sp. ZJUTW	1155384	S	29	53	82	0.00001
SRR6145059	Chromobacterium sp. ATCC 53434	2059672	S	53	4	57	0.00001
SRR6145059	Brevibacterium sp. o2	2697565	S	187	53	240	0.00003
SRR6145059	Bradyrhizobium sp. WSM471	319017	S	28	53	81	0.00001
SRR6145059	Sulfuritortus calidifontis	1914471	S	47	5	52	0.00001
SRR6145059	Stenotrophomonas sp. DAIF1	2546450	S	14	52	66	0.00001
SRR6145059	Salinibacter ruber	146919	S	52	0	52	0.00001
SRR6145059	Rathayibacter tritici	33888	S	44	8	52	0.00001
SRR6145059	Pseudomonas yamanorum	515393	S	45	7	52	0.00001
SRR6145059	Pigmentiphaga aceris	1940612	S	52	0	52	0.00001
SRR6145059	Pectobacterium carotovorum	554	S	37	15	52	0.00001
SRR6145059	Marichromatium purpuratum	37487	S	50	2	52	0.00001
SRR6145059	Herbaspirillum hiltneri	341045	S	50	2	52	0.00001
SRR6145059	Halomonas chromatireducens	507626	S	52	0	52	0.00001
SRR6145059	Glutamicibacter mishrai	1775880	S	49	3	52	0.00001
SRR6145059	Delftia sp. HK171	1920191	S	25	52	77	0.00001
SRR6145059	Capnocytophaga ochracea	1018	S	33	19	52	0.00001
SRR6145059	Aggregatibacter actinomycetemcomitans	714	S	49	3	52	0.00001
SRR6145059	Xanthomonas axonopodis	53413	S	35	16	51	0.00001
SRR6145059	Thiohalobacter thiocyanaticus	585455	S	50	1	51	0.00001
SRR6145059	Sphaerobacter thermophilus	2057	S	51	0	51	0.00001
SRR6145059	Phaeobacter piscinae	1580596	S	31	20	51	0.00001
SRR6145059	Panacibacter ginsenosidivorans	1813871	S	50	1	51	0.00001
SRR6145059	Nocardioides sp. R-3366	2712223	S	424	51	475	0.00006
SRR6145059	Leuconostoc citreum	33964	S	47	4	51	0.00001
SRR6145059	Hyphomonas neptunium	81032	S	46	5	51	0.00001
SRR6145059	Flavobacterium anhuiense	459526	S	42	9	51	0.00001
SRR6145059	Citrobacter werkmanii	67827	S	32	19	51	0.00001
SRR6145059	Citrobacter portucalensis	1639133	S	25	26	51	0.00001
SRR6145059	Caulobacter sp. Ji-3-8	2708539	S	173	51	224	0.00003
SRR6145059	Brachybacterium sp. P6-10-X1	1903186	S	631	51	682	0.00008
SRR6145059	Anoxybacillus flavithermus	33934	S	47	4	51	0.00001
SRR6145059	Thermomonas sp. HDW16	2714945	S	338	50	388	0.00005
SRR6145059	Serratia plymuthica	82996	S	44	6	50	0.00001
SRR6145059	Rhodobacter sp. CZR27	2033869	S	276	50	326	0.00004
SRR6145059	Pseudohalocynthiibacter aestuariivivens	1591409	S	43	7	50	0.00001
SRR6145059	Paracoccus sp. 2251	2560053	S	645	50	695	0.00008
SRR6145059	Nocardioides sp. dk3136	2575373	S	205	50	255	0.00003
SRR6145059	Microcoleus sp. PCC 7113	1173027	S	50	1	51	0.00001
SRR6145059	Microbacterium endophyticum	1526412	S	50	0	50	0.00001
SRR6145059	Hymenobacter sp. PAMC 26554	1484116	S	50	1	51	0.00001
SRR6145059	Hydrogenophaga crassostreae	1763535	S	50	0	50	0.00001
SRR6145059	Glutamicibacter arilaitensis	256701	S	46	4	50	0.00001
SRR6145059	Flavobacterium johnsoniae	986	S	44	6	50	0.00001
SRR6145059	Clostridium perfringens	1502	S	49	1	50	0.00001
SRR6145059	Bordetella pseudohinzii	1331258	S	45	5	50	0.00001
SRR6145059	Actinoalloteichus sp. GBA129-24	1612551	S	5	50	55	0.00001
SRR6145059	Streptomyces sp. S1D4-14	2594461	S	1	49	50	0.00001
SRR6145059	Streptococcus phage phiARI0462	1701826	S	1	49	50	0.00001
SRR6145059	Rhodococcus sp. PBTS 2	1653479	S	49	21	70	0.00001
SRR6145059	Paracoccus sp. SC2-6	2259340	S	459	49	508	0.00006
SRR6145059	Paraburkholderia rhizoxinica	412963	S	49	0	49	0.00001
SRR6145059	Microbacterium sp. Y-01	2048898	S	385	49	434	0.00005
SRR6145059	Methyloceanibacter caenitepidi	1384459	S	43	6	49	0.00001
SRR6145059	Mesorhizobium sp. NZP2234	2483402	S	7	49	56	0.00001
SRR6145059	Celeribacter baekdonensis	875171	S	38	11	49	0.00001
SRR6145059	Arthrobacter sp. PAMC 25486	1494608	S	49	1	50	0.00001
SRR6145059	Alkalilimnicola ehrlichii	351052	S	48	1	49	0.00001
SRR6145059	Acidihalobacter prosperus	160660	S	49	0	49	0.00001
SRR6145059	Roseovarius sp. THAF8	2587846	S	31	48	79	0.00001
SRR6145059	Pseudomonas rhizosphaerae	216142	S	47	1	48	0.00001
SRR6145059	Pseudarthrobacter sp. NIBRBAC000502771	2590774	S	27	48	75	0.00001
SRR6145059	Nocardioides sp. JS614	196162	S	446	48	494	0.00006
SRR6145059	Mycobacterium marinum	1781	S	45	3	48	0.00001
SRR6145059	Mogibacterium pumilum	86332	S	47	1	48	0.00001
SRR6145059	Mitsuaria sp. 7	1658665	S	540	48	588	0.00007
SRR6145059	Megamonas funiformis	437897	S	48	0	48	0.00001
SRR6145059	Leuconostoc mesenteroides	1245	S	39	9	48	0.00001
SRR6145059	Kosakonia radicincitans	283686	S	13	35	48	0.00001
SRR6145059	Hymenobacter oligotrophus	2319843	S	46	2	48	0.00001
SRR6145059	Hydrogenophaga sp. PBC	795665	S	225	48	273	0.00003
SRR6145059	Glycocaulis alkaliphilus	1434191	S	48	0	48	0.00001
SRR6145059	Fusobacterium periodonticum	860	S	24	24	48	0.00001
SRR6145059	Epibacterium mobile	379347	S	38	10	48	0.00001
SRR6145059	Cupriavidus sp. USMAA2-4	876364	S	26	48	74	0.00001
SRR6145059	Aromatoleum aromaticum	551760	S	48	0	48	0.00001
SRR6145059	Streptomyces sp. 604F	1476754	S	12	47	59	0.00001
SRR6145059	Streptococcus equi	1336	S	46	1	47	0.00001
SRR6145059	Salinicoccus halodurans	407035	S	47	0	47	0.00001
SRR6145059	Rhodocyclaceae bacterium	1898103	S	11	36	47	0.00001
SRR6145059	Labrenzia sp. THAF35	2587854	S	10	47	57	0.00001
SRR6145059	Kosakonia sacchari	1158459	S	40	7	47	0.00001
SRR6145059	Halomonas sp. PGE1	2730360	S	78	47	125	0.00001
SRR6145059	Gimesia maris	122	S	2	45	47	0.00001
SRR6145059	Corynebacterium mustelae	571915	S	47	0	47	0.00001
SRR6145059	Citrobacter sp. TBCP-5362	2576406	S	1	47	48	0.00001
SRR6145059	Chitinophaga pinensis	79329	S	44	3	47	0.00001
SRR6145059	Azoarcus olearius	418699	S	13	34	47	0.00001
SRR6145059	Sulfuritalea hydrogenivorans	748811	S	46	0	46	0.00001
SRR6145059	Streptomyces sp. WAC 06738	2203210	S	46	17	63	0.00001
SRR6145059	Shewanella bicestrii	2018305	S	24	22	46	0.00001
SRR6145059	Roseovarius sp. THAF27	2587850	S	27	46	73	0.00001
SRR6145059	Rhodococcus sp. WB1	1033922	S	8	46	54	0.00001
SRR6145059	Pseudonocardia sp. AL041005-10	445576	S	335	46	381	0.00005
SRR6145059	Pseudomonas veronii	76761	S	23	23	46	0.00001
SRR6145059	Pseudomonas sp. ATCC 13867	1294143	S	46	4	50	0.00001
SRR6145059	Pantoea stewartii	66269	S	44	2	46	0.00001
SRR6145059	Jeotgalicoccus saudimassiliensis	1461582	S	46	0	46	0.00001
SRR6145059	Hymenobacter sp. PAMC 26628	1484118	S	46	11	57	0.00001
SRR6145059	Hymenobacter sedentarius	1411621	S	44	2	46	0.00001
SRR6145059	Halomonas aestuarii	1897729	S	46	0	46	0.00001
SRR6145059	Duganella sp. GN2-R2	2728020	S	327	46	373	0.00004
SRR6145059	Desulfovibrio carbinoliphilus	345370	S	46	0	46	0.00001
SRR6145059	Corynebacterium choanis	1862358	S	46	0	46	0.00001
SRR6145059	Steroidobacter denitrificans	465721	S	43	2	45	0.00001
SRR6145059	Rathayibacter sp. VKM Ac-2801	2609255	S	45	23	68	0.00001
SRR6145059	Marinobacter hydrocarbonoclasticus	2743	S	42	3	45	0.00001
SRR6145059	Flavobacterium indicum	312277	S	45	0	45	0.00001
SRR6145059	Cronobacter dublinensis	413497	S	40	5	45	0.00001
SRR6145059	Chryseobacterium antarcticum	266748	S	45	0	45	0.00001
SRR6145059	Chania multitudinisentens	1639108	S	45	0	45	0.00001
SRR6145059	Cellvibrio japonicus	155077	S	43	2	45	0.00001
SRR6145059	Bifidobacterium pseudolongum	1694	S	44	1	45	0.00001
SRR6145059	Anabaena sp. YBS01	2490939	S	3	45	48	0.00001
SRR6145059	Acinetobacter oleivorans	1148157	S	41	4	45	0.00001
SRR6145059	Xanthomonas gardneri	90270	S	10	34	44	0.00001
SRR6145059	Pseudomonas tolaasii	29442	S	36	8	44	0.00001
SRR6145059	Peptacetobacter hiranonis	89152	S	43	1	44	0.00001
SRR6145059	Nitrobacter winogradskyi	913	S	41	3	44	0.00001
SRR6145059	Maricaulis maris	74318	S	44	0	44	0.00001
SRR6145059	Halopiger xanaduensis	387343	S	42	2	44	0.00001
SRR6145059	Halobacterium hubeiense	1407499	S	39	5	44	0.00001
SRR6145059	Citromicrobium sp. JL477	1634516	S	162	44	206	0.00002
SRR6145059	Burkholderia diffusa	488732	S	40	4	44	0.00001
SRR6145059	Bradyrhizobium sp. SK17	2057741	S	198	44	242	0.00003
SRR6145059	Azospirillum sp. M2T2B2	682998	S	93	44	137	0.00002
SRR6145059	Xanthomonas vasicola	56459	S	38	5	43	0.00001
SRR6145059	Wenzhouxiangella marina	1579979	S	43	0	43	0.00001
SRR6145059	Thalassobius gelatinovorus	53501	S	42	1	43	0.00001
SRR6145059	Sulfitobacter sp. THAF37	2587855	S	93	43	136	0.00002
SRR6145059	Streptomyces sp. SS52	2563602	S	17	43	60	0.00001
SRR6145059	Streptococcus sp. A12	1759399	S	182	43	225	0.00003
SRR6145059	Stenotrophomonas sp. G4	2303750	S	40	43	83	0.00001
SRR6145059	Staphylococcus phage StB27	1147044	S	14	43	57	0.00001
SRR6145059	Solibacillus silvestris	76853	S	41	2	43	0.00001
SRR6145059	Rubrobacter radiotolerans	42256	S	41	2	43	0.00001
SRR6145059	Rhodobaca barguzinensis	441209	S	43	0	43	0.00001
SRR6145059	Pseudomonas sp. SWI7	2587597	S	8	43	51	0.00001
SRR6145059	Pseudomonas sp. SNU WT1	2518644	S	43	2	45	0.00001
SRR6145059	Halomonas subglaciescola	29571	S	43	0	43	0.00001
SRR6145059	Halomonas sp. HL-93	1666906	S	10	43	53	0.00001
SRR6145059	Enterobacter soli	885040	S	41	2	43	0.00001
SRR6145059	Altererythrobacter ishigakiensis	476157	S	42	1	43	0.00001
SRR6145059	Zymobacter palmae	33074	S	42	0	42	0.00000
SRR6145059	Xanthomonas fragariae	48664	S	40	2	42	0.00000
SRR6145059	Thioflavicoccus mobilis	80679	S	42	0	42	0.00000
SRR6145059	Salicibibacter halophilus	2502791	S	42	0	42	0.00000
SRR6145059	Pseudomonas trivialis	200450	S	35	7	42	0.00000
SRR6145059	Pseudomonas sp. bs2935	1761895	S	1	42	43	0.00001
SRR6145059	Pseudomonas sp. PONIH3	1636610	S	19	42	61	0.00001
SRR6145059	Pseudomonas lurida	244566	S	37	5	42	0.00000
SRR6145059	Pseudomonas cremoricolorata	157783	S	41	1	42	0.00000
SRR6145059	Pseudomonas asturiensis	1190415	S	41	1	42	0.00000
SRR6145059	Neisseria chenwenguii	1853278	S	42	0	42	0.00000
SRR6145059	Meiothermus silvanus	52022	S	42	0	42	0.00000
SRR6145059	Lonsdalea britannica	1082704	S	41	1	42	0.00000
SRR6145059	Lactobacillus fermentum	1613	S	39	3	42	0.00000
SRR6145059	Halotalea alkalilenta	376489	S	41	1	42	0.00000
SRR6145059	Casimicrobium huifangae	2591109	S	40	2	42	0.00000
SRR6145059	Thiobacillus denitrificans	36861	S	40	1	41	0.00000
SRR6145059	Streptococcus sp. HSISS3	1316412	S	33	41	74	0.00001
SRR6145059	Staphylococcus schleiferi	1295	S	36	5	41	0.00000
SRR6145059	Serratia sp. SSNIH1	1758196	S	7	41	48	0.00001
SRR6145059	Lactobacillus casei	1582	S	11	30	41	0.00000
SRR6145059	Halomonas sp. A3H3	1346287	S	9	41	50	0.00001
SRR6145059	Flavobacterium haoranii	683124	S	37	4	41	0.00000
SRR6145059	Exiguobacterium sp. ZWU0009	1224749	S	23	41	64	0.00001
SRR6145059	Enterococcus faecium	1352	S	31	10	41	0.00000
SRR6145059	Dickeya zeae	204042	S	38	3	41	0.00000
SRR6145059	Cytophaga hutchinsonii	985	S	41	0	41	0.00000
SRR6145059	Calothrix sp. NIES-2100	1954172	S	11	41	52	0.00001
SRR6145059	Aminobacter sp. MSH1	374606	S	134	41	175	0.00002
SRR6145059	Alteromonas macleodii	28108	S	39	2	41	0.00000
SRR6145059	Acidovorax sp. RAC01	1842533	S	185	41	226	0.00003
SRR6145059	Acidothermus cellulolyticus	28049	S	41	0	41	0.00000
SRR6145059	Variovorax sp. PMC12	2126319	S	186	40	226	0.00003
SRR6145059	Thioalkalivibrio sulfidiphilus	1033854	S	36	4	40	0.00000
SRR6145059	Thalassospira indica	1891279	S	37	3	40	0.00000
SRR6145059	Streptomyces sp. WAC6273	2588707	S	17	40	57	0.00001
SRR6145059	Streptomyces sp. M56	1495638	S	12	40	52	0.00001
SRR6145059	Sphingopyxis sp. QXT-31	1357916	S	328	40	368	0.00004
SRR6145059	Singulisphaera acidiphila	466153	S	39	1	40	0.00000
SRR6145059	Pseudomonas kribbensis	1628086	S	35	5	40	0.00000
SRR6145059	Phytobacter sp. SCO41	1756993	S	7	40	47	0.00001
SRR6145059	Phycicoccus sp. HDW14	2714941	S	580	40	620	0.00007
SRR6145059	Paraburkholderia sp. CCGE1002	640511	S	818	40	858	0.00010
SRR6145059	Ochrobactrum quorumnocens	271865	S	38	2	40	0.00000
SRR6145059	Oceanithermus profundus	187137	S	40	0	40	0.00000
SRR6145059	Nitrospira moscoviensis	42253	S	40	0	40	0.00000
SRR6145059	Laribacter hongkongensis	168471	S	37	3	40	0.00000
SRR6145059	Hoeflea phototrophica	244596	S	38	2	40	0.00000
SRR6145059	Halorubrum lacusprofundi	2247	S	23	17	40	0.00000
SRR6145059	Halobiforma lacisalsi	229731	S	37	3	40	0.00000
SRR6145059	Gordonia sp. 1D	1737359	S	453	40	493	0.00006
SRR6145059	Clostridium beijerinckii	1520	S	26	14	40	0.00000
SRR6145059	Brevundimonas sp. M20	2591463	S	896	40	936	0.00011
SRR6145059	Bifidobacterium catenulatum	1686	S	31	9	40	0.00000
SRR6145059	Allochromatium vinosum	1049	S	38	2	40	0.00000
SRR6145059	Acinetobacter larvae	1789224	S	40	0	40	0.00000
SRR6145059	[Ruminococcus] gnavus	33038	S	33	6	39	0.00000
SRR6145059	Tepidiforma bonchosmolovskayae	2601677	S	39	0	39	0.00000
SRR6145059	Streptomyces platensis	58346	S	24	15	39	0.00000
SRR6145059	Staphylococcus vitulinus	71237	S	38	1	39	0.00000
SRR6145059	Rhodococcus sp. H-CA8f	1727214	S	10	39	49	0.00001
SRR6145059	Pseudomonas xinjiangensis	487184	S	39	0	39	0.00000
SRR6145059	Pantoea rwandensis	1076550	S	37	2	39	0.00000
SRR6145059	Mycobacterium haemophilum	29311	S	39	0	39	0.00000
SRR6145059	Hydrogenophaga sp. PBL-H3	434010	S	117	39	156	0.00002
SRR6145059	Gibbsiella quercinecans	929813	S	39	0	39	0.00000
SRR6145059	Desulfovibrio vulgaris	881	S	39	0	39	0.00000
SRR6145059	Citrobacter braakii	57706	S	15	24	39	0.00000
SRR6145059	Brevundimonas sp. MF30-B	2561924	S	868	39	907	0.00011
SRR6145059	Bacteroides uniformis	820	S	24	15	39	0.00000
SRR6145059	Bacteroides dorei	357276	S	25	14	39	0.00000
SRR6145059	Alistipes communis	2585118	S	36	3	39	0.00000
SRR6145059	Agrobacterium sp. T29	2580515	S	73	39	112	0.00001
SRR6145059	Acinetobacter equi	1324350	S	39	0	39	0.00000
SRR6145059	Vibrio furnissii	29494	S	36	2	38	0.00000
SRR6145059	Pseudomonas marincola	437900	S	37	1	38	0.00000
SRR6145059	Pseudobacter ginsenosidimutans	661488	S	36	2	38	0.00000
SRR6145059	Polynucleobacter necessarius	576610	S	37	1	38	0.00000
SRR6145059	Microvirgula aerodenitrificans	57480	S	38	0	38	0.00000
SRR6145059	Mesorhizobium sp. M1E.F.Ca.ET.045.02.1.1	2493672	S	88	38	126	0.00001
SRR6145059	Mesorhizobium sp. M1D.F.Ca.ET.043.01.1.1	2493669	S	67	38	105	0.00001
SRR6145059	Macrococcus canis	1855823	S	37	1	38	0.00000
SRR6145059	Komagataeibacter saccharivorans	265959	S	33	5	38	0.00000
SRR6145059	Intestinimonas butyriciproducens	1297617	S	3	35	38	0.00000
SRR6145059	Helicobacter pylori	210	S	37	1	38	0.00000
SRR6145059	Halomonas campaniensis	213554	S	23	15	38	0.00000
SRR6145059	Desulfarculus baarsii	453230	S	34	4	38	0.00000
SRR6145059	Caulobacter sp. K31	366602	S	196	38	234	0.00003
SRR6145059	Brenneria goodwinii	1109412	S	31	7	38	0.00000
SRR6145059	Anaeromyxobacter sp. K	447217	S	40	38	78	0.00001
SRR6145059	Alteromonas mediterranea	314275	S	11	27	38	0.00000
SRR6145059	Altererythrobacter sp. B11	2060312	S	148	38	186	0.00002
SRR6145059	Alcanivorax xenomutans	1094342	S	34	4	38	0.00000
SRR6145059	Alcanivorax dieselolei	285091	S	35	3	38	0.00000
SRR6145059	Zobellella denitrificans	347534	S	37	0	37	0.00000
SRR6145059	Thiocystis violascens	73141	S	37	0	37	0.00000
SRR6145059	Streptomyces sp. GF20	2692235	S	6	37	43	0.00001
SRR6145059	Streptococcus sp. HSISS2	1316411	S	28	37	65	0.00001
SRR6145059	Serratia rubidaea	61652	S	28	9	37	0.00000
SRR6145059	Pseudomonas sp. BIOMIG1BAC	1758730	S	18	37	55	0.00001
SRR6145059	Pseudomonas simiae	321846	S	33	4	37	0.00000
SRR6145059	Pseudolysobacter antarcticus	2511995	S	37	0	37	0.00000
SRR6145059	Plantibacter sp. PA-3-X8	2480625	S	39	37	76	0.00001
SRR6145059	Nocardioides sp. HDW12B	2714939	S	347	37	384	0.00005
SRR6145059	Nocardia sp. CFHS0054	2382165	S	168	37	205	0.00002
SRR6145059	Niastella koreensis	354356	S	35	2	37	0.00000
SRR6145059	Kozakia baliensis	153496	S	32	5	37	0.00000
SRR6145059	Kerstersia gyiorum	206506	S	36	1	37	0.00000
SRR6145059	Halorhodospira halophila	1053	S	37	0	37	0.00000
SRR6145059	Haloplanus rallus	1816183	S	32	5	37	0.00000
SRR6145059	Gammapapillomavirus sp.	2049444	S	37	0	37	0.00000
SRR6145059	Enterobacter ludwigii	299767	S	14	23	37	0.00000
SRR6145059	Chromobacterium rhizoryzae	1778675	S	9	28	37	0.00000
SRR6145059	Carnobacterium divergens	2748	S	35	2	37	0.00000
SRR6145059	Azoarcus sp. BH72	62928	S	14	37	51	0.00001
SRR6145059	Agrobacterium sp. RAC06	1842536	S	21	37	58	0.00001
SRR6145059	Weissella paramesenteroides	1249	S	34	2	36	0.00000
SRR6145059	Sulfurivermis fontis	1972068	S	33	3	36	0.00000
SRR6145059	Pseudomonas sp. JY-Q	1338689	S	7	36	43	0.00001
SRR6145059	Pseudomonas mandelii	75612	S	16	20	36	0.00000
SRR6145059	Propionibacterium virus PHL152M00	1982295	S	121	36	157	0.00002
SRR6145059	Phyllobacterium zundukense	1867719	S	34	2	36	0.00000
SRR6145059	Olsenella uli	133926	S	35	1	36	0.00000
SRR6145059	Nocardia sp. CS682	1047172	S	199	36	235	0.00003
SRR6145059	Natrinema versiforme	88724	S	32	4	36	0.00000
SRR6145059	Methylococcus capsulatus	414	S	34	2	36	0.00000
SRR6145059	Labrenzia aggregata	187304	S	9	27	36	0.00000
SRR6145059	Desulfovibrio desulfuricans	876	S	33	3	36	0.00000
SRR6145059	Bifidobacterium scardovii	158787	S	36	0	36	0.00000
SRR6145059	Azospirillum sp. TSH100	652764	S	98	36	134	0.00002
SRR6145059	Acetobacter pasteurianus	438	S	19	17	36	0.00000
SRR6145059	Zymomonas mobilis	542	S	27	8	35	0.00000
SRR6145059	Streptomyces sp. S501	2420135	S	5	35	40	0.00000
SRR6145059	Sphingomonas sp. AAP5	1523415	S	424	35	459	0.00005
SRR6145059	Shewanella baltica	62322	S	24	11	35	0.00000
SRR6145059	Roseobacter denitrificans	2434	S	25	10	35	0.00000
SRR6145059	Psychromicrobium lacuslunae	1618207	S	35	0	35	0.00000
SRR6145059	Pseudopedobacter saltans	151895	S	34	1	35	0.00000
SRR6145059	Pseudonocardia sp. HH130629-09	1641402	S	179	35	214	0.00003
SRR6145059	Pseudomonas vancouverensis	95300	S	33	2	35	0.00000
SRR6145059	Pseudomonas sp. FDAARGOS_761	2545800	S	2	35	37	0.00000
SRR6145059	Plantibacter sp. M259	2583822	S	37	35	72	0.00001
SRR6145059	Phaeobacter porticola	1844006	S	28	7	35	0.00000
SRR6145059	Parolsenella catena	2003188	S	18	17	35	0.00000
SRR6145059	Mesorhizobium sp. M2A.F.Ca.ET.043.05.1.1	2493671	S	49	35	84	0.00001
SRR6145059	Meiothermus ruber	277	S	35	0	35	0.00000
SRR6145059	Macaca mulatta papillomavirus 5	2364645	S	35	0	35	0.00000
SRR6145059	Leptolyngbya boryana	1184	S	34	1	35	0.00000
SRR6145059	Kluyvera intermedia	61648	S	31	4	35	0.00000
SRR6145059	Hyphomonas sp. CACIAM 19H1	1873716	S	35	4	39	0.00000
SRR6145059	Hydrogenophaga sp. BA0156	2716225	S	196	35	231	0.00003
SRR6145059	Guyparkeria halophila	47960	S	34	1	35	0.00000
SRR6145059	Gluconobacter albidus	318683	S	34	1	35	0.00000
SRR6145059	Desulfobulbus oralis	1986146	S	34	1	35	0.00000
SRR6145059	Dechloromonas aromatica	259537	S	34	1	35	0.00000
SRR6145059	Campylobacter jejuni	197	S	17	18	35	0.00000
SRR6145059	Bifidobacterium dentium	1689	S	35	0	35	0.00000
SRR6145059	Bacillus cohnii	33932	S	35	0	35	0.00000
SRR6145059	Thermaerobacter marianensis	73919	S	33	1	34	0.00000
SRR6145059	Streptomyces sp. 769	1262452	S	61	34	95	0.00001
SRR6145059	Sphingobium sp. SYK-6	627192	S	189	34	223	0.00003
SRR6145059	Salinigranum rubrum	755307	S	34	0	34	0.00000
SRR6145059	Roseobacter ponti	1891787	S	34	0	34	0.00000
SRR6145059	Rhodovulum sp. MB263	308754	S	131	34	165	0.00002
SRR6145059	Pseudomonas sp. LTJR-52	2479392	S	120	34	154	0.00002
SRR6145059	Pseudomonas mosselii	78327	S	17	17	34	0.00000
SRR6145059	Pseudomonas graminis	158627	S	34	0	34	0.00000
SRR6145059	Pseudomonas cedrina	651740	S	29	5	34	0.00000
SRR6145059	Natrialbaceae archaeon XQ-INN 246	2419781	S	34	0	34	0.00000
SRR6145059	Murdochiella vaginalis	1852373	S	31	3	34	0.00000
SRR6145059	Microbacterium sp. 10M-3C3	2483401	S	284	34	318	0.00004
SRR6145059	Libanicoccus massiliensis	1871022	S	20	14	34	0.00000
SRR6145059	Halobellus limi	699433	S	30	4	34	0.00000
SRR6145059	Fluviibacterium aquatile	2552766	S	31	3	34	0.00000
SRR6145059	Flavobacterium crocinum	2183896	S	30	4	34	0.00000
SRR6145059	Fibrella aestuarina	651143	S	33	1	34	0.00000
SRR6145059	Fastidiosipila sanguinis	236753	S	32	2	34	0.00000
SRR6145059	Elizabethkingia ursingii	1756150	S	30	4	34	0.00000
SRR6145059	Arabia massiliensis	1870985	S	34	0	34	0.00000
SRR6145059	Ahniella affigens	2021234	S	34	0	34	0.00000
SRR6145059	Achromobacter ruhlandii	72557	S	1	33	34	0.00000
SRR6145059	Sulfuricaulis limicola	1620215	S	33	0	33	0.00000
SRR6145059	Stenotrophomonas sp. WZN-1	2005046	S	36	33	69	0.00001
SRR6145059	Staphylococcus phage StB20	1147043	S	8	33	41	0.00000
SRR6145059	Staphylococcus carnosus	1281	S	30	3	33	0.00000
SRR6145059	Spirosoma aerolatum	1211326	S	32	1	33	0.00000
SRR6145059	Pseudomonas cichorii	36746	S	33	0	33	0.00000
SRR6145059	Propionibacterium virus P1001	1982263	S	22	33	55	0.00001
SRR6145059	Nocardioides sp. 78	2045452	S	243	33	276	0.00003
SRR6145059	Mycobacterium canettii	78331	S	32	1	33	0.00000
SRR6145059	Micromonospora sp. B006	2201999	S	86	33	119	0.00001
SRR6145059	Methylorubrum zatmanii	29429	S	5	28	33	0.00000
SRR6145059	Lactobacillus salivarius	1624	S	32	1	33	0.00000
SRR6145059	Lactobacillus jensenii	109790	S	32	1	33	0.00000
SRR6145059	Haloferax volcanii	2246	S	15	18	33	0.00000
SRR6145059	Geobacter sulfurreducens	35554	S	23	10	33	0.00000
SRR6145059	Erwinia gerundensis	1619313	S	32	1	33	0.00000
SRR6145059	Devriesea agamarum	472569	S	33	0	33	0.00000
SRR6145059	Curtobacterium sp. MR_MD2014	1561023	S	113	33	146	0.00002
SRR6145059	Cobetia marina	28258	S	2	31	33	0.00000
SRR6145059	Citrobacter sp. 86	2013114	S	1	33	34	0.00000
SRR6145059	Bifidobacterium choerinum	35760	S	32	1	33	0.00000
SRR6145059	Alistipes shahii	328814	S	27	6	33	0.00000
SRR6145059	Achromobacter sp. AONIH1	1758194	S	106	33	139	0.00002
SRR6145059	Treponema putidum	221027	S	30	2	32	0.00000
SRR6145059	Shewanella sp. FDAARGOS_354	1930557	S	127	32	159	0.00002
SRR6145059	Salinibacterium sp. CGMCC 1.16371	2079791	S	32	1	33	0.00000
SRR6145059	Rhodococcus sp. S2-17	1990687	S	84	32	116	0.00001
SRR6145059	Propionibacterium virus Stormborn	1982307	S	41	32	73	0.00001
SRR6145059	Propionibacterium virus P104A	1982268	S	32	32	64	0.00001
SRR6145059	Pantoea eucalypti	470933	S	8	24	32	0.00000
SRR6145059	Neoasaia chiangmaiensis	320497	S	30	2	32	0.00000
SRR6145059	Morganella morganii	582	S	29	3	32	0.00000
SRR6145059	Limnochorda pilosa	1555112	S	32	0	32	0.00000
SRR6145059	Leisingera sp. NJS204	2508307	S	16	32	48	0.00001
SRR6145059	Halorubrum trapanicum	29284	S	24	8	32	0.00000
SRR6145059	Halorubrum ezzemoulense	337243	S	28	4	32	0.00000
SRR6145059	Halalkalicoccus jeotgali	413810	S	32	0	32	0.00000
SRR6145059	Gallionella capsiferriformans	370405	S	32	0	32	0.00000
SRR6145059	Enterobacter cancerogenus	69218	S	30	2	32	0.00000
SRR6145059	Eikenella exigua	2528037	S	28	4	32	0.00000
SRR6145059	Desulfovibrio fairfieldensis	44742	S	32	0	32	0.00000
SRR6145059	Desulfovibrio carbinolicus	296842	S	27	5	32	0.00000
SRR6145059	Bradyrhizobium sp. 58S1	1404864	S	19	32	51	0.00001
SRR6145059	Bifidobacterium gallinarum	78344	S	31	1	32	0.00000
SRR6145059	Alcanivorax pacificus	1306787	S	31	1	32	0.00000
SRR6145059	Acidimicrobium ferrooxidans	53635	S	32	0	32	0.00000
SRR6145059	Thioalkalivibrio nitratireducens	186931	S	26	5	31	0.00000
SRR6145059	Stenotrophomonas sp. ZAC14D2_NAIMI4_6	2072406	S	25	31	56	0.00001
SRR6145059	Spirosoma sp. KCTC 42546	2520506	S	31	2	33	0.00000
SRR6145059	Serratia fonticola	47917	S	28	3	31	0.00000
SRR6145059	Serinicoccus sp. W204	2593973	S	232	31	263	0.00003
SRR6145059	Roseivivax sp. THAF40	2587858	S	2	31	33	0.00000
SRR6145059	Ralstonia pseudosolanacearum	1310165	S	8	23	31	0.00000
SRR6145059	Pseudonocardia sp. HH130630-07	1690815	S	223	31	254	0.00003
SRR6145059	Pseudomonas umsongensis	198618	S	30	1	31	0.00000
SRR6145059	Pseudomonas pohangensis	364197	S	31	0	31	0.00000
SRR6145059	Pseudomonas palleroniana	191390	S	29	2	31	0.00000
SRR6145059	Pseudomonas frederiksbergensis	104087	S	26	5	31	0.00000
SRR6145059	Pistricoccus aurantiacus	1883414	S	31	0	31	0.00000
SRR6145059	Peptoniphilus ivorii	54006	S	31	0	31	0.00000
SRR6145059	Pectobacterium brasiliense	180957	S	17	14	31	0.00000
SRR6145059	Paraburkholderia sp. 7Q-K02	2571747	S	492	31	523	0.00006
SRR6145059	Neisseria brasiliensis	2666100	S	28	3	31	0.00000
SRR6145059	Natrinema pellirubrum	69525	S	25	6	31	0.00000
SRR6145059	Myroides phaeus	702745	S	30	1	31	0.00000
SRR6145059	Methylomicrobium album	39775	S	31	0	31	0.00000
SRR6145059	Halomonas huangheensis	1178482	S	31	0	31	0.00000
SRR6145059	Exiguobacterium sp. MH3	1399115	S	89	31	120	0.00001
SRR6145059	Capnocytophaga sp. FDAARGOS_737	2545799	S	129	31	160	0.00002
SRR6145059	Bradyrhizobium sp. S23321	335659	S	18	31	49	0.00001
SRR6145059	Betapapillomavirus 6	1172193	S	31	0	31	0.00000
SRR6145059	Aerococcus christensenii	87541	S	30	1	31	0.00000
SRR6145059	Symbiobacterium thermophilum	2734	S	30	0	30	0.00000
SRR6145059	Streptomyces sp. S8	1837283	S	40	30	70	0.00001
SRR6145059	Stenotrophomonas sp. YAU14D1_LEIMI4_1	2072407	S	28	30	58	0.00001
SRR6145059	Rhizobium sp. JKLM13E	2582918	S	15	30	45	0.00001
SRR6145059	Raoultella sp. NCTC 9189	2583577	S	30	39	69	0.00001
SRR6145059	Pseudomonas sp. J380	2605424	S	30	30	60	0.00001
SRR6145059	Pseudomonas sabulinigri	472181	S	30	0	30	0.00000
SRR6145059	Paenibacillus mucilaginosus	61624	S	30	0	30	0.00000
SRR6145059	Moraxella bovoculi	386891	S	23	7	30	0.00000
SRR6145059	Mesorhizobium sp. WSM1497	278153	S	7	30	37	0.00000
SRR6145059	Lelliottia nimipressuralis	69220	S	24	6	30	0.00000
SRR6145059	Labrenzia sp. CP4	1674922	S	6	30	36	0.00000
SRR6145059	Jonesia denitrificans	43674	S	30	0	30	0.00000
SRR6145059	Halostagnicola larsenii	353800	S	30	0	30	0.00000
SRR6145059	Gordonibacter urolithinfaciens	1335613	S	22	8	30	0.00000
SRR6145059	Erwinia persicina	55211	S	29	1	30	0.00000
SRR6145059	Bifidobacterium pseudocatenulatum	28026	S	21	9	30	0.00000
SRR6145059	Beijerinckia indica	533	S	29	1	30	0.00000
SRR6145059	Ancylobacter sp. TS-1	1850374	S	114	30	144	0.00002
SRR6145059	Aeromicrobium sp. 592	2079793	S	162	30	192	0.00002
SRR6145059	Vibrio fluvialis	676	S	28	1	29	0.00000
SRR6145059	Variovorax sp. RA8	662548	S	118	29	147	0.00002
SRR6145059	Thiomonas arsenitoxydans	426114	S	11	18	29	0.00000
SRR6145059	Streptomyces sp. Tue 6075	1661694	S	29	17	46	0.00001
SRR6145059	Spirosoma rigui	564064	S	27	2	29	0.00000
SRR6145059	Rhodococcus sp. WB9	2594007	S	34	29	63	0.00001
SRR6145059	Rhizobium acidisoli	1538158	S	18	11	29	0.00000
SRR6145059	Psychrobacter sp. P11G5	1699624	S	45	29	74	0.00001
SRR6145059	Pseudomonas saudiphocaensis	1499686	S	29	0	29	0.00000
SRR6145059	Pseudomonas litoralis	797277	S	29	0	29	0.00000
SRR6145059	Pseudomonas agarici	46677	S	29	0	29	0.00000
SRR6145059	Propionibacterium virus P1.1	1982264	S	27	29	56	0.00001
SRR6145059	Propionibacterium virus ATCC29399BT	1982253	S	15	29	44	0.00001
SRR6145059	Natronobacterium gregoryi	44930	S	28	1	29	0.00000
SRR6145059	Mesorhizobium sp. NIBRBAC000500504	2725666	S	158	29	187	0.00002
SRR6145059	Kosakonia oryzae	497725	S	15	14	29	0.00000
SRR6145059	Komagataeibacter rhaeticus	215221	S	2	27	29	0.00000
SRR6145059	Hydrogenophaga sp. RAC07	1842537	S	112	29	141	0.00002
SRR6145059	Gloeocapsa sp. PCC 7428	1173026	S	29	1	30	0.00000
SRR6145059	Flavobacterium kingsejongi	1678728	S	29	0	29	0.00000
SRR6145059	Erwinia billingiae	182337	S	13	16	29	0.00000
SRR6145059	Enterobacter sp. HK169	1868135	S	11	29	40	0.00000
SRR6145059	Desulfovibrio magneticus	184917	S	25	4	29	0.00000
SRR6145059	Bacteroides ovatus	28116	S	21	8	29	0.00000
SRR6145059	Anaerostipes hadrus	649756	S	27	2	29	0.00000
SRR6145059	Adlercreutzia equolifaciens	446660	S	21	8	29	0.00000
SRR6145059	Tatumella ptyseos	82987	S	27	1	28	0.00000
SRR6145059	Tardiphaga sp. vice352	2592816	S	1	28	29	0.00000
SRR6145059	Staphylococcus schweitzeri	1654388	S	23	5	28	0.00000
SRR6145059	Staphylococcus chromogenes	46126	S	27	1	28	0.00000
SRR6145059	Sphingobacterium sp. CZ-2	2557994	S	407	28	435	0.00005
SRR6145059	Serratia odorifera	618	S	27	1	28	0.00000
SRR6145059	Rhodococcus sp. WAY2	2663121	S	77	28	105	0.00001
SRR6145059	Rhizobium sp. JKLM12A2	2583231	S	14	28	42	0.00000
SRR6145059	Rathayibacter toxicus	145458	S	28	0	28	0.00000
SRR6145059	Pseudomonas extremaustralis	359110	S	26	2	28	0.00000
SRR6145059	Octadecabacter antarcticus	1217908	S	28	0	28	0.00000
SRR6145059	Neisseria zoodegmatis	326523	S	26	2	28	0.00000
SRR6145059	Luteimonas sp. Gr-4	1176533	S	314	28	342	0.00004
SRR6145059	Leuconostoc suionicum	1511761	S	25	3	28	0.00000
SRR6145059	Lactococcus garvieae	1363	S	23	5	28	0.00000
SRR6145059	Gordonibacter pamelaeae	471189	S	20	8	28	0.00000
SRR6145059	Flavisolibacter tropicus	1492898	S	25	3	28	0.00000
SRR6145059	Curtobacterium sp. SGAir0471	2070337	S	96	28	124	0.00001
SRR6145059	Corynebacterium sp. NML98-0116	702967	S	373	28	401	0.00005
SRR6145059	Cedecea neteri	158822	S	27	1	28	0.00000
SRR6145059	Bacillus pumilus	1408	S	25	3	28	0.00000
SRR6145059	Aquitalea magnusonii	332411	S	23	5	28	0.00000
SRR6145059	Altererythrobacter sp. NS1	2338327	S	195	28	223	0.00003
SRR6145059	Actinomyces sp. dk561	2560010	S	103	28	131	0.00002
SRR6145059	Vibrio parahaemolyticus	670	S	23	4	27	0.00000
SRR6145059	Veillonella rodentium	248315	S	27	0	27	0.00000
SRR6145059	Thiomonas sp. X19	1050370	S	93	27	120	0.00001
SRR6145059	Thermus thermophilus	274	S	16	11	27	0.00000
SRR6145059	Streptomyces sp. NEAU-S7GS2	2202000	S	42	27	69	0.00001
SRR6145059	Sterolibacterium denitrificans	157592	S	27	0	27	0.00000
SRR6145059	Spirosoma radiotolerans	1379870	S	24	3	27	0.00000
SRR6145059	Pseudomonas sp. S09G 359	2054919	S	27	3	30	0.00000
SRR6145059	Pseudomonas sp. 14181154	2662033	S	52	27	79	0.00001
SRR6145059	Propionibacterium virus Ouroboros	1982259	S	85	27	112	0.00001
SRR6145059	Pectobacterium versatile	2488639	S	14	13	27	0.00000
SRR6145059	Parabacteroides distasonis	823	S	13	14	27	0.00000
SRR6145059	Ochrobactrum pituitosum	571256	S	17	10	27	0.00000
SRR6145059	Microvirga sp. HR1	2651334	S	151	27	178	0.00002
SRR6145059	Marinobacterium aestuarii	1821621	S	27	0	27	0.00000
SRR6145059	Leisingera sp. NJS201	2508306	S	14	27	41	0.00000
SRR6145059	Lactococcus piscium	1364	S	26	1	27	0.00000
SRR6145059	Haloplanus aerogenes	660522	S	25	2	27	0.00000
SRR6145059	Halapricum salinum	1457250	S	27	0	27	0.00000
SRR6145059	Gemmatimonas aurantiaca	173480	S	27	0	27	0.00000
SRR6145059	Filimonas lacunae	477680	S	25	2	27	0.00000
SRR6145059	Eggerthella lenta	84112	S	25	2	27	0.00000
SRR6145059	Desulfovibrio marinus	370038	S	27	0	27	0.00000
SRR6145059	Desulfosarcina alkanivorans	571177	S	25	2	27	0.00000
SRR6145059	Cyanobium gracile	59930	S	26	1	27	0.00000
SRR6145059	Burkholderia sp. KJ006	416344	S	8	27	35	0.00000
SRR6145059	Burkholderia sp. CCGE1003	640512	S	816	27	843	0.00010
SRR6145059	Brevundimonas sp. LM2	1938605	S	639	27	666	0.00008
SRR6145059	Arthrobacter sp. UKPF54-2	2600159	S	80	27	107	0.00001
SRR6145059	Arthrobacter sp. KBS0702	2578107	S	86	27	113	0.00001
SRR6145059	Thalassospira xiamenensis	220697	S	25	1	26	0.00000
SRR6145059	Streptomyces sp. endophyte_N2	2153485	S	34	26	60	0.00001
SRR6145059	Streptococcus gallolyticus	315405	S	9	17	26	0.00000
SRR6145059	Staphylococcus sp. SDB 2975	2044912	S	26	3	29	0.00000
SRR6145059	Staphylococcus fleurettii	150056	S	23	3	26	0.00000
SRR6145059	Shigella boydii	621	S	3	23	26	0.00000
SRR6145059	Runella slithyformis	106	S	24	2	26	0.00000
SRR6145059	Rhodobacteraceae bacterium SH-1	2605946	S	137	26	163	0.00002
SRR6145059	Pseudomonas xanthomarina	271420	S	25	1	26	0.00000
SRR6145059	Pseudomonas sp. SWI36	2083052	S	12	26	38	0.00000
SRR6145059	Pseudomonas mucidolens	46679	S	25	1	26	0.00000
SRR6145059	Pseudomonas mediterranea	183795	S	23	3	26	0.00000
SRR6145059	Providencia rettgeri	587	S	15	11	26	0.00000
SRR6145059	Propionibacterium virus PHL132N00	1982291	S	23	26	49	0.00001
SRR6145059	Propionibacterium virus PHL025M00	1982274	S	31	26	57	0.00001
SRR6145059	Porphyromonas cangingivalis	36874	S	26	0	26	0.00000
SRR6145059	Parasedimentitalea marina	2483033	S	26	0	26	0.00000
SRR6145059	Natronomonas moolapensis	416273	S	26	0	26	0.00000
SRR6145059	Mycobacterium lepraemurium	64667	S	24	2	26	0.00000
SRR6145059	Mixta gaviniae	665914	S	24	2	26	0.00000
SRR6145059	Legionella pneumophila	446	S	23	3	26	0.00000
SRR6145059	Leclercia sp. J807	2681307	S	23	26	49	0.00001
SRR6145059	Komagataeibacter europaeus	33995	S	21	5	26	0.00000
SRR6145059	Herminiimonas arsenicoxydans	204773	S	20	6	26	0.00000
SRR6145059	Geobacillus stearothermophilus	1422	S	13	13	26	0.00000
SRR6145059	Flavisolibacter ginsenosidimutans	661481	S	25	1	26	0.00000
SRR6145059	Dickeya fangzhongdai	1778540	S	8	18	26	0.00000
SRR6145059	Clostridium butyricum	1492	S	26	0	26	0.00000
SRR6145059	Cellulomonas sp. PSBB021	2003551	S	167	26	193	0.00002
SRR6145059	Bifidobacterium animalis	28025	S	26	0	26	0.00000
SRR6145059	Bacteroides thetaiotaomicron	818	S	23	3	26	0.00000
SRR6145059	Arcobacter ellisii	913109	S	23	3	26	0.00000
SRR6145059	Alistipes onderdonkii	328813	S	23	3	26	0.00000
SRR6145059	Aeromonas schubertii	652	S	25	1	26	0.00000
SRR6145059	Aeromonas encheleia	73010	S	24	2	26	0.00000
SRR6145059	Advenella kashmirensis	310575	S	25	1	26	0.00000
SRR6145059	Streptococcus infantarius	102684	S	16	9	25	0.00000
SRR6145059	Staphylococcus felis	46127	S	25	0	25	0.00000
SRR6145059	Spiribacter roseus	1855875	S	25	0	25	0.00000
SRR6145059	Simonsiella muelleri	72	S	25	0	25	0.00000
SRR6145059	Serratia nematodiphila	458197	S	3	22	25	0.00000
SRR6145059	Rhizobium sp. N324	1703969	S	2	25	27	0.00000
SRR6145059	Pseudodesulfovibrio indicus	1716143	S	23	2	25	0.00000
SRR6145059	Pseudoalteromonas nigrifaciens	28109	S	8	17	25	0.00000
SRR6145059	Propionibacterium virus ATCC29399BC	1982252	S	6	25	31	0.00000
SRR6145059	Ornithinimicrobium sp. AMA3305	2283195	S	338	25	363	0.00004
SRR6145059	Nostoc linckia	92942	S	22	3	25	0.00000
SRR6145059	Neisseria animaloris	326522	S	24	1	25	0.00000
SRR6145059	Moraxella bovis	476	S	24	1	25	0.00000
SRR6145059	Mesorhizobium sp. M9A.F.Ca.ET.002.03.1.2	2493668	S	56	25	81	0.00001
SRR6145059	Melaminivora sp. SC2-9	2109913	S	146	25	171	0.00002
SRR6145059	Marinobacter salarius	1420917	S	23	2	25	0.00000
SRR6145059	Leuconostoc gelidum	1244	S	25	0	25	0.00000
SRR6145059	Leptospirillum ferriphilum	178606	S	18	7	25	0.00000
SRR6145059	Leclercia sp. W17	2282309	S	14	25	39	0.00000
SRR6145059	Haloterrigena turkmenica	62320	S	24	1	25	0.00000
SRR6145059	Halorhabdus utahensis	146826	S	25	0	25	0.00000
SRR6145059	Haloferax gibbonsii	35746	S	23	2	25	0.00000
SRR6145059	Halobacterium salinarum	2242	S	24	1	25	0.00000
SRR6145059	Gemmatimonas phototrophica	1379270	S	25	0	25	0.00000
SRR6145059	Fuerstia marisgermanicae	1891926	S	25	0	25	0.00000
SRR6145059	Flavonifractor plautii	292800	S	24	1	25	0.00000
SRR6145059	Flavobacterium sediminis	2201181	S	22	3	25	0.00000
SRR6145059	Flavobacterium nitrogenifigens	1617283	S	20	5	25	0.00000
SRR6145059	Fimbriimonas ginsengisoli	1005039	S	25	0	25	0.00000
SRR6145059	Dermatophilus congolensis	1863	S	25	0	25	0.00000
SRR6145059	Deinococcus sp. NW-56	2080419	S	533	25	558	0.00007
SRR6145059	Cohnella candidum	2674991	S	25	0	25	0.00000
SRR6145059	Candidatus Liberibacter asiaticus	34021	S	3	25	28	0.00000
SRR6145059	Bordetella avium	521	S	25	0	25	0.00000
SRR6145059	Beijerinckiaceae bacterium	1978229	S	25	0	25	0.00000
SRR6145059	Agrococcus sp. SGAir0287	2070347	S	182	25	207	0.00002
SRR6145059	Agrobacterium sp. H13-3	861208	S	7	25	32	0.00000
SRR6145059	Acidihalobacter ferrooxidans	1765967	S	25	0	25	0.00000
SRR6145059	haloarchaeon 3A1-DGR	1071085	S	21	3	24	0.00000
SRR6145059	Xylanimicrobium sp. FW10M-9	2509457	S	147	24	171	0.00002
SRR6145059	Vibrio vulnificus	672	S	23	1	24	0.00000
SRR6145059	Streptomyces sp. Sge12	1972846	S	31	24	55	0.00001
SRR6145059	Streptomyces sp. MOE7	1961713	S	18	24	42	0.00000
SRR6145059	Streptomyces sp. CB09001	2083284	S	52	24	76	0.00001
SRR6145059	Stenotrophomonas sp. LM091	1904944	S	96	24	120	0.00001
SRR6145059	Staphylococcus piscifermentans	70258	S	22	2	24	0.00000
SRR6145059	Salaquimonas pukyongi	2712698	S	24	0	24	0.00000
SRR6145059	Roseobacter litoralis	42443	S	23	1	24	0.00000
SRR6145059	Rhizobium sp. JKLM19E	2583232	S	10	24	34	0.00000
SRR6145059	Pseudomonas sp. CCOS 191	1649877	S	24	7	31	0.00000
SRR6145059	Pseudomonas brenneri	129817	S	21	3	24	0.00000
SRR6145059	Pseudodesulfovibrio aespoeensis	182210	S	21	3	24	0.00000
SRR6145059	Propionibacterium virus P101A	1982267	S	15	24	39	0.00000
SRR6145059	Propionibacterium virus MrAK	1982258	S	17	24	41	0.00000
SRR6145059	Planctomycetes bacterium	2026780	S	24	0	24	0.00000
SRR6145059	Neisseria animalis	492	S	24	0	24	0.00000
SRR6145059	Methylocaldum marinum	1432792	S	24	0	24	0.00000
SRR6145059	Martelella sp. AD-3	686597	S	79	24	103	0.00001
SRR6145059	Lelliottia amnigena	61646	S	23	1	24	0.00000
SRR6145059	Grimontia hollisae	673	S	24	0	24	0.00000
SRR6145059	Gammapapillomavirus 8	1175850	S	24	0	24	0.00000
SRR6145059	Frankia sp. QA3	710111	S	111	24	135	0.00002
SRR6145059	Flavobacterium sangjuense	2518177	S	24	0	24	0.00000
SRR6145059	Flavobacterium columnare	996	S	24	0	24	0.00000
SRR6145059	Cronobacter turicensis	413502	S	21	3	24	0.00000
SRR6145059	Bacteroides heparinolyticus	28113	S	20	4	24	0.00000
SRR6145059	Asaia bogorensis	91915	S	24	0	24	0.00000
SRR6145059	Alicyclobacillus acidocaldarius	405212	S	24	0	24	0.00000
SRR6145059	Aeromonas dhakensis	196024	S	13	11	24	0.00000
SRR6145059	Acidithiobacillus caldus	33059	S	21	3	24	0.00000
SRR6145059	[Clostridium] innocuum	1522	S	11	12	23	0.00000
SRR6145059	Xanthomonas perforans	442694	S	4	19	23	0.00000
SRR6145059	Trueperella bialowiezensis	312285	S	23	0	23	0.00000
SRR6145059	Streptococcus parauberis	1348	S	21	2	23	0.00000
SRR6145059	Streptococcus macedonicus	59310	S	5	18	23	0.00000
SRR6145059	Streptococcus canis	1329	S	21	2	23	0.00000
SRR6145059	Stenotrophomonas sp. SAU14A_NAIMI4_5	2072413	S	67	23	90	0.00001
SRR6145059	Salinivibrio costicola	51367	S	12	11	23	0.00000
SRR6145059	Salinibaculum litoreum	1710541	S	21	2	23	0.00000
SRR6145059	Rubrobacter indicoceani	2051957	S	22	1	23	0.00000
SRR6145059	Rathayibacter sp. VKM Ac-2805	2609258	S	23	36	59	0.00001
SRR6145059	Pseudomonas viridiflava	33069	S	23	0	23	0.00000
SRR6145059	Pseudomonas thivervalensis	86265	S	20	3	23	0.00000
SRR6145059	Pseudomonas sp. XWY-1	2069256	S	12	23	35	0.00000
SRR6145059	Pseudomonas soli	1306993	S	8	15	23	0.00000
SRR6145059	Pseudomonas poae	200451	S	18	5	23	0.00000
SRR6145059	Pseudomonas coronafaciens	53409	S	22	1	23	0.00000
SRR6145059	Propionibacterium virus Solid	1982306	S	30	23	53	0.00001
SRR6145059	Propionibacterium virus PHL095N00	1982283	S	19	23	42	0.00000
SRR6145059	Propionibacterium virus PA6	1982269	S	27	23	50	0.00001
SRR6145059	Propionibacterium virus Lauchelly	1982257	S	91	23	114	0.00001
SRR6145059	Propionibacterium phage QueenBey	1654782	S	63	23	86	0.00001
SRR6145059	Paenibacillus beijingensis	1126833	S	23	0	23	0.00000
SRR6145059	Myroides odoratimimus	76832	S	11	12	23	0.00000
SRR6145059	Lactobacillus reuteri	1598	S	23	0	23	0.00000
SRR6145059	Halovivax ruber	387341	S	23	0	23	0.00000
SRR6145059	Haloterrigena daqingensis	588898	S	23	0	23	0.00000
SRR6145059	Halomonas sp. PA16-9	2576841	S	33	23	56	0.00001
SRR6145059	Halomicrobium mukohataei	57705	S	13	10	23	0.00000
SRR6145059	Enterobacter cloacae complex sp.	2027919	S	23	30	53	0.00001
SRR6145059	Devosia sp. A16	1736675	S	336	23	359	0.00004
SRR6145059	Desulfosarcina ovata	83564	S	23	0	23	0.00000
SRR6145059	Clostridium pasteurianum	1501	S	23	0	23	0.00000
SRR6145059	Citrobacter sp. 92	2019568	S	1	23	24	0.00000
SRR6145059	Chromobacterium haemolyticum	394935	S	6	17	23	0.00000
SRR6145059	Carnobacterium maltaromaticum	2751	S	21	2	23	0.00000
SRR6145059	Blautia producta	33035	S	16	7	23	0.00000
SRR6145059	Aquitalea denitrificans	519081	S	20	3	23	0.00000
SRR6145059	Anaerobutyricum hallii	39488	S	21	2	23	0.00000
SRR6145059	Aeromonas sp. ASNIH4	1636609	S	11	23	34	0.00000
SRR6145059	Aeromicrobium sp. MF47	2662028	S	130	23	153	0.00002
SRR6145059	Actinomyces sp. Z16	2079536	S	88	23	111	0.00001
SRR6145059	Yersinia intermedia	631	S	4	18	22	0.00000
SRR6145059	Thauera sp. MZ1T	85643	S	109	22	131	0.00002
SRR6145059	Terriglobus roseus	392734	S	22	0	22	0.00000
SRR6145059	Streptomyces sp. RPA4-5	2721245	S	41	22	63	0.00001
SRR6145059	Streptomyces sp. CNQ-509	444103	S	59	22	81	0.00001
SRR6145059	Streptomyces sp. CCM_MD2014	1561022	S	50	22	72	0.00001
SRR6145059	Streptococcus porcinus	1340	S	19	3	22	0.00000
SRR6145059	Sphingomonas sp. LM7	1938607	S	315	22	337	0.00004
SRR6145059	Simiduia agarivorans	447471	S	22	0	22	0.00000
SRR6145059	Pseudomonas silesiensis	1853130	S	20	2	22	0.00000
SRR6145059	Pseudomonas reinekei	395598	S	21	1	22	0.00000
SRR6145059	Propionibacterium virus PHL113M01	1982286	S	18	22	40	0.00000
SRR6145059	Prochlorococcus marinus	1219	S	19	3	22	0.00000
SRR6145059	Porphyrobacter sp. HT-58-2	2023229	S	112	22	134	0.00002
SRR6145059	Pediococcus pentosaceus	1255	S	21	1	22	0.00000
SRR6145059	Paenibacillus thiaminolyticus	49283	S	22	0	22	0.00000
SRR6145059	Ochrobactrum pseudogrignonense	419475	S	14	8	22	0.00000
SRR6145059	Nostoc flagelliforme	1306274	S	16	6	22	0.00000
SRR6145059	Nocardioides sp. HY056	2500546	S	156	22	178	0.00002
SRR6145059	Niabella ginsenosidivorans	1176587	S	21	1	22	0.00000
SRR6145059	Mycobacterium sp. ELW1	1547487	S	113	22	135	0.00002
SRR6145059	Mucilaginibacter ginsenosidivorax	862126	S	22	0	22	0.00000
SRR6145059	Miniimonas sp. S16	2171623	S	377	22	399	0.00005
SRR6145059	Methylomonas clara	417	S	19	3	22	0.00000
SRR6145059	Mesorhizobium sp. M4B.F.Ca.ET.058.02.1.1	2493675	S	84	22	106	0.00001
SRR6145059	Labrenzia alexandrii	388408	S	21	1	22	0.00000
SRR6145059	Kushneria konosiri	698828	S	20	2	22	0.00000
SRR6145059	Hymenobacter sp. DG01	2584940	S	109	22	131	0.00002
SRR6145059	Gloeobacter kilaueensis	1416614	S	22	0	22	0.00000
SRR6145059	Glaesserella parasuis	738	S	20	2	22	0.00000
SRR6145059	Gemmata sp. SH-PL17	1630693	S	52	22	74	0.00001
SRR6145059	Fusobacterium necrophorum	859	S	22	0	22	0.00000
SRR6145059	Ferriphaselus amnicola	1188319	S	22	0	22	0.00000
SRR6145059	Enterocloster bolteae	208479	S	21	1	22	0.00000
SRR6145059	Bordetella holmesii	35814	S	21	1	22	0.00000
SRR6145059	Bacillus safensis	561879	S	21	1	22	0.00000
SRR6145059	Arachidicoccus ginsenosidivorans	496057	S	21	1	22	0.00000
SRR6145059	Amycolatopsis sp. BJA-103	1911175	S	106	22	128	0.00002
SRR6145059	Vibrio alginolyticus	663	S	12	9	21	0.00000
SRR6145059	Thioalkalivibrio versutus	106634	S	21	0	21	0.00000
SRR6145059	Thermochromatium tepidum	1050	S	21	0	21	0.00000
SRR6145059	Thauera hydrothermalis	2184083	S	6	15	21	0.00000
SRR6145059	Tetragenococcus halophilus	51669	S	21	0	21	0.00000
SRR6145059	Sutterella megalosphaeroides	2494234	S	21	0	21	0.00000
SRR6145059	Streptomyces sp. S1D4-11	2721246	S	56	21	77	0.00001
SRR6145059	Stenotrophomonas sp. ZAC14D2_NAIMI4_7	2072405	S	34	21	55	0.00001
SRR6145059	Stenotrophomonas sp. MYb57	1827305	S	6	21	27	0.00000
SRR6145059	Staphylococcus stepanovicii	643214	S	21	0	21	0.00000
SRR6145059	Sneathia amnii	187101	S	21	0	21	0.00000
SRR6145059	Shewanella chilikensis	558541	S	15	6	21	0.00000
SRR6145059	Ruminococcus bicirculans	1160721	S	21	0	21	0.00000
SRR6145059	Roseovarius sp. TM1035	391613	S	13	21	34	0.00000
SRR6145059	Roseiflexus castenholzii	120962	S	19	2	21	0.00000
SRR6145059	Rhodothermaceae bacterium RA	1779382	S	23	21	44	0.00001
SRR6145059	Pseudomonas prosekii	1148509	S	20	1	21	0.00000
SRR6145059	Pseudomonas asplenii	53407	S	14	7	21	0.00000
SRR6145059	Pseudomonas amygdali	47877	S	9	12	21	0.00000
SRR6145059	Pseudescherichia vulneris	566	S	21	0	21	0.00000
SRR6145059	Pseudarthrobacter sp. NIBRBAC000502772	2590775	S	37	21	58	0.00001
SRR6145059	Propionibacterium virus Procrass1	1982304	S	27	21	48	0.00001
SRR6145059	Propionibacterium virus PHL060L00	1982277	S	18	21	39	0.00000
SRR6145059	Propionibacterium phage PAC1	1690805	S	18	21	39	0.00000
SRR6145059	Pedobacter suwonensis	332999	S	20	1	21	0.00000
SRR6145059	Pedobacter ginsengisoli	363852	S	20	1	21	0.00000
SRR6145059	Parascardovia denticolens	78258	S	21	0	21	0.00000
SRR6145059	Paraburkholderia sp. DHF22	2571748	S	399	21	420	0.00005
SRR6145059	Paenibacillus borealis	160799	S	20	1	21	0.00000
SRR6145059	Natrialba magadii	13769	S	18	3	21	0.00000
SRR6145059	Microbulbifer aggregans	1769779	S	21	0	21	0.00000
SRR6145059	Methylobacterium sp. 4-46	426117	S	411	21	432	0.00005
SRR6145059	Mesorhizobium sp. AA22	1854057	S	28	21	49	0.00001
SRR6145059	Leptotrichia goodfellowii	157692	S	21	0	21	0.00000
SRR6145059	Lacinutrix venerupis	1486034	S	20	1	21	0.00000
SRR6145059	Kiritimatiella glycovorans	1307763	S	15	6	21	0.00000
SRR6145059	Hymenobacter jejuensis	2502781	S	20	1	21	0.00000
SRR6145059	Haliscomenobacter hydrossis	2350	S	21	0	21	0.00000
SRR6145059	Granulosicoccus antarcticus	437505	S	21	0	21	0.00000
SRR6145059	Geitlerinema sp. PCC 7407	1173025	S	21	0	21	0.00000
SRR6145059	Erythrobacter sp. EB310	2739433	S	112	21	133	0.00002
SRR6145059	Enterobacter sp. ODB01	1827481	S	5	21	26	0.00000
SRR6145059	Desulfuromonas soudanensis	1603606	S	21	0	21	0.00000
SRR6145059	Desulfovibrio piger	901	S	21	0	21	0.00000
SRR6145059	Desulfocurvibacter africanus	873	S	21	0	21	0.00000
SRR6145059	Desulfobulbus propionicus	894	S	21	0	21	0.00000
SRR6145059	Clostridium saccharoperbutylacetonicum	36745	S	21	0	21	0.00000
SRR6145059	Citrobacter rodentium	67825	S	20	1	21	0.00000
SRR6145059	Chryseolinea soli	2321403	S	21	0	21	0.00000
SRR6145059	Cellulomonas sp. JZ18	2654191	S	186	21	207	0.00002
SRR6145059	Cellulomonas sp. H30R-01	2704467	S	181	21	202	0.00002
SRR6145059	Capnocytophaga haemolytica	45243	S	21	0	21	0.00000
SRR6145059	Capnocytophaga canimorsus	28188	S	20	1	21	0.00000
SRR6145059	Caldilinea aerophila	133453	S	21	0	21	0.00000
SRR6145059	Butyricimonas faecalis	2093856	S	15	6	21	0.00000
SRR6145059	Brenneria rubrifaciens	55213	S	13	8	21	0.00000
SRR6145059	Bacillus thermoamylovorans	35841	S	21	0	21	0.00000
SRR6145059	Yersinia enterocolitica	630	S	17	3	20	0.00000
SRR6145059	Thalassospira marina	2048283	S	20	0	20	0.00000
SRR6145059	Streptomyces sp. SYP-A7193	2662065	S	58	20	78	0.00001
SRR6145059	Streptomyces sp. Mg1	465541	S	49	20	69	0.00001
SRR6145059	Stenotrophomonas sp. ZAC14A_NAIMI4_1	2072412	S	17	20	37	0.00000
SRR6145059	Stenotrophomonas sp. YAU14A_MKIMI4_1	2072408	S	5	20	25	0.00000
SRR6145059	Staphylococcus hyicus	1284	S	19	1	20	0.00000
SRR6145059	Solitalea canadensis	995	S	20	0	20	0.00000
SRR6145059	Ruthenibacterium lactatiformans	1550024	S	19	1	20	0.00000
SRR6145059	Rhodovulum sp. P5	1564506	S	114	20	134	0.00002
SRR6145059	Pseudomonas lactis	1615674	S	13	7	20	0.00000
SRR6145059	Pseudoalteromonas tunicata	314281	S	20	0	20	0.00000
SRR6145059	Propionibacterium virus PHL116M00	1982288	S	54	20	74	0.00001
SRR6145059	Propionibacterium phage BruceLethal	1654740	S	87	20	107	0.00001
SRR6145059	Prevotella ruminicola	839	S	20	0	20	0.00000
SRR6145059	Pontibacter actiniarum	323450	S	17	3	20	0.00000
SRR6145059	Pedobacter steynii	430522	S	19	1	20	0.00000
SRR6145059	Paenibacillus cellulositrophicus	562959	S	20	0	20	0.00000
SRR6145059	Nocardioides sp. JQ2195	2592334	S	261	20	281	0.00003
SRR6145059	Natronorubrum aibiense	348826	S	19	1	20	0.00000
SRR6145059	Muribaculaceae bacterium DSM 108610	2652307	S	20	0	20	0.00000
SRR6145059	Mucilaginibacter mallensis	652787	S	20	0	20	0.00000
SRR6145059	Methylobacillus flagellatus	405	S	20	0	20	0.00000
SRR6145059	Mesorhizobium sp. NZP2077	2483404	S	89	20	109	0.00001
SRR6145059	Marinobacter sp. LQ44	1749259	S	31	20	51	0.00001
SRR6145059	Mannheimia haemolytica	75985	S	8	12	20	0.00000
SRR6145059	Leclercia sp. W6	2282310	S	14	20	34	0.00000
SRR6145059	Kosakonia sp. CCTCC M2018092	2492396	S	20	5	25	0.00000
SRR6145059	Isosphaera pallida	128	S	20	0	20	0.00000
SRR6145059	Hydrogenophilus thermoluteolus	297	S	20	0	20	0.00000
SRR6145059	Hydrogenophaga sp. BPS33	2651974	S	151	20	171	0.00002
SRR6145059	Hydrocarboniclastica marina	2259620	S	20	0	20	0.00000
SRR6145059	Gloeobacter violaceus	33072	S	20	0	20	0.00000
SRR6145059	Geobacter pickeringii	345632	S	20	0	20	0.00000
SRR6145059	Fusobacterium varium	856	S	20	0	20	0.00000
SRR6145059	Fusobacterium ulcerans	861	S	20	0	20	0.00000
SRR6145059	Fluviicola taffensis	191579	S	20	0	20	0.00000
SRR6145059	Flavobacterium sp. 140616W15	2478552	S	355	20	375	0.00004
SRR6145059	Flavobacterium psychrophilum	96345	S	19	1	20	0.00000
SRR6145059	Eubacterium limosum	1736	S	16	4	20	0.00000
SRR6145059	Edwardsiella tarda	636	S	12	8	20	0.00000
SRR6145059	Desulfovibrio gigas	879	S	20	0	20	0.00000
SRR6145059	Citrobacter pasteurii	1563222	S	7	13	20	0.00000
SRR6145059	Cellulomonas sp. Y8	2591145	S	231	20	251	0.00003
SRR6145059	Celeribacter marinus	1397108	S	20	0	20	0.00000
SRR6145059	Burkholderia sp. MSMB1588	1636423	S	9	20	29	0.00000
SRR6145059	Arthrobacter sp. AQ5-05	2184581	S	2	20	22	0.00000
SRR6145059	Alistipes megaguti	2364787	S	19	1	20	0.00000
SRR6145059	Acetobacter persici	1076596	S	20	0	20	0.00000
SRR6145059	Victivallales bacterium CCUG 44730	2094242	S	19	0	19	0.00000
SRR6145059	Tatumella citrea	53336	S	19	0	19	0.00000
SRR6145059	Streptomyces sp. KPB2	2305221	S	42	19	61	0.00001
SRR6145059	Staphylococcus virus S25-4	1980964	S	4	19	23	0.00000
SRR6145059	Staphylococcus agnetis	985762	S	18	1	19	0.00000
SRR6145059	Saccharibacillus brassicae	2583377	S	19	0	19	0.00000
SRR6145059	Roseivivax sp. THAF30	2587852	S	99	19	118	0.00001
SRR6145059	Rhizobium sp. Kim5	2020311	S	18	19	37	0.00000
SRR6145059	Pseudomonas sp. s211(2017)	2045200	S	6	19	25	0.00000
SRR6145059	Pseudomonas arsenicoxydans	702115	S	18	1	19	0.00000
SRR6145059	Proteus vulgaris	585	S	16	3	19	0.00000
SRR6145059	Propioniciclava sp. HDW11	2714937	S	298	19	317	0.00004
SRR6145059	Propionibacterium virus PHL092M00	1982282	S	30	19	49	0.00001
SRR6145059	Propionibacterium virus Attacne	1982254	S	32	19	51	0.00001
SRR6145059	Planctomycetes bacterium Mal35	2527993	S	2	19	21	0.00000
SRR6145059	Planctomycetes bacterium CA11	2527988	S	1	19	20	0.00000
SRR6145059	Pectobacterium odoriferum	78398	S	12	7	19	0.00000
SRR6145059	Pantoea sp. PSNIH1	1484158	S	54	19	73	0.00001
SRR6145059	Ornithobacterium rhinotracheale	28251	S	19	0	19	0.00000
SRR6145059	Nostoc sp. PCC 7524	28072	S	19	1	20	0.00000
SRR6145059	Nodularia spumigena	70799	S	17	2	19	0.00000
SRR6145059	Nocardioides sp. SB3-45	2558918	S	250	19	269	0.00003
SRR6145059	Niabella soli	446683	S	18	1	19	0.00000
SRR6145059	Natrinema pallidum	69527	S	15	4	19	0.00000
SRR6145059	Micromonospora sp. HM134	2583243	S	106	19	125	0.00001
SRR6145059	Microchaete diplosiphon	1197	S	10	9	19	0.00000
SRR6145059	Methanosarcina barkeri	2208	S	18	1	19	0.00000
SRR6145059	Mesorhizobium sp. M1B.F.Ca.ET.045.04.1.1	2493673	S	68	19	87	0.00001
SRR6145059	Magnetospirillum sp. XM-1	1663591	S	65	19	84	0.00001
SRR6145059	Lactobacillus pentosus	1589	S	19	0	19	0.00000
SRR6145059	Kushneria marisflavi	157779	S	17	2	19	0.00000
SRR6145059	Komagataeibacter medellinensis	1177712	S	14	5	19	0.00000
SRR6145059	Klebsiella sp. P1CD1	2267618	S	1	19	20	0.00000
SRR6145059	Kingella kingae	504	S	19	0	19	0.00000
SRR6145059	Human papillomavirus	10566	S	19	0	19	0.00000
SRR6145059	Granulicella tundricola	940615	S	19	0	19	0.00000
SRR6145059	Geobacillus subterraneus	129338	S	17	2	19	0.00000
SRR6145059	Francisella philomiragia	28110	S	6	13	19	0.00000
SRR6145059	Ereboglobus luteus	1796921	S	19	0	19	0.00000
SRR6145059	Enterobacter sichuanensis	2071710	S	12	7	19	0.00000
SRR6145059	Desulfatibacillum aliphaticivorans	218208	S	19	0	19	0.00000
SRR6145059	Cyanothece sp. PCC 7425	395961	S	19	0	19	0.00000
SRR6145059	Comamonas sp. NLF-7-7	2597701	S	124	19	143	0.00002
SRR6145059	Clostridium saccharobutylicum	169679	S	19	0	19	0.00000
SRR6145059	Clostridium baratii	1561	S	19	0	19	0.00000
SRR6145059	Campylobacter lari	201	S	18	1	19	0.00000
SRR6145059	Burkholderia sp. IDO3	1705310	S	105	19	124	0.00001
SRR6145059	Bradyrhizobium sp. 6(2017)	1197460	S	167	19	186	0.00002
SRR6145059	Bartonella apis	1686310	S	19	0	19	0.00000
SRR6145059	Bacillus sp. FDAARGOS_527	2576356	S	2	19	21	0.00000
SRR6145059	Bacillus circulans	1397	S	19	0	19	0.00000
SRR6145059	Alistipes dispar	2585119	S	17	2	19	0.00000
SRR6145059	Aerococcus urinae	1376	S	19	0	19	0.00000
SRR6145059	Acidovorax sp. 1608163	2478662	S	285	19	304	0.00004
SRR6145059	Zoogloeaceae bacteirum Par-f-2	2080469	S	7	18	25	0.00000
SRR6145059	Weeksella virosa	1014	S	18	0	18	0.00000
SRR6145059	Vibrio diabolicus	50719	S	8	10	18	0.00000
SRR6145059	Vibrio anguillarum	55601	S	16	2	18	0.00000
SRR6145059	Thioalkalivibrio paradoxus	108010	S	15	3	18	0.00000
SRR6145059	Sulfuriferula plumbiphila	171865	S	18	0	18	0.00000
SRR6145059	Streptomyces sp. Tu6071	355249	S	12	18	30	0.00000
SRR6145059	Streptomyces sp. SGAir0924	2109593	S	8	18	26	0.00000
SRR6145059	Streptomyces sp. S063	2005885	S	44	18	62	0.00001
SRR6145059	Streptomyces sp. Go-475	2072505	S	75	18	93	0.00001
SRR6145059	Streptococcus respiraculi	2021971	S	18	0	18	0.00000
SRR6145059	Streptococcus pluranimalium	82348	S	18	0	18	0.00000
SRR6145059	Sphingobium sp. RAC03	1843368	S	163	18	181	0.00002
SRR6145059	Sphingobacterium psychroaquaticum	561061	S	18	0	18	0.00000
SRR6145059	Serratia sp. FS14	1327989	S	9	18	27	0.00000
SRR6145059	Renibacterium salmoninarum	1646	S	18	0	18	0.00000
SRR6145059	Pseudonocardia sp. Gen01	2736640	S	381	18	399	0.00005
SRR6145059	Pseudomonas sp. WCS374	1495331	S	1	18	19	0.00000
SRR6145059	Pseudomonas sp. Os17	1500686	S	10	18	28	0.00000
SRR6145059	Pseudomonas sp. LH1G9	2083055	S	9	18	27	0.00000
SRR6145059	Pseudomonas extremorientalis	169669	S	13	5	18	0.00000
SRR6145059	Providencia heimbachae	333962	S	18	0	18	0.00000
SRR6145059	Propionibacterium virus P144	1982262	S	28	18	46	0.00001
SRR6145059	Propionibacterium phage PA1-14	1747271	S	23	18	41	0.00000
SRR6145059	Propionibacterium phage Moyashi	1654781	S	14	18	32	0.00000
SRR6145059	Pectobacterium polaris	2042057	S	13	5	18	0.00000
SRR6145059	Paeniclostridium sordellii	1505	S	18	0	18	0.00000
SRR6145059	Paenibacillus xylanilyticus	248903	S	18	0	18	0.00000
SRR6145059	Octadecabacter arcticus	53946	S	18	0	18	0.00000
SRR6145059	Nostoc punctiforme	272131	S	9	9	18	0.00000
SRR6145059	Neisseria canis	493	S	18	0	18	0.00000
SRR6145059	Micromonospora sp. WMMA2032	2039870	S	73	18	91	0.00001
SRR6145059	Mesorhizobium sp. M7D.F.Ca.US.005.01.1.1	2493678	S	54	18	72	0.00001
SRR6145059	Mesorhizobium sp. M3A.F.Ca.ET.080.04.2.1	2493676	S	72	18	90	0.00001
SRR6145059	Mesorhizobium sp. DCY119	2108445	S	131	18	149	0.00002
SRR6145059	Maritalea myrionectae	454601	S	18	0	18	0.00000
SRR6145059	Komagataeibacter hansenii	436	S	17	1	18	0.00000
SRR6145059	Histophilus somni	731	S	17	1	18	0.00000
SRR6145059	Haloplanus sp. CBA1112	1547898	S	6	18	24	0.00000
SRR6145059	Halomonas titanicae	664683	S	7	11	18	0.00000
SRR6145059	Gordonia sp. X0973	2742602	S	256	18	274	0.00003
SRR6145059	Gluconobacter thailandicus	257438	S	12	6	18	0.00000
SRR6145059	Geobacter anodireducens	1340425	S	11	7	18	0.00000
SRR6145059	Formosa sediminum	2594004	S	18	0	18	0.00000
SRR6145059	Flavobacterium pallidum	2172098	S	18	0	18	0.00000
SRR6145059	Flavobacterium branchiophilum	55197	S	18	0	18	0.00000
SRR6145059	Flavivirga eckloniae	1803846	S	18	0	18	0.00000
SRR6145059	Ferrimonas balearica	44012	S	18	0	18	0.00000
SRR6145059	Eubacterium maltosivorans	2041044	S	10	8	18	0.00000
SRR6145059	Enterococcus mundtii	53346	S	18	0	18	0.00000
SRR6145059	Desulfurivibrio alkaliphilus	427923	S	18	0	18	0.00000
SRR6145059	Desulfomicrobium baculatum	899	S	18	0	18	0.00000
SRR6145059	Curtobacterium sp. Csp2	2495430	S	113	18	131	0.00002
SRR6145059	Curtobacterium sp. BH-2-1-1	1905847	S	96	18	114	0.00001
SRR6145059	Chryseobacterium sp. G0162	2487063	S	48	18	66	0.00001
SRR6145059	Bremerella volcania	2527984	S	18	0	18	0.00000
SRR6145059	Bacteroides caccae	47678	S	18	0	18	0.00000
SRR6145059	Bacterioplanes sanyensis	1249553	S	18	0	18	0.00000
SRR6145059	Arcanobacterium haemolyticum	28264	S	16	2	18	0.00000
SRR6145059	Agromyces sp. MF30-A	2080742	S	108	18	126	0.00001
SRR6145059	Aeromonas sp. 2692-1	2560029	S	5	18	23	0.00000
SRR6145059	Yokenella regensburgei	158877	S	16	1	17	0.00000
SRR6145059	Trichodesmium erythraeum	1206	S	17	0	17	0.00000
SRR6145059	Thermobacillus composti	377615	S	17	0	17	0.00000
SRR6145059	Terriglobus albidus	1592106	S	17	0	17	0.00000
SRR6145059	Streptomyces sp. CFMR 7	1649184	S	17	38	55	0.00001
SRR6145059	Streptomyces sp. 3211	1964449	S	27	17	44	0.00001
SRR6145059	Streptococcus uberis	1349	S	17	0	17	0.00000
SRR6145059	Staphylococcus phage St 134	1958922	S	17	1	18	0.00000
SRR6145059	Shewanella decolorationis	256839	S	15	2	17	0.00000
SRR6145059	Sedimenticola thiotaurini	1543721	S	17	0	17	0.00000
SRR6145059	Rubinisphaera brasiliensis	119	S	17	0	17	0.00000
SRR6145059	Roseovarius sp. THAF9	2587847	S	63	17	80	0.00001
SRR6145059	Rhodobiaceae bacterium	2026785	S	17	0	17	0.00000
SRR6145059	Rathayibacter sp. VKM Ac-2762	2609254	S	17	25	42	0.00000
SRR6145059	Psychrobacter arcticus	334543	S	17	0	17	0.00000
SRR6145059	Pseudomonas sp. TMW 2.1634	1886807	S	17	51	68	0.00001
SRR6145059	Pseudomonas sp. S150	2559074	S	18	17	35	0.00000
SRR6145059	Pseudomonas sp. FGI182	1259844	S	20	17	37	0.00000
SRR6145059	Pseudomonas salegens	1434072	S	17	0	17	0.00000
SRR6145059	Propionibacterium virus Wizzo	1982308	S	23	17	40	0.00000
SRR6145059	Propionibacterium virus PHL111M01	1982284	S	16	17	33	0.00000
SRR6145059	Propionibacterium virus PHL041M10	1982276	S	24	17	41	0.00000
SRR6145059	Propionibacterium virus P100D	1982266	S	18	17	35	0.00000
SRR6145059	Plautia stali symbiont	891974	S	78	17	95	0.00001
SRR6145059	Paraprevotella xylaniphila	454155	S	15	2	17	0.00000
SRR6145059	Paenibacillus lautus	1401	S	14	3	17	0.00000
SRR6145059	Paenibacillus durus	44251	S	17	0	17	0.00000
SRR6145059	Oceanobacillus kimchii	746691	S	17	0	17	0.00000
SRR6145059	Neisseria weaveri	28091	S	16	1	17	0.00000
SRR6145059	Mycobacterium sp. DL90	2487344	S	172	17	189	0.00002
SRR6145059	Mucilaginibacter ginsenosidivorans	398053	S	17	0	17	0.00000
SRR6145059	Mixta intestinalis	1615494	S	16	1	17	0.00000
SRR6145059	Microbulbifer agarilyticus	260552	S	17	0	17	0.00000
SRR6145059	Microbacterium sp. LKL04	912630	S	286	17	303	0.00004
SRR6145059	Methylovulum psychrotolerans	1704499	S	17	0	17	0.00000
SRR6145059	Methylobacterium sp. WL1	2603276	S	242	17	259	0.00003
SRR6145059	Mesorhizobium sp. Pch-S	2082387	S	239	17	256	0.00003
SRR6145059	Megasphaera stantonii	2144175	S	15	2	17	0.00000
SRR6145059	Lysinibacillus sphaericus	1421	S	9	8	17	0.00000
SRR6145059	Lactobacillus johnsonii	33959	S	16	1	17	0.00000
SRR6145059	Lactobacillus helveticus	1587	S	13	4	17	0.00000
SRR6145059	Halalkaliarchaeum desulfuricum	2055893	S	17	0	17	0.00000
SRR6145059	Flavobacterium nackdongense	2547394	S	17	0	17	0.00000
SRR6145059	Emcibacter congregatus	2043170	S	17	0	17	0.00000
SRR6145059	Dialister pneumosintes	39950	S	17	0	17	0.00000
SRR6145059	Desulfovibrio sp. G11	631220	S	4	17	21	0.00000
SRR6145059	Desulfococcus multivorans	897	S	17	0	17	0.00000
SRR6145059	Citrobacter sp. CF971	2566012	S	2	17	19	0.00000
SRR6145059	Chitinophaga sp. 1303	2725414	S	1	17	18	0.00000
SRR6145059	Cedecea lapagei	158823	S	16	1	17	0.00000
SRR6145059	Capnocytophaga cynodegmi	28189	S	15	2	17	0.00000
SRR6145059	Bdellovibrio exovorus	453816	S	17	0	17	0.00000
SRR6145059	Alkalitalea saponilacus	889453	S	17	0	17	0.00000
SRR6145059	Alistipes finegoldii	214856	S	15	2	17	0.00000
SRR6145059	Aliivibrio fischeri	668	S	16	1	17	0.00000
SRR6145059	[Eubacterium] minutum	76124	S	16	0	16	0.00000
SRR6145059	Xylella fastidiosa	2371	S	16	0	16	0.00000
SRR6145059	Woeseia oceani	1548547	S	16	0	16	0.00000
SRR6145059	Vibrio campbellii	680	S	14	2	16	0.00000
SRR6145059	Urechidicola croceus	1850246	S	16	0	16	0.00000
SRR6145059	Syntrophobacter fumaroxidans	119484	S	15	1	16	0.00000
SRR6145059	Sulfuricella denitrificans	649841	S	16	0	16	0.00000
SRR6145059	Streptomyces sp. jing01	2726118	S	47	16	63	0.00001
SRR6145059	Streptomyces sp. W1SF4	2305220	S	108	16	124	0.00001
SRR6145059	Streptomyces sp. HF10	2692233	S	41	16	57	0.00001
SRR6145059	Streptococcus pasteurianus	197614	S	3	13	16	0.00000
SRR6145059	Stenotrophomonas sp. 364	2691571	S	61	16	77	0.00001
SRR6145059	Starkeya sp. ORNL1	2709380	S	174	16	190	0.00002
SRR6145059	Staphylococcus sp. MI 10-1553	1912064	S	16	1	17	0.00000
SRR6145059	Staphylococcus muscae	1294	S	16	0	16	0.00000
SRR6145059	Staphylococcus lutrae	155085	S	16	0	16	0.00000
SRR6145059	Spiribacter curvatus	1335757	S	16	0	16	0.00000
SRR6145059	Sphingomonas sp. C33	2698679	S	292	16	308	0.00004
SRR6145059	Sodalis praecaptivus	1239307	S	13	3	16	0.00000
SRR6145059	Serratia symbiotica	138074	S	16	0	16	0.00000
SRR6145059	Rhizobium sp. NIBRBAC000502774	2590777	S	11	16	27	0.00000
SRR6145059	Pseudomonas sp. SWI44	2083053	S	3	16	19	0.00000
SRR6145059	Pseudomonas lini	163011	S	15	1	16	0.00000
SRR6145059	Pseudoalteromonas donghaensis	621376	S	16	0	16	0.00000
SRR6145059	Propionibacterium virus PHL141N00	1982292	S	13	16	29	0.00000
SRR6145059	Propionibacterium virus P91	1982260	S	14	16	30	0.00000
SRR6145059	Pontibacter akesuensis	388950	S	15	1	16	0.00000
SRR6145059	Parvularcula bermudensis	208216	S	16	0	16	0.00000
SRR6145059	Olsenella umbonata	604330	S	15	1	16	0.00000
SRR6145059	Olleya aquimaris	639310	S	16	0	16	0.00000
SRR6145059	Olivibacter sp. LS-1	2592345	S	7	16	23	0.00000
SRR6145059	Oceanobacillus iheyensis	182710	S	16	0	16	0.00000
SRR6145059	Mycoplasma salivarium	2124	S	8	8	16	0.00000
SRR6145059	Mycoavidus cysteinexigens	1553431	S	16	0	16	0.00000
SRR6145059	Mucilaginibacter paludis	423351	S	16	0	16	0.00000
SRR6145059	Microbulbifer hydrolyticus	48074	S	16	0	16	0.00000
SRR6145059	Microbacterium sp. PM5	2014534	S	380	16	396	0.00005
SRR6145059	Methylomonas denitrificans	1538553	S	16	0	16	0.00000
SRR6145059	Mesorhizobium sp. NZP2298	2483403	S	44	16	60	0.00001
SRR6145059	Mesorhizobium sp. 8	2584466	S	158	16	174	0.00002
SRR6145059	Marivirga tractuosa	1006	S	13	3	16	0.00000
SRR6145059	Marinobacter fonticola	2603215	S	16	0	16	0.00000
SRR6145059	Mariniblastus fucicola	980251	S	16	0	16	0.00000
SRR6145059	Luteimonas sp. 100111	2006110	S	274	16	290	0.00003
SRR6145059	Leadbetterella byssophila	316068	S	15	1	16	0.00000
SRR6145059	Lactobacillus sakei	1599	S	15	1	16	0.00000
SRR6145059	Lactobacillus brevis	1580	S	16	0	16	0.00000
SRR6145059	Komagataeibacter nataicola	265960	S	14	2	16	0.00000
SRR6145059	Jonquetella anthropi	428712	S	16	0	16	0.00000
SRR6145059	Hymenobacter sp. APR13	1356852	S	52	16	68	0.00001
SRR6145059	Halostella pelagica	2583824	S	15	1	16	0.00000
SRR6145059	Halopenitus persicus	1048396	S	15	1	16	0.00000
SRR6145059	Halioglobus pacificus	930806	S	16	0	16	0.00000
SRR6145059	Halanaeroarchaeum sulfurireducens	1604004	S	16	0	16	0.00000
SRR6145059	Flavobacterium gilvum	1492737	S	16	0	16	0.00000
SRR6145059	Escherichia fergusonii	564	S	10	6	16	0.00000
SRR6145059	Enterococcus cecorum	44008	S	16	0	16	0.00000
SRR6145059	Edwardsiella piscicida	1263550	S	2	14	16	0.00000
SRR6145059	Devosia sp. I507	2083786	S	169	16	185	0.00002
SRR6145059	Cloacibacillus porcorum	1197717	S	16	0	16	0.00000
SRR6145059	Chitinophaga sp. 1310	2725416	S	1	16	17	0.00000
SRR6145059	Chitinophaga caeni	2029983	S	16	0	16	0.00000
SRR6145059	Candidatus Saccharibacteria bacterium YM_S32_TM7_50_20	2056494	S	16	0	16	0.00000
SRR6145059	Candidatus Gracilibacteria bacterium HOT-871	1540872	S	16	0	16	0.00000
SRR6145059	Calothrix brevissima	938406	S	13	3	16	0.00000
SRR6145059	Bacillus tropicus	2026188	S	3	13	16	0.00000
SRR6145059	Bacillus miscanthi	2598861	S	16	0	16	0.00000
SRR6145059	Anabaena cylindrica	1165	S	15	1	16	0.00000
SRR6145059	Altererythrobacter sp. TH136	2067415	S	167	16	183	0.00002
SRR6145059	Agromyces sp. LHK192	2498704	S	130	16	146	0.00002
SRR6145059	Acinetobacter sp. ACNIH2	1758189	S	143	16	159	0.00002
SRR6145059	Acidisarcina polymorpha	2211140	S	16	0	16	0.00000
SRR6145059	Acetobacter ghanensis	431306	S	15	1	16	0.00000
SRR6145059	Variovorax sp. PBS-H4	434008	S	102	15	117	0.00001
SRR6145059	Thermus aquaticus	271	S	14	1	15	0.00000
SRR6145059	Tetrasphaera sp. HKS02	1813880	S	300	15	315	0.00004
SRR6145059	Sutterella faecalis	2584944	S	15	0	15	0.00000
SRR6145059	Streptomyces sp. JB150	2714844	S	83	15	98	0.00001
SRR6145059	Streptomyces sp. CLI2509	1984801	S	9	15	24	0.00000
SRR6145059	Sporosarcina ureae	1571	S	15	0	15	0.00000
SRR6145059	Sphingomonas sp. PAMC26645	2565555	S	385	15	400	0.00005
SRR6145059	Sphingomonas sp. LMO-1	2681549	S	398	15	413	0.00005
SRR6145059	Sphingomonas sp. Cra20	1327635	S	288	15	303	0.00004
SRR6145059	Sideroxydans lithotrophicus	63745	S	15	0	15	0.00000
SRR6145059	Shewanella khirikhana	1965282	S	15	0	15	0.00000
SRR6145059	Scandinavium goeteborgense	1851514	S	15	0	15	0.00000
SRR6145059	Roseimaritima ulvae	980254	S	15	0	15	0.00000
SRR6145059	Rhodoluna limnophila	232537	S	15	0	15	0.00000
SRR6145059	Rhodococcus sp. SGAir0479	2567884	S	183	15	198	0.00002
SRR6145059	Rhizobium sp. IE4771	1301032	S	19	15	34	0.00000
SRR6145059	Psychrobacter urativorans	45610	S	15	0	15	0.00000
SRR6145059	Pseudomonas sp. TKP	1415630	S	7	15	22	0.00000
SRR6145059	Pseudomonas sp. LPH1	1898684	S	63	15	78	0.00001
SRR6145059	Pseudomonas sp. A214	1855331	S	5	15	20	0.00000
SRR6145059	Propionibacterium virus PHL171M01	1982297	S	83	15	98	0.00001
SRR6145059	Pontibacter korlensis	400092	S	14	1	15	0.00000
SRR6145059	Pedobacter sp. PACM 27299	1727164	S	15	1	16	0.00000
SRR6145059	Pantoea alhagi	1891675	S	15	0	15	0.00000
SRR6145059	Paenibacillus physcomitrellae	1619311	S	14	1	15	0.00000
SRR6145059	Paenibacillus chitinolyticus	79263	S	15	0	15	0.00000
SRR6145059	Paenibacillus bovis	1616788	S	15	0	15	0.00000
SRR6145059	Odoribacter splanchnicus	28118	S	14	1	15	0.00000
SRR6145059	Neorhizobium sp. SOG26	2060726	S	165	15	180	0.00002
SRR6145059	Moorea producens	1155739	S	15	0	15	0.00000
SRR6145059	Mixta theicola	1458355	S	14	1	15	0.00000
SRR6145059	Microbulbifer thermotolerans	252514	S	15	0	15	0.00000
SRR6145059	Microbacterium sp. CBA3102	2603598	S	201	15	216	0.00003
SRR6145059	Microbacteriaceae bacterium WY83	1804990	S	120	15	135	0.00002
SRR6145059	Marinithermus hydrothermalis	186192	S	15	0	15	0.00000
SRR6145059	Magnetospirillum sp. ME-1	1639348	S	45	15	60	0.00001
SRR6145059	Legionella sainthelensi	28087	S	13	2	15	0.00000
SRR6145059	Halorhabdus tiamatea	430914	S	14	1	15	0.00000
SRR6145059	Halomonas alkaliphila	272774	S	9	6	15	0.00000
SRR6145059	Halocynthiibacter arcticus	1579316	S	15	0	15	0.00000
SRR6145059	Halobacterium sp. DL1	751944	S	27	15	42	0.00000
SRR6145059	Haloarcula taiwanensis	1932004	S	13	2	15	0.00000
SRR6145059	Granulicella mallensis	940614	S	15	0	15	0.00000
SRR6145059	Gramella fulva	2126553	S	15	0	15	0.00000
SRR6145059	Flavobacterium magnum	2162713	S	15	0	15	0.00000
SRR6145059	Flammeovirga pectinis	2494373	S	15	0	15	0.00000
SRR6145059	Enterobacter sp. LU1	1848517	S	2	15	17	0.00000
SRR6145059	Ectothiorhodospira haloalkaliphila	421628	S	13	2	15	0.00000
SRR6145059	Dickeya sp. NCPPB 569	568768	S	15	1	16	0.00000
SRR6145059	Campylobacter coli	195	S	12	3	15	0.00000
SRR6145059	Calothrix parasitica	1973486	S	15	0	15	0.00000
SRR6145059	Brevibacterium sp. WO024	2697563	S	391	15	406	0.00005
SRR6145059	Bradyrhizobium sp. 1(2017)	1404888	S	85	15	100	0.00001
SRR6145059	Bordetella genomosp. 13	463040	S	96	15	111	0.00001
SRR6145059	Bacillus oceanisediminis	665099	S	15	0	15	0.00000
SRR6145059	Bacillus foraminis	279826	S	15	0	15	0.00000
SRR6145059	Bacillus coagulans	1398	S	15	0	15	0.00000
SRR6145059	Akkermansia muciniphila	239935	S	15	0	15	0.00000
SRR6145059	Actinomyces sp. 299	2057743	S	80	15	95	0.00001
SRR6145059	Actinomadura sp. WMMB499	2650775	S	211	15	226	0.00003
SRR6145059	[Clostridium] scindens	29347	S	13	1	14	0.00000
SRR6145059	Tuwongella immobilis	692036	S	14	0	14	0.00000
SRR6145059	Thermus parvatiensis	456163	S	3	11	14	0.00000
SRR6145059	Tardiphaga sp. vice154	2592814	S	1	14	15	0.00000
SRR6145059	Streptomyces sp. SAT1	1849967	S	108	14	122	0.00001
SRR6145059	Streptomyces sp. RLB1-33	2721243	S	36	14	50	0.00001
SRR6145059	Streptomyces sp. ADI95-16	1522758	S	37	14	51	0.00001
SRR6145059	Stenotrophomonas sp. ESTM1D_MKCIP4_1	2072414	S	65	14	79	0.00001
SRR6145059	Sphingobacterium sp. 21	743722	S	6	14	20	0.00000
SRR6145059	Snodgrassella alvi	1196083	S	14	0	14	0.00000
SRR6145059	Shigella dysenteriae	622	S	3	11	14	0.00000
SRR6145059	Pseudomonas sp. URMO17WK12:I11	1283291	S	22	14	36	0.00000
SRR6145059	Pseudomonas sp. St29	1500687	S	8	14	22	0.00000
SRR6145059	Pseudomonas sp. R2A2	2213057	S	23	14	37	0.00000
SRR6145059	Pseudomonas corrugata	47879	S	13	1	14	0.00000
SRR6145059	Pseudarthrobacter sp. NIBRBAC000502770	2590785	S	8	14	22	0.00000
SRR6145059	Polaribacter vadi	1774273	S	13	1	14	0.00000
SRR6145059	Planococcus rifietoensis	200991	S	12	2	14	0.00000
SRR6145059	Pirellula staleyi	125	S	14	0	14	0.00000
SRR6145059	Photobacterium gaetbulicola	1295392	S	14	0	14	0.00000
SRR6145059	Permianibacter aggregans	1510150	S	14	0	14	0.00000
SRR6145059	Paenibacillus donghaensis	414771	S	14	0	14	0.00000
SRR6145059	Novosphingobium sp. THN1	1016987	S	190	14	204	0.00002
SRR6145059	Nostoc piscinale	224012	S	13	1	14	0.00000
SRR6145059	Neisseria zalophi	640030	S	14	0	14	0.00000
SRR6145059	Natronolimnobius aegyptiacus	745377	S	13	1	14	0.00000
SRR6145059	Mucilaginibacter gotjawali	1550579	S	14	0	14	0.00000
SRR6145059	Micromonospora sp. WMMC415	2675222	S	104	14	118	0.00001
SRR6145059	Mesorhizobium sp. M7A.F.Ce.TU.012.03.2.1	2493681	S	42	14	56	0.00001
SRR6145059	Marinobacter sp. CP1	1671721	S	9	14	23	0.00000
SRR6145059	Marinobacter similis	1420916	S	14	0	14	0.00000
SRR6145059	Mageeibacillus indolicus	884684	S	14	0	14	0.00000
SRR6145059	Lysobacter sp. TY2-98	2290922	S	274	14	288	0.00003
SRR6145059	Leuconostoc carnosum	1252	S	13	1	14	0.00000
SRR6145059	Komagataeibacter oboediens	65958	S	13	1	14	0.00000
SRR6145059	Halorhodospira halochloris	1052	S	14	0	14	0.00000
SRR6145059	Haloferax alexandrinus	114529	S	6	8	14	0.00000
SRR6145059	Gramella salexigens	1913577	S	14	0	14	0.00000
SRR6145059	Geobacter metallireducens	28232	S	14	0	14	0.00000
SRR6145059	Geobacter lovleyi	313985	S	14	0	14	0.00000
SRR6145059	Geobacter bemidjiensis	225194	S	12	2	14	0.00000
SRR6145059	Flavobacterium commune	1306519	S	14	0	14	0.00000
SRR6145059	Flavobacterium arcticum	1784713	S	14	0	14	0.00000
SRR6145059	Dickeya chrysanthemi	556	S	14	0	14	0.00000
SRR6145059	Diaphorobacter sp. HDW4A	2714924	S	83	14	97	0.00001
SRR6145059	Dialister massiliensis	2161821	S	2	12	14	0.00000
SRR6145059	Desulfosarcina widdelii	947919	S	14	0	14	0.00000
SRR6145059	Cronobacter condimenti	1163710	S	13	1	14	0.00000
SRR6145059	Corynebacterium sp. LMM-1652	2487892	S	442	14	456	0.00005
SRR6145059	Corynebacterium sp. 2183	2080740	S	239	14	253	0.00003
SRR6145059	Clostridium isatidis	182773	S	14	0	14	0.00000
SRR6145059	Cellulophaga baltica	76594	S	14	0	14	0.00000
SRR6145059	Cellulophaga algicola	59600	S	13	1	14	0.00000
SRR6145059	Brevibacillus laterosporus	1465	S	9	5	14	0.00000
SRR6145059	Bernardetia litoralis	999	S	14	0	14	0.00000
SRR6145059	Belliella baltica	232259	S	14	0	14	0.00000
SRR6145059	Bacteroides zoogleoformans	28119	S	12	2	14	0.00000
SRR6145059	Bacteroides salanitronis	376805	S	14	0	14	0.00000
SRR6145059	Bacteroides intestinalis	329854	S	14	0	14	0.00000
SRR6145059	Bacteroides cellulosilyticus	246787	S	13	1	14	0.00000
SRR6145059	Bacillus pseudomycoides	64104	S	14	0	14	0.00000
SRR6145059	Bacillus paranthracis	2026186	S	4	10	14	0.00000
SRR6145059	Bacillus litoralis	152268	S	14	0	14	0.00000
SRR6145059	Arcobacter butzleri	28197	S	13	1	14	0.00000
SRR6145059	Aquiflexum balticum	280473	S	14	0	14	0.00000
SRR6145059	Aminomonas paucivorans	81412	S	14	0	14	0.00000
SRR6145059	Alcanivorax borkumensis	59754	S	2	12	14	0.00000
SRR6145059	Aeribacillus pallidus	33936	S	14	0	14	0.00000
SRR6145059	Actinomyces tangfeifanii	1912795	S	14	0	14	0.00000
SRR6145059	Actinomadura sp. WMMA1423	2591108	S	188	14	202	0.00002
SRR6145059	Acidobacterium capsulatum	33075	S	14	0	14	0.00000
SRR6145059	Acidithiobacillus ferrivorans	160808	S	13	1	14	0.00000
SRR6145059	Acetobacter aceti	435	S	14	0	14	0.00000
SRR6145059	Yersinia frederiksenii	29484	S	7	6	13	0.00000
SRR6145059	Vibrio metschnikovii	28172	S	13	0	13	0.00000
SRR6145059	Thermus scotoductus	37636	S	11	2	13	0.00000
SRR6145059	Streptomyces sp. S4.7	2705439	S	60	13	73	0.00001
SRR6145059	Streptococcus iniae	1346	S	13	0	13	0.00000
SRR6145059	Sphingorhabdus sp. YGSMI21	2077182	S	98	13	111	0.00001
SRR6145059	Sphingorhabdus sp. SMR4y	2584094	S	93	13	106	0.00001
SRR6145059	Sphingomonas sp. XS-10	2599297	S	375	13	388	0.00005
SRR6145059	Sphingomonas sp. HKS19	1813879	S	349	13	362	0.00004
SRR6145059	Sphingobium sp. EP60837	1855519	S	124	13	137	0.00002
SRR6145059	Romboutsia hominis	1507512	S	13	0	13	0.00000
SRR6145059	Rhodococcus sp. W8901	2742603	S	175	13	188	0.00002
SRR6145059	Psychrobacter sp. PRwf-1	349106	S	19	13	32	0.00000
SRR6145059	Pseudomonas sp. SXM-1	2169583	S	8	13	21	0.00000
SRR6145059	Pseudomonas sp. Lz4W	1206777	S	7	13	20	0.00000
SRR6145059	Propionibacterium virus Pacnes201215	1982270	S	70	13	83	0.00001
SRR6145059	Propionibacterium virus PHL301M00	1982301	S	27	13	40	0.00000
SRR6145059	Propionibacterium virus PHL112N00	1982285	S	15	13	28	0.00000
SRR6145059	Propionibacterium virus PHL070N00	1982279	S	55	13	68	0.00001
SRR6145059	Propionibacterium phage Enoki	1654780	S	16	13	29	0.00000
SRR6145059	Porphyromonas crevioricanis	393921	S	13	0	13	0.00000
SRR6145059	Polaromonas vacuolata	37448	S	13	0	13	0.00000
SRR6145059	Plesiomonas shigelloides	703	S	13	0	13	0.00000
SRR6145059	Petrimonas mucosa	1642646	S	13	0	13	0.00000
SRR6145059	Parageobacillus thermoglucosidasius	1426	S	13	0	13	0.00000
SRR6145059	Pandoraea sp. XY-2	2518599	S	83	13	96	0.00001
SRR6145059	Paenibacillus terrae	159743	S	12	1	13	0.00000
SRR6145059	Nitrospira japonica	1325564	S	13	0	13	0.00000
SRR6145059	Nitrosospira briensis	35799	S	13	0	13	0.00000
SRR6145059	Muribaculum intestinale	1796646	S	13	0	13	0.00000
SRR6145059	Mucilaginibacter sp. PAMC 26640	1300914	S	13	0	13	0.00000
SRR6145059	Monaibacterium sp. ALG8	2715211	S	71	13	84	0.00001
SRR6145059	Microbacterium sp. BH-3-3-3	1906742	S	241	13	254	0.00003
SRR6145059	Methanoculleus marisnigri	2198	S	13	0	13	0.00000
SRR6145059	Methanococcus aeolicus	42879	S	13	0	13	0.00000
SRR6145059	Mesorhizobium sp. M6A.T.Cr.TU.016.01.1.1	2493677	S	53	13	66	0.00001
SRR6145059	Lutibacter profundi	1622118	S	13	0	13	0.00000
SRR6145059	Lactobacillus curvatus	28038	S	12	1	13	0.00000
SRR6145059	Lachnospira eligens	39485	S	13	0	13	0.00000
SRR6145059	Kosakonia arachidis	551989	S	13	0	13	0.00000
SRR6145059	Hymenobacter sp. HDW8	2714932	S	10	13	23	0.00000
SRR6145059	Halohasta litchfieldiae	1073996	S	11	2	13	0.00000
SRR6145059	Halogeometricum borinquense	60847	S	13	0	13	0.00000
SRR6145059	Halioglobus maricola	2601894	S	13	0	13	0.00000
SRR6145059	Geminocystis herdmanii	669359	S	13	0	13	0.00000
SRR6145059	Gallaecimonas mangrovi	2291597	S	13	0	13	0.00000
SRR6145059	Flavobacterium faecale	1355330	S	13	0	13	0.00000
SRR6145059	Fictibacillus phosphorivorans	1221500	S	13	0	13	0.00000
SRR6145059	Echinicola vietnamensis	390884	S	11	2	13	0.00000
SRR6145059	Desulfovibrio alaskensis	58180	S	10	3	13	0.00000
SRR6145059	Desulfococcus oleovorans	181663	S	13	0	13	0.00000
SRR6145059	Cryobacterium sp. GCJ02	2220095	S	58	13	71	0.00001
SRR6145059	Crinalium epipsammum	241425	S	13	0	13	0.00000
SRR6145059	Corynebacterium sp. 2184	2079535	S	254	13	267	0.00003
SRR6145059	Corynebacterium sp. 2019	2675218	S	151	13	164	0.00002
SRR6145059	Clostridium argentinense	29341	S	13	0	13	0.00000
SRR6145059	Citrobacter sp. SNU WT2	2562449	S	13	1	14	0.00000
SRR6145059	Chlorobaculum tepidum	1097	S	12	1	13	0.00000
SRR6145059	Calothrix sp. PCC 7507	99598	S	13	7	20	0.00000
SRR6145059	Burkholderia sp. PAMC 28687	1795874	S	13	12	25	0.00000
SRR6145059	Bradyrhizobium sp. BTAi1	288000	S	128	13	141	0.00002
SRR6145059	Bifidobacterium thermophilum	33905	S	13	0	13	0.00000
SRR6145059	Bifidobacterium actinocoloniiforme	638619	S	13	0	13	0.00000
SRR6145059	Arenibacter algicola	616991	S	13	0	13	0.00000
SRR6145059	Alcaligenes aquatilis	323284	S	7	6	13	0.00000
SRR6145059	Actinobacillus pleuropneumoniae	715	S	8	5	13	0.00000
SRR6145059	Undibacterium parvum	401471	S	12	0	12	0.00000
SRR6145059	Treponema phagedenis	162	S	12	0	12	0.00000
SRR6145059	Tolypothrix sp. PCC 7910	2099387	S	12	5	17	0.00000
SRR6145059	Thermus brockianus	56956	S	11	1	12	0.00000
SRR6145059	Thermoanaerobacterium thermosaccharolyticum	1517	S	11	1	12	0.00000
SRR6145059	Terriglobus saanensis	870903	S	12	0	12	0.00000
SRR6145059	Streptomyces sp. PAMC 26508	1265601	S	12	84	96	0.00001
SRR6145059	Streptomyces sp. CdTB01	1725411	S	104	12	116	0.00001
SRR6145059	Streptococcus sp. NCTC 10228	2583585	S	12	6	18	0.00000
SRR6145059	Sporosarcina pasteurii	1474	S	11	1	12	0.00000
SRR6145059	Sodalis glossinidius	63612	S	12	0	12	0.00000
SRR6145059	Shimwellia blattae	563	S	12	0	12	0.00000
SRR6145059	Shewanella sp. ANA-3	94122	S	28	12	40	0.00000
SRR6145059	Serratia sp. LS-1	2485839	S	2	12	14	0.00000
SRR6145059	Serratia proteamaculans	28151	S	10	2	12	0.00000
SRR6145059	Saccharospirillum mangrovi	2161747	S	12	0	12	0.00000
SRR6145059	Robiginitalea biformata	252307	S	12	0	12	0.00000
SRR6145059	Rhodopirellula baltica	265606	S	12	0	12	0.00000
SRR6145059	Rhodoferax sp. BAB1	2741720	S	145	12	157	0.00002
SRR6145059	Rhodococcus sp. MTM3W5.2	1805827	S	207	12	219	0.00003
SRR6145059	Pseudomonas sp. THAF7b	2587845	S	15	12	27	0.00000
SRR6145059	Pseudomonas avellanae	46257	S	1	11	12	0.00000
SRR6145059	Pseudodesulfovibrio profundus	57320	S	10	2	12	0.00000
SRR6145059	Pseudoalteromonas luteoviolacea	43657	S	12	0	12	0.00000
SRR6145059	Propionibacterium virus PHL179M00	1982298	S	13	12	25	0.00000
SRR6145059	Propionibacterium virus PAS50	1982272	S	13	12	25	0.00000
SRR6145059	Propionibacterium virus PAD20	1982271	S	13	12	25	0.00000
SRR6145059	Pontimonas salivibrio	1159327	S	12	0	12	0.00000
SRR6145059	Polaribacter reichenbachii	996801	S	11	1	12	0.00000
SRR6145059	Planctopirus limnophila	120	S	12	0	12	0.00000
SRR6145059	Planctomycetes bacterium Mal33	2527992	S	8	12	20	0.00000
SRR6145059	Piscirickettsia salmonis	1238	S	12	0	12	0.00000
SRR6145059	Oscillibacter sp. PEA192	2109687	S	6	12	18	0.00000
SRR6145059	Oscillatoria nigro-viridis	482564	S	12	0	12	0.00000
SRR6145059	Nonlabens marinus	930802	S	12	0	12	0.00000
SRR6145059	Nonlabens dokdonensis	328515	S	12	0	12	0.00000
SRR6145059	Nitrosomonas communis	44574	S	12	0	12	0.00000
SRR6145059	Ndongobacter massiliensis	1871025	S	11	1	12	0.00000
SRR6145059	Natronorubrum bangense	61858	S	11	1	12	0.00000
SRR6145059	Natronomonas pharaonis	2257	S	12	0	12	0.00000
SRR6145059	Mucinivorans hirudinis	1433126	S	12	0	12	0.00000
SRR6145059	Moritella yayanosii	69539	S	12	0	12	0.00000
SRR6145059	Moraxella cuniculi	34061	S	12	0	12	0.00000
SRR6145059	Moorella thermoacetica	1525	S	12	0	12	0.00000
SRR6145059	Methylomonas sp. DH-1	1727196	S	5	12	17	0.00000
SRR6145059	Methylocystis sp. SC2	187303	S	40	12	52	0.00001
SRR6145059	Legionella longbeachae	450	S	10	2	12	0.00000
SRR6145059	Kyrpidia spormannii	2055160	S	9	3	12	0.00000
SRR6145059	Ktedonosporobacter rubrisoli	2509675	S	12	0	12	0.00000
SRR6145059	Kordia antarctica	1218801	S	12	0	12	0.00000
SRR6145059	Kangiella koreensis	261964	S	12	0	12	0.00000
SRR6145059	Halomonas sp. hl-4	1761789	S	3	12	15	0.00000
SRR6145059	Frederiksenia canicola	123824	S	12	0	12	0.00000
SRR6145059	Formosa agariphila	320324	S	12	0	12	0.00000
SRR6145059	Ephemeroptericola cinctiostellae	2268024	S	12	0	12	0.00000
SRR6145059	Enterococcus durans	53345	S	11	1	12	0.00000
SRR6145059	Enterobacter sp. 18A13	2565914	S	4	12	16	0.00000
SRR6145059	Enterobacter oligotrophica	2478464	S	12	0	12	0.00000
SRR6145059	Elizabethkingia sp. 2-6	2575699	S	18	12	30	0.00000
SRR6145059	Echinicola rosea	1807691	S	10	2	12	0.00000
SRR6145059	Dolichospermum flos-aquae	1166	S	2	10	12	0.00000
SRR6145059	Dickeya sp. MK7	1224145	S	2	12	14	0.00000
SRR6145059	Desulfomicrobium orale	132132	S	12	0	12	0.00000
SRR6145059	Desulfoglaeba alkanexedens	361111	S	12	0	12	0.00000
SRR6145059	Cytophagales bacterium TFI 002	1945892	S	12	1	13	0.00000
SRR6145059	Cyclobacterium amurskyense	320787	S	11	1	12	0.00000
SRR6145059	Clostridium ljungdahlii	1538	S	4	8	12	0.00000
SRR6145059	Clostridium aceticum	84022	S	12	0	12	0.00000
SRR6145059	Chlorobium limicola	1092	S	12	0	12	0.00000
SRR6145059	Cellvibrio sp. KY-GH-1	2303332	S	161	12	173	0.00002
SRR6145059	Burkholderia sp. MSMB0856	1637869	S	92	12	104	0.00001
SRR6145059	Burkholderia latens	488446	S	10	2	12	0.00000
SRR6145059	Brevibacillus agri	51101	S	12	0	12	0.00000
SRR6145059	Bradyrhizobiaceae bacterium SG-6C	709797	S	102	12	114	0.00001
SRR6145059	Bordetella parapertussis	519	S	2	10	12	0.00000
SRR6145059	Bacillus altitudinis	293387	S	6	6	12	0.00000
SRR6145059	Arthrobacter sp. FB24	290399	S	78	12	90	0.00001
SRR6145059	Arthrobacter citreus	1670	S	12	0	12	0.00000
SRR6145059	Arcobacter defluvii	873191	S	6	6	12	0.00000
SRR6145059	Antarcticibacterium flavum	2058175	S	12	0	12	0.00000
SRR6145059	Anseongella ginsenosidimutans	496056	S	12	0	12	0.00000
SRR6145059	Anaerolinea thermophila	167964	S	12	0	12	0.00000
SRR6145059	Agromyces sp. HY052	2585717	S	103	12	115	0.00001
SRR6145059	Advenella mimigardefordensis	302406	S	12	0	12	0.00000
SRR6145059	Acetobacter tropicalis	104102	S	8	4	12	0.00000
SRR6145059	Yersinia pseudotuberculosis	633	S	8	3	11	0.00000
SRR6145059	Weissella jogaejeotgali	1631871	S	11	0	11	0.00000
SRR6145059	Virgibacillus halodenitrificans	1482	S	9	2	11	0.00000
SRR6145059	Vibrio owensii	696485	S	9	2	11	0.00000
SRR6145059	Vagococcus teuberi	519472	S	11	0	11	0.00000
SRR6145059	Tolumonas auensis	43948	S	11	0	11	0.00000
SRR6145059	Thermomicrobium roseum	500	S	11	0	11	0.00000
SRR6145059	Tenacibaculum maritimum	107401	S	11	0	11	0.00000
SRR6145059	Sulfitobacter sp. D7	1968541	S	46	11	57	0.00001
SRR6145059	Streptosporangium sp. 'caverna'	2202249	S	143	11	154	0.00002
SRR6145059	Streptomyces sp. fd1-xmd	1812480	S	72	11	83	0.00001
SRR6145059	Streptomyces sp. Z423-1	2730915	S	101	11	112	0.00001
SRR6145059	Streptomyces sp. S1A1-7	2594459	S	2	11	13	0.00000
SRR6145059	Streptococcus lutetiensis	150055	S	2	9	11	0.00000
SRR6145059	Staphylococcus phage IME-SA4	1610872	S	4	11	15	0.00000
SRR6145059	Sporomusa termitida	2377	S	11	0	11	0.00000
SRR6145059	Spiribacter salinus	1335746	S	11	0	11	0.00000
SRR6145059	Selenomonas ruminantium	971	S	11	0	11	0.00000
SRR6145059	Scytonema sp. NIES-4073	2005464	S	31	11	42	0.00000
SRR6145059	Salinivibrio sp. YCSC6	2003370	S	12	11	23	0.00000
SRR6145059	Rufibacter tibetensis	512763	S	10	1	11	0.00000
SRR6145059	Roseburia intestinalis	166486	S	10	1	11	0.00000
SRR6145059	Pseudomonas granadensis	1421430	S	8	3	11	0.00000
SRR6145059	Pseudomonas fuscovaginae	50340	S	8	3	11	0.00000
SRR6145059	Pseudoarcobacter acticola	1849015	S	11	0	11	0.00000
SRR6145059	Pseudoalteromonas sp. SM9913	234831	S	3	11	14	0.00000
SRR6145059	Pseudoalteromonas piscicida	43662	S	10	1	11	0.00000
SRR6145059	Propionibacterium virus SKKY	1982305	S	10	11	21	0.00000
SRR6145059	Propionibacterium virus Kubed	1982256	S	28	11	39	0.00000
SRR6145059	Planctomycetes bacterium Pan258	2527981	S	11	11	22	0.00000
SRR6145059	Photobacterium damselae	38293	S	11	0	11	0.00000
SRR6145059	Pelobacter propionicus	29543	S	10	1	11	0.00000
SRR6145059	Pelobacter carbinolicus	19	S	11	0	11	0.00000
SRR6145059	Pedobacter heparinus	984	S	11	0	11	0.00000
SRR6145059	Parasaccharibacter apium	1510841	S	11	0	11	0.00000
SRR6145059	Paenibacillus psychroresistens	1778678	S	11	0	11	0.00000
SRR6145059	Paenibacillus ihbetae	1870820	S	11	0	11	0.00000
SRR6145059	Oleiphilus messinensis	141451	S	11	0	11	0.00000
SRR6145059	Octadecabacter temperatus	1458307	S	11	0	11	0.00000
SRR6145059	Nonomuraea sp. WYY166	2656914	S	205	11	216	0.00003
SRR6145059	Nitrosospira multiformis	1231	S	11	0	11	0.00000
SRR6145059	Muricauda ruestringensis	111501	S	10	1	11	0.00000
SRR6145059	Moraxella ovis	29433	S	7	4	11	0.00000
SRR6145059	Microbacterium sp. 4R-513	2567934	S	250	11	261	0.00003
SRR6145059	Methylophilus medardicus	2588534	S	11	0	11	0.00000
SRR6145059	Metallosphaera tengchongensis	1532350	S	11	0	11	0.00000
SRR6145059	Maribacter cobaltidurans	1178778	S	11	0	11	0.00000
SRR6145059	Luteimonas sp. JM171	1896164	S	197	11	208	0.00002
SRR6145059	Leptospira interrogans	173	S	11	0	11	0.00000
SRR6145059	Leclercia sp. 119287	2681308	S	7	11	18	0.00000
SRR6145059	Lactobacillus parabuchneri	152331	S	11	0	11	0.00000
SRR6145059	Laceyella sacchari	37482	S	11	0	11	0.00000
SRR6145059	Kurthia zopfii	1650	S	11	0	11	0.00000
SRR6145059	Jeotgalibaca ciconiae	2496265	S	11	0	11	0.00000
SRR6145059	Heliobacterium modesticaldum	35701	S	11	0	11	0.00000
SRR6145059	Halothiobacillus neapolitanus	927	S	11	0	11	0.00000
SRR6145059	Halomonas venusta	44935	S	10	1	11	0.00000
SRR6145059	Halomonas sp. NBT06E8	2609667	S	191	11	202	0.00002
SRR6145059	Halomonas sp. AM6	2661553	S	16	11	27	0.00000
SRR6145059	Halodesulfurarchaeum formicicum	1873524	S	11	0	11	0.00000
SRR6145059	Haemophilus aegyptius	197575	S	1	10	11	0.00000
SRR6145059	Gynuella sunshinyii	1445505	S	11	0	11	0.00000
SRR6145059	Georgenia sp. Z294	2585135	S	188	11	199	0.00002
SRR6145059	Geobacter uraniireducens	351604	S	11	0	11	0.00000
SRR6145059	Erythrobacter sp. THAF29	2587851	S	59	11	70	0.00001
SRR6145059	Erythrobacter sp. HL-111	1798193	S	131	11	142	0.00002
SRR6145059	Erwinia tasmaniensis	338565	S	11	0	11	0.00000
SRR6145059	Enterococcus hirae	1354	S	11	0	11	0.00000
SRR6145059	Duganella sp. AF9R3	2728021	S	156	11	167	0.00002
SRR6145059	Dickeya dianthicola	204039	S	8	3	11	0.00000
SRR6145059	Cronobacter muytjensii	413501	S	4	7	11	0.00000
SRR6145059	Congregibacter litoralis	393662	S	11	0	11	0.00000
SRR6145059	Clostridium chauvoei	46867	S	11	0	11	0.00000
SRR6145059	Chryseobacterium sp. POL2	2713414	S	136	11	147	0.00002
SRR6145059	Chryseobacterium sp. 6424	2039166	S	250	11	261	0.00003
SRR6145059	Chloracidobacterium thermophilum	458033	S	11	0	11	0.00000
SRR6145059	Chamaesiphon minutus	1173032	S	11	0	11	0.00000
SRR6145059	Cellulosimicrobium sp. BI34T	2587808	S	114	11	125	0.00001
SRR6145059	Campylobacter hominis	76517	S	11	0	11	0.00000
SRR6145059	Calothrix parietina	32054	S	11	0	11	0.00000
SRR6145059	Burkholderia sp. MSMB0852	1637841	S	19	11	30	0.00000
SRR6145059	Bradyrhizobium sp. CCGE-LA001	1223566	S	73	11	84	0.00001
SRR6145059	Bordetella genomosp. 6	463024	S	10	11	21	0.00000
SRR6145059	Bifidobacterium angulatum	1683	S	11	0	11	0.00000
SRR6145059	Bacillus pseudofirmus	79885	S	11	0	11	0.00000
SRR6145059	Bacillus filamentosus	1402861	S	11	0	11	0.00000
SRR6145059	Bacillus ciccensis	1670641	S	11	0	11	0.00000
SRR6145059	Azoarcus sp. DD4	2027405	S	102	11	113	0.00001
SRR6145059	Avibacterium paragallinarum	728	S	11	0	11	0.00000
SRR6145059	Arcobacter halophilus	197482	S	10	1	11	0.00000
SRR6145059	Aneurinibacillus soli	1500254	S	11	0	11	0.00000
SRR6145059	Aeromonas sp. 1805	2560028	S	5	11	16	0.00000
SRR6145059	Acinetobacter sp. 10FS3-1	2563897	S	61	11	72	0.00001
SRR6145059	Acetobacter ascendens	481146	S	7	4	11	0.00000
SRR6145059	Yersinia kristensenii	28152	S	2	8	10	0.00000
SRR6145059	Xenorhabdus bovienii	40576	S	10	0	10	0.00000
SRR6145059	Vibrio nigripulchritudo	28173	S	10	0	10	0.00000
SRR6145059	Vibrio casei	673372	S	10	0	10	0.00000
SRR6145059	Tumebacillus avium	1903704	S	10	0	10	0.00000
SRR6145059	Thermus caldilimi	2483360	S	9	1	10	0.00000
SRR6145059	Thermoproteus uzoniensis	184117	S	10	0	10	0.00000
SRR6145059	Thermogutta terrifontis	1331910	S	10	0	10	0.00000
SRR6145059	Tenacibaculum dicentrarchi	669041	S	10	0	10	0.00000
SRR6145059	Synechococcus sp. WH 8101	59932	S	10	0	10	0.00000
SRR6145059	Streptomyces sp. TN58	234612	S	66	10	76	0.00001
SRR6145059	Streptomyces sp. QHH-9511	2684468	S	90	10	100	0.00001
SRR6145059	Streptomyces sp. P3	2135430	S	103	10	113	0.00001
SRR6145059	Streptomyces sp. M2	646637	S	95	10	105	0.00001
SRR6145059	Streptomyces sp. 3214.6	1882757	S	76	10	86	0.00001
SRR6145059	Streptococcus urinalis	149016	S	10	0	10	0.00000
SRR6145059	Streptococcus ferus	1345	S	10	0	10	0.00000
SRR6145059	Sinorhizobium sp. RAC02	1842534	S	131	10	141	0.00002
SRR6145059	Salmonella bongori	54736	S	10	0	10	0.00000
SRR6145059	Salinivirga cyanobacteriivorans	1307839	S	10	0	10	0.00000
SRR6145059	Salegentibacter salegens	143223	S	10	0	10	0.00000
SRR6145059	Rippkaea orientalis	2546366	S	10	0	10	0.00000
SRR6145059	Rhizobium sp. CIAT894	2020312	S	42	10	52	0.00001
SRR6145059	Psychromonas ingrahamii	357794	S	10	0	10	0.00000
SRR6145059	Psychrobacter sp. YP14	2203895	S	14	10	24	0.00000
SRR6145059	Pseudomonas sp. NC02	2067572	S	6	10	16	0.00000
SRR6145059	Pseudomonas sp. MYb193	1827300	S	12	10	22	0.00000
SRR6145059	Pseudomonas sp. MRSN12121	1611770	S	10	10	20	0.00000
SRR6145059	Pseudomonas sp. DR 5-09	1534110	S	10	4	14	0.00000
SRR6145059	Polynucleobacter asymbioticus	576611	S	10	0	10	0.00000
SRR6145059	Planktomarina temperata	1284658	S	10	0	10	0.00000
SRR6145059	Planctomycetes bacterium V6	2528030	S	9	10	19	0.00000
SRR6145059	Pedobacter cryoconitis	188932	S	10	0	10	0.00000
SRR6145059	Paenibacillus sp. FSL R7-0331	1536773	S	10	0	10	0.00000
SRR6145059	Paenibacillus sp. FSL R7-0273	1536772	S	10	0	10	0.00000
SRR6145059	Paenibacillus sp. FSL H7-0357	1536774	S	10	0	10	0.00000
SRR6145059	Paenibacillus naphthalenovorans	162209	S	10	0	10	0.00000
SRR6145059	Oblitimonas alkaliphila	1697053	S	10	0	10	0.00000
SRR6145059	Nitrospira defluvii	330214	S	10	0	10	0.00000
SRR6145059	Nitrosomonas ureae	44577	S	10	0	10	0.00000
SRR6145059	Neorhizobium sp. NCHU2750	1825976	S	102	10	112	0.00001
SRR6145059	Myroides odoratus	256	S	10	0	10	0.00000
SRR6145059	Mycoplasma capricolum	2095	S	9	1	10	0.00000
SRR6145059	Mycobacterium sp. MS1601	1936029	S	242	10	252	0.00003
SRR6145059	Mycobacterium leprae	1769	S	10	0	10	0.00000
SRR6145059	Methylosinus sp. C49	2699395	S	74	10	84	0.00001
SRR6145059	Methylomonas koyamae	702114	S	3	7	10	0.00000
SRR6145059	Methanosaeta harundinacea	301375	S	10	0	10	0.00000
SRR6145059	Methanofollis liminatans	2201	S	10	0	10	0.00000
SRR6145059	Massilistercora timonensis	2086584	S	9	1	10	0.00000
SRR6145059	Marinirhabdus gelatinilytica	1703343	S	10	0	10	0.00000
SRR6145059	Mannheimia varigena	85404	S	10	0	10	0.00000
SRR6145059	Leifsonia sp. PS1209	2724914	S	99	10	109	0.00001
SRR6145059	Legionella geestiana	45065	S	10	0	10	0.00000
SRR6145059	Lactobacillus rhamnosus	47715	S	10	0	10	0.00000
SRR6145059	Lactobacillus paragasseri	2107999	S	6	4	10	0.00000
SRR6145059	Lactobacillus allii	1847728	S	10	0	10	0.00000
SRR6145059	Jeotgalibaca dankookensis	708126	S	10	0	10	0.00000
SRR6145059	Hungatella hathewayi	154046	S	10	0	10	0.00000
SRR6145059	Humibacter sp. WJ7-1	2599293	S	144	10	154	0.00002
SRR6145059	Hathewaya histolytica	1498	S	9	1	10	0.00000
SRR6145059	Haloarcula sp. CBA1115	1592728	S	1	10	11	0.00000
SRR6145059	Halarcobacter bivalviorum	663364	S	10	0	10	0.00000
SRR6145059	Faecalitalea cylindroides	39483	S	9	1	10	0.00000
SRR6145059	Escherichia albertii	208962	S	8	2	10	0.00000
SRR6145059	Erysipelothrix rhusiopathiae	1648	S	10	0	10	0.00000
SRR6145059	Enterococcus wangshanyuanii	2005703	S	10	0	10	0.00000
SRR6145059	Enterococcus sp. HSIEG1	1316414	S	2	10	12	0.00000
SRR6145059	Enterococcus gilvus	160453	S	10	0	10	0.00000
SRR6145059	Enterobacter sp. N18-03635	2500132	S	8	10	18	0.00000
SRR6145059	Endozoicomonas montiporae	1027273	S	10	0	10	0.00000
SRR6145059	Dehalogenimonas lykanthroporepellens	552810	S	10	0	10	0.00000
SRR6145059	Corynebacterium phage Lederberg	2588502	S	1	10	11	0.00000
SRR6145059	Coraliomargarita akajimensis	395922	S	10	0	10	0.00000
SRR6145059	Clostridium sp. SYSU GA15002T	2587161	S	10	0	10	0.00000
SRR6145059	Clostridium kluyveri	1534	S	10	0	10	0.00000
SRR6145059	Clostridium carboxidivorans	217159	S	10	0	10	0.00000
SRR6145059	Christensenella minuta	626937	S	10	0	10	0.00000
SRR6145059	Chlorobaculum limnaeum	274537	S	10	0	10	0.00000
SRR6145059	Candidatus Pelagibacter sp. RS40	1977865	S	10	0	10	0.00000
SRR6145059	Bythopirellula goksoyri	1400387	S	10	0	10	0.00000
SRR6145059	Burkholderia sp. MSMB617WGS	1637831	S	14	10	24	0.00000
SRR6145059	Burkholderia mallei	13373	S	3	7	10	0.00000
SRR6145059	Brucella suis	29461	S	1	9	10	0.00000
SRR6145059	Brevibacillus sp. SCSIO 07484	2496837	S	10	0	10	0.00000
SRR6145059	Brachyspira hyodysenteriae	159	S	9	1	10	0.00000
SRR6145059	Blattabacterium sp. (Blattella germanica)	624186	S	10	0	10	0.00000
SRR6145059	Bacillus vallismortis	72361	S	9	1	10	0.00000
SRR6145059	Bacillus simplex	1478	S	10	0	10	0.00000
SRR6145059	Bacillus butanolivorans	421767	S	10	0	10	0.00000
SRR6145059	Bacillus aryabhattai	412384	S	3	7	10	0.00000
SRR6145059	Arcanobacterium phocae	131112	S	8	2	10	0.00000
SRR6145059	Aliiarcobacter faecis	1564138	S	10	0	10	0.00000
SRR6145059	Algoriphagus machipongonensis	388413	S	10	0	10	0.00000
SRR6145059	Algibacter alginicilyticus	1736674	S	10	0	10	0.00000
SRR6145059	Akkermansia glycaniphila	1679444	S	10	0	10	0.00000
SRR6145059	Actinomyces sp. 2129	2321394	S	57	10	67	0.00001
SRR6145059	Acidovorax sp. HDW3	2714923	S	120	10	130	0.00002
SRR6145059	Acetobacter senegalensis	446692	S	7	3	10	0.00000
SRR6145059	Acetoanaerobium sticklandii	1511	S	10	0	10	0.00000
SRR6145059	halophilic archaeon DL31	756883	S	19	9	28	0.00000
SRR6145059	Zhongshania aliphaticivorans	1470434	S	9	0	9	0.00000
SRR6145059	Yangia sp. CCB-MM3	1792508	S	96	9	105	0.00001
SRR6145059	Xenorhabdus poinarii	40577	S	9	0	9	0.00000
SRR6145059	Vibrio ponticus	265668	S	9	0	9	0.00000
SRR6145059	Turneriella parva	29510	S	9	0	9	0.00000
SRR6145059	Tumebacillus algifaecis	1214604	S	9	0	9	0.00000
SRR6145059	Thermosipho melanesiensis	46541	S	9	0	9	0.00000
SRR6145059	Thermoanaerobacter siderophilus	106578	S	1	8	9	0.00000
SRR6145059	Tetragenococcus koreensis	290335	S	9	0	9	0.00000
SRR6145059	Tenacibaculum todarodis	1850252	S	9	0	9	0.00000
SRR6145059	Tenacibaculum jejuense	584609	S	9	0	9	0.00000
SRR6145059	Synechococcus sp. WH 7803	32051	S	9	0	9	0.00000
SRR6145059	Sulfitobacter sp. SK025	1389011	S	38	9	47	0.00001
SRR6145059	Streptomyces sp. Z022	1442032	S	77	9	86	0.00001
SRR6145059	Streptomyces sp. T44	2686304	S	76	9	85	0.00001
SRR6145059	Streptomyces sp. RLB3-17	2594455	S	1	9	10	0.00000
SRR6145059	Streptomyces sp. QMT-28	2662397	S	77	9	86	0.00001
SRR6145059	Streptomyces sp. HM190	2695266	S	88	9	97	0.00001
SRR6145059	Streptomyces sp. GY16	2653200	S	100	9	109	0.00001
SRR6145059	Streptomyces sp. GS7	2692234	S	93	9	102	0.00001
SRR6145059	Streptococcus himalayensis	1888195	S	9	0	9	0.00000
SRR6145059	Streptococcus acidominimus	1326	S	9	0	9	0.00000
SRR6145059	Sterolibacteriaceae bacterium M52	2496847	S	34	9	43	0.00001
SRR6145059	Staphylococcus virus Rodi	1980962	S	7	9	16	0.00000
SRR6145059	Staphylococcus delphini	53344	S	9	0	9	0.00000
SRR6145059	Stanieria cyanosphaera	102116	S	8	1	9	0.00000
SRR6145059	Spirosoma sp. BT328	2692134	S	17	9	26	0.00000
SRR6145059	Spirochaeta africana	46355	S	9	0	9	0.00000
SRR6145059	Sphingomonas sp. AP4-R1	2735134	S	284	9	293	0.00003
SRR6145059	Shewanella marisflavi	260364	S	9	0	9	0.00000
SRR6145059	Scytonema sp. HK-05	1137095	S	29	9	38	0.00000
SRR6145059	Scardovia inopinata	78259	S	9	0	9	0.00000
SRR6145059	Salinimonas lutimaris	914153	S	9	0	9	0.00000
SRR6145059	Saccharopolyspora sp. ASAGF58	2719023	S	149	9	158	0.00002
SRR6145059	Rummeliibacillus stabekisii	241244	S	9	0	9	0.00000
SRR6145059	Rickettsia amblyommatis	33989	S	7	2	9	0.00000
SRR6145059	Rhodococcus sp. X156	2499145	S	164	9	173	0.00002
SRR6145059	Rhodobacteraceae bacterium QY30	2033435	S	224	9	233	0.00003
SRR6145059	Pseudomonas sp. RU47	2005388	S	6	9	15	0.00000
SRR6145059	Pseudomonas sp. R4-35-07	658643	S	2	9	11	0.00000
SRR6145059	Pseudomonas sp. R2-60-08W	1173280	S	2	9	11	0.00000
SRR6145059	Pseudomonas sp. B14-6	2738843	S	5	9	14	0.00000
SRR6145059	Pseudoalteromonas tetraodonis	43659	S	2	7	9	0.00000
SRR6145059	Providencia stuartii	588	S	8	1	9	0.00000
SRR6145059	Proteus cibarius	626774	S	6	3	9	0.00000
SRR6145059	Propionibacterium virus PHL114L00	1982287	S	40	9	49	0.00001
SRR6145059	Propionibacterium virus P105	1982261	S	8	9	17	0.00000
SRR6145059	Propionibacterium virus P100A	1982265	S	63	9	72	0.00001
SRR6145059	Planococcus plakortidis	1038856	S	8	1	9	0.00000
SRR6145059	Planctomycetes bacterium MalM14	2527997	S	3	9	12	0.00000
SRR6145059	Pectobacterium parmentieri	1905730	S	7	2	9	0.00000
SRR6145059	Paraphotobacterium marinum	1755811	S	9	0	9	0.00000
SRR6145059	Pandoravirus dulcis	1349409	S	9	0	9	0.00000
SRR6145059	Paenibacillus stellifer	169760	S	9	0	9	0.00000
SRR6145059	Paenibacillus sp. FSL P4-0081	1536769	S	9	3	12	0.00000
SRR6145059	Paenibacillus sp. B01	2660554	S	66	9	75	0.00001
SRR6145059	Paenibacillus graminis	189425	S	8	1	9	0.00000
SRR6145059	Nostoc sphaeroides	446679	S	6	3	9	0.00000
SRR6145059	Nitrosococcus watsonii	473531	S	8	1	9	0.00000
SRR6145059	Nitratireductor sp. SY7	2599600	S	99	9	108	0.00001
SRR6145059	Nitratifractor salsuginis	269261	S	9	0	9	0.00000
SRR6145059	Neisseriaceae bacterium DSM 100970	2052837	S	9	0	9	0.00000
SRR6145059	Muricauda lutaonensis	516051	S	9	0	9	0.00000
SRR6145059	Mucilaginibacter xinganensis	1234841	S	9	0	9	0.00000
SRR6145059	Microcystis aeruginosa	1126	S	7	2	9	0.00000
SRR6145059	Methylophaga frappieri	754477	S	9	0	9	0.00000
SRR6145059	Megasphaera elsdenii	907	S	8	1	9	0.00000
SRR6145059	Lysinibacillus timonensis	2086577	S	9	0	9	0.00000
SRR6145059	Listeria seeligeri	1640	S	9	0	9	0.00000
SRR6145059	Lactococcus petauri	1940789	S	8	1	9	0.00000
SRR6145059	Lactobacillus paraplantarum	60520	S	9	0	9	0.00000
SRR6145059	Lactobacillus harbinensis	304207	S	9	0	9	0.00000
SRR6145059	Lactobacillus curieae	1138822	S	9	0	9	0.00000
SRR6145059	Klebsiella sp. LY	2015795	S	1	9	10	0.00000
SRR6145059	Hymenobacter sp. BRD72	2615203	S	26	9	35	0.00000
SRR6145059	Hydrogenovibrio crunogenus	39765	S	9	0	9	0.00000
SRR6145059	Herminiimonas arsenitoxidans	1809410	S	8	1	9	0.00000
SRR6145059	Halomonas sp. THAF12	2587849	S	53	9	62	0.00001
SRR6145059	Halomicronema hongdechloris	1209493	S	9	0	9	0.00000
SRR6145059	Halobacteriovorax marinus	97084	S	9	0	9	0.00000
SRR6145059	Hahella chejuensis	158327	S	8	1	9	0.00000
SRR6145059	Gramella forsetii	411153	S	9	0	9	0.00000
SRR6145059	Gilliamella apicola	1196095	S	9	0	9	0.00000
SRR6145059	Geobacillus thermodenitrificans	33940	S	9	0	9	0.00000
SRR6145059	Fusobacterium mortiferum	850	S	9	0	9	0.00000
SRR6145059	Fusobacterium gonidiaformans	849	S	9	0	9	0.00000
SRR6145059	Flavobacterium crassostreae	1763534	S	9	0	9	0.00000
SRR6145059	Fabibacter pacificus	1267423	S	9	0	9	0.00000
SRR6145059	Exiguobacterium sibiricum	332410	S	9	0	9	0.00000
SRR6145059	Escherichia marmotae	1499973	S	8	1	9	0.00000
SRR6145059	Erythrobacter sp. HKB08	2502843	S	117	9	126	0.00001
SRR6145059	Erwinia pyrifoliae	79967	S	4	5	9	0.00000
SRR6145059	Enterobacter sp. E76	2596949	S	37	9	46	0.00001
SRR6145059	Desulfohalobium retbaense	45663	S	9	0	9	0.00000
SRR6145059	Desulfobacter hydrogenophilus	2291	S	7	2	9	0.00000
SRR6145059	Desulfitobacterium hafniense	49338	S	9	0	9	0.00000
SRR6145059	Dactylococcopsis salina	292566	S	8	1	9	0.00000
SRR6145059	Cronobacter universalis	535744	S	7	2	9	0.00000
SRR6145059	Clostridium sp. MF28	1702238	S	3	9	12	0.00000
SRR6145059	Clostridium scatologenes	1548	S	8	1	9	0.00000
SRR6145059	Clostridium novyi	1542	S	9	0	9	0.00000
SRR6145059	Clostridium drakei	332101	S	8	1	9	0.00000
SRR6145059	Clostridium diolis	223919	S	2	7	9	0.00000
SRR6145059	Citrobacter sp. LUTT5	2697370	S	1	9	10	0.00000
SRR6145059	Chryseobacterium sp. G0186	2487064	S	58	9	67	0.00001
SRR6145059	Changchengzhania lutea	2049305	S	9	0	9	0.00000
SRR6145059	Caminibacter mediatlanticus	291048	S	9	0	9	0.00000
SRR6145059	Butyrivibrio proteoclasticus	43305	S	9	0	9	0.00000
SRR6145059	Brucella melitensis	29459	S	1	8	9	0.00000
SRR6145059	Brachyspira intermedia	84377	S	9	0	9	0.00000
SRR6145059	Bacteroides helcogenes	290053	S	9	0	9	0.00000
SRR6145059	Bacteroides coprosuis	151276	S	9	0	9	0.00000
SRR6145059	Bacillus weihaiensis	1547283	S	9	0	9	0.00000
SRR6145059	Bacillus mycoides	1405	S	8	1	9	0.00000
SRR6145059	Bacillus glycinifermentans	1664069	S	9	0	9	0.00000
SRR6145059	Bacillus cellulosilyticus	1413	S	9	0	9	0.00000
SRR6145059	Aurantimicrobium minutum	708131	S	7	2	9	0.00000
SRR6145059	Arcobacter lekithochrous	1904463	S	9	0	9	0.00000
SRR6145059	Arcobacter cryaerophilus	28198	S	8	1	9	0.00000
SRR6145059	Antarcticibacterium sp. PAMC 28998	2585771	S	9	0	9	0.00000
SRR6145059	Algoriphagus sanaruensis	1727163	S	9	0	9	0.00000
SRR6145059	Aeromonas rivipollensis	948519	S	4	5	9	0.00000
SRR6145059	Acidithiobacillus ferrooxidans	920	S	6	3	9	0.00000
SRR6145059	Acidaminococcus intestini	187327	S	9	0	9	0.00000
SRR6145059	Acetobacter sp. KACC 21233	2592655	S	9	0	9	0.00000
SRR6145059	[Eubacterium] cellulosolvens	29322	S	8	0	8	0.00000
SRR6145059	[Clostridium] ultunense	45497	S	8	0	8	0.00000
SRR6145059	Zunongwangia profunda	398743	S	8	0	8	0.00000
SRR6145059	Zobellia galactanivorans	63186	S	8	0	8	0.00000
SRR6145059	Yersinia pestis	632	S	3	5	8	0.00000
SRR6145059	Vibrio tritonius	1435069	S	8	0	8	0.00000
SRR6145059	Vibrio panuliri	1381081	S	8	0	8	0.00000
SRR6145059	Vibrio natriegens	691	S	5	3	8	0.00000
SRR6145059	Vibrio cincinnatiensis	675	S	8	0	8	0.00000
SRR6145059	Variovorax sp. HW608	1034889	S	219	8	227	0.00003
SRR6145059	Vagococcus penaei	633807	S	8	0	8	0.00000
SRR6145059	Trichormus variabilis	264691	S	2	6	8	0.00000
SRR6145059	Treponema brennaborense	81028	S	8	0	8	0.00000
SRR6145059	Thioploca ingrica	40754	S	8	0	8	0.00000
SRR6145059	Thermus oshimai	56957	S	8	0	8	0.00000
SRR6145059	Thermacetogenium phaeum	85874	S	8	0	8	0.00000
SRR6145059	Thauera sp. K11	2005884	S	95	8	103	0.00001
SRR6145059	Tessaracoccus sp. T2.5-30	1909732	S	150	8	158	0.00002
SRR6145059	Tepidanaerobacter acetatoxydans	499229	S	8	0	8	0.00000
SRR6145059	Tatlockia micdadei	451	S	8	0	8	0.00000
SRR6145059	Synechococcus sp. PCC 7336	195250	S	8	0	8	0.00000
SRR6145059	Streptomyces sp. SirexAA-E	862751	S	82	8	90	0.00001
SRR6145059	Streptomyces sp. CMB-StM0423	2059884	S	61	8	69	0.00001
SRR6145059	Streptomyces sp. 2323.1	1938841	S	68	8	76	0.00001
SRR6145059	Streptococcus troglodytae	1111760	S	8	0	8	0.00000
SRR6145059	Streptococcus sp. NCTC 11567	2583584	S	8	53	61	0.00001
SRR6145059	Streptococcus merionis	400065	S	8	0	8	0.00000
SRR6145059	Streptococcus marmotae	1825069	S	8	0	8	0.00000
SRR6145059	Streptococcus halotolerans	1814128	S	8	0	8	0.00000
SRR6145059	Staphylococcus virus P108	1924731	S	5	8	13	0.00000
SRR6145059	Staphylococcus phage StB12	1147042	S	10	8	18	0.00000
SRR6145059	Sporosarcina psychrophila	1476	S	8	0	8	0.00000
SRR6145059	Sphingomonas sp. MK52	2711156	S	197	8	205	0.00002
SRR6145059	Slackia heliotrinireducens	84110	S	8	0	8	0.00000
SRR6145059	Siansivirga zeaxanthinifaciens	762954	S	8	0	8	0.00000
SRR6145059	Shewanella oneidensis	70863	S	8	0	8	0.00000
SRR6145059	Shewanella japonica	93973	S	8	0	8	0.00000
SRR6145059	Serratia sp. SCBI	488142	S	3	8	11	0.00000
SRR6145059	Serratia sp. FDAARGOS_506	2420306	S	25	8	33	0.00000
SRR6145059	Saccharophagus degradans	86304	S	8	0	8	0.00000
SRR6145059	Raoultella sp. X13	2259647	S	1	8	9	0.00000
SRR6145059	Pyrobaculum ferrireducens	1104324	S	8	0	8	0.00000
SRR6145059	Psychrobacter cryohalolentis	330922	S	8	0	8	0.00000
SRR6145059	Pseudomonas sp. R4-39-08	1173288	S	2	8	10	0.00000
SRR6145059	Pseudomonas sp. R4-34-07	658642	S	2	8	10	0.00000
SRR6145059	Pseudomonas sp. FDAARGOS_380	2018067	S	14	8	22	0.00000
SRR6145059	Pseudomonas sp. CFSAN084952	2664899	S	3	8	11	0.00000
SRR6145059	Pseudanabaena sp. PCC 7367	82654	S	8	0	8	0.00000
SRR6145059	Plantactinospora sp. KBS50	2024580	S	118	8	126	0.00001
SRR6145059	Planctopirus ephydatiae	2528019	S	8	0	8	0.00000
SRR6145059	Planctomycetes bacterium Enr10	2527978	S	2	8	10	0.00000
SRR6145059	Planctomyces sp. SH-PL62	1636152	S	135	8	143	0.00002
SRR6145059	Pelodictyon phaeoclathratiforme	34090	S	8	0	8	0.00000
SRR6145059	Pelobacter acetylenicus	29542	S	8	0	8	0.00000
SRR6145059	Pectobacterium wasabiae	55208	S	7	1	8	0.00000
SRR6145059	Paraclostridium bifermentans	1490	S	8	0	8	0.00000
SRR6145059	Paenibacillus yonginensis	1462996	S	8	0	8	0.00000
SRR6145059	Paenibacillus sabinae	365617	S	8	0	8	0.00000
SRR6145059	Paenibacillus baekrokdamisoli	1712516	S	8	0	8	0.00000
SRR6145059	Oerskovia sp. KBS0722	1179673	S	130	8	138	0.00002
SRR6145059	Novibacillus thermophilus	1471761	S	8	0	8	0.00000
SRR6145059	Nostoc carneum	374162	S	4	4	8	0.00000
SRR6145059	Nonlabens spongiae	331648	S	8	0	8	0.00000
SRR6145059	Microbacterium sp. XT11	367477	S	187	8	195	0.00002
SRR6145059	Microbacterium sp. L-031	2614639	S	130	8	138	0.00002
SRR6145059	Methylophaga nitratireducenticrescens	754476	S	8	0	8	0.00000
SRR6145059	Methylomusa anaerophila	1930071	S	8	0	8	0.00000
SRR6145059	Melissococcus plutonius	33970	S	8	0	8	0.00000
SRR6145059	Megamonas hypermegale	158847	S	8	0	8	0.00000
SRR6145059	Litoricola lipolytica	418701	S	8	0	8	0.00000
SRR6145059	Leuconostoc garlicum	255248	S	4	4	8	0.00000
SRR6145059	Legionella jordanis	456	S	8	0	8	0.00000
SRR6145059	Lactobacillus vaginalis	1633	S	8	0	8	0.00000
SRR6145059	Lactobacillus mucosae	97478	S	8	0	8	0.00000
SRR6145059	Kroppenstedtia eburnea	714067	S	8	0	8	0.00000
SRR6145059	Kitasatospora sp. MMS16-BH015	2018025	S	180	8	188	0.00002
SRR6145059	Ilyobacter polytropus	167642	S	8	0	8	0.00000
SRR6145059	Hymenobacter sp. BRD67	2675877	S	26	8	34	0.00000
SRR6145059	Herbiconiux sp. SALV-R1	2735133	S	142	8	150	0.00002
SRR6145059	Halomonas sp. SF2003	2136172	S	12	8	20	0.00000
SRR6145059	Haloarcula marismortui	2238	S	5	3	8	0.00000
SRR6145059	Gordonia virus Phistory	2734203	S	8	8	16	0.00000
SRR6145059	Gloeothece verrucosa	2546359	S	8	0	8	0.00000
SRR6145059	Gloeothece citriformis	2546356	S	8	0	8	0.00000
SRR6145059	Glaciecola nitratireducens	300231	S	8	0	8	0.00000
SRR6145059	Geobacter daltonii	1203471	S	8	0	8	0.00000
SRR6145059	Gammapapillomavirus 7	1175849	S	8	0	8	0.00000
SRR6145059	Gallibacterium anatis	750	S	8	0	8	0.00000
SRR6145059	Francisella tularensis	263	S	5	3	8	0.00000
SRR6145059	Flavobacteriaceae bacterium	1871037	S	8	0	8	0.00000
SRR6145059	Enterococcus gallinarum	1353	S	3	5	8	0.00000
SRR6145059	Draconibacterium orientale	1168034	S	8	0	8	0.00000
SRR6145059	Dolichospermum compactum	136073	S	5	3	8	0.00000
SRR6145059	Devosia sp. 1566	2499144	S	90	8	98	0.00001
SRR6145059	Cyclobacterium marinum	104	S	7	1	8	0.00000
SRR6145059	Cyanobacterium aponinum	379064	S	8	0	8	0.00000
SRR6145059	Corynebacterium sp. 1959	2675216	S	145	8	153	0.00002
SRR6145059	Coriobacterium glomerans	33871	S	8	0	8	0.00000
SRR6145059	Colwellia sp. PAMC 20917	1816218	S	8	0	8	0.00000
SRR6145059	Clostridium septicum	1504	S	8	0	8	0.00000
SRR6145059	Clostridium acetobutylicum	1488	S	8	0	8	0.00000
SRR6145059	Citrobacter sp. CFNIH10	1920110	S	2	8	10	0.00000
SRR6145059	Citrobacter farmeri	67824	S	6	2	8	0.00000
SRR6145059	Chromobacterium sp. IIBBL 274-1	2202142	S	8	35	43	0.00001
SRR6145059	Chelativorans sp. BNC1	266779	S	124	8	132	0.00002
SRR6145059	Cellulomonas sp. 40-2	2729175	S	150	8	158	0.00002
SRR6145059	Catenovulum sediminis	1740262	S	8	0	8	0.00000
SRR6145059	Carnobacterium inhibens	147709	S	7	1	8	0.00000
SRR6145059	Campylobacter sputorum	206	S	8	0	8	0.00000
SRR6145059	Campylobacter pinnipediorum	1965231	S	8	0	8	0.00000
SRR6145059	Caldithrix abyssi	187145	S	8	0	8	0.00000
SRR6145059	Brevibacillus brevis	1393	S	8	0	8	0.00000
SRR6145059	Brachyspira pilosicoli	52584	S	8	0	8	0.00000
SRR6145059	Borrelia miyamotoi	47466	S	8	0	8	0.00000
SRR6145059	Bacteroides sp. A1C1	2528203	S	18	8	26	0.00000
SRR6145059	Bacillus marisflavi	189381	S	8	0	8	0.00000
SRR6145059	Bacillus jeotgali	129985	S	8	0	8	0.00000
SRR6145059	Bacillus freudenreichii	1783501	S	8	0	8	0.00000
SRR6145059	Bacillus clausii	79880	S	8	0	8	0.00000
SRR6145059	Bacillus atrophaeus	1452	S	8	0	8	0.00000
SRR6145059	Arthrobacter sp. U41	1849032	S	84	8	92	0.00001
SRR6145059	Arcobacter skirrowii	28200	S	7	1	8	0.00000
SRR6145059	Arcobacter peruensis	2320140	S	4	4	8	0.00000
SRR6145059	Anoxybacillus kamchatkensis	196180	S	4	4	8	0.00000
SRR6145059	Amycolatopsis sp. AA4	1896961	S	150	8	158	0.00002
SRR6145059	Amphibacillus xylanus	1449	S	8	0	8	0.00000
SRR6145059	Alteromonas australica	589873	S	8	0	8	0.00000
SRR6145059	Alloactinosynnema sp. L-07	1653480	S	132	8	140	0.00002
SRR6145059	Aerococcus urinaehominis	128944	S	8	0	8	0.00000
SRR6145059	Aequorivita sublithincola	101385	S	8	0	8	0.00000
SRR6145059	Actinomyces sp. Chiba101	1851395	S	136	8	144	0.00002
SRR6145059	Acaryochloris marina	155978	S	8	0	8	0.00000
SRR6145059	Absiella argi	1671597	S	2	6	8	0.00000
SRR6145059	candidate division Zixibacteria bacterium	2053527	S	7	0	7	0.00000
SRR6145059	[Mannheimia] succiniciproducens	157673	S	2	5	7	0.00000
SRR6145059	[Brevibacterium] frigoritolerans	450367	S	7	0	7	0.00000
SRR6145059	Xylella taiwanensis	1444770	S	7	0	7	0.00000
SRR6145059	Vibrio taketomensis	2572923	S	7	0	7	0.00000
SRR6145059	Vibrio navarrensis	29495	S	7	0	7	0.00000
SRR6145059	Vibrio breoganii	553239	S	7	0	7	0.00000
SRR6145059	Vibrio azureus	512649	S	7	0	7	0.00000
SRR6145059	Vibrio aphrogenes	1891186	S	7	0	7	0.00000
SRR6145059	Treponema pedis	409322	S	7	0	7	0.00000
SRR6145059	Thalassolituus oleivorans	187493	S	7	0	7	0.00000
SRR6145059	Sulfuriflexus mobilis	1811807	S	7	0	7	0.00000
SRR6145059	Succinivibrio dextrinosolvens	83771	S	7	0	7	0.00000
SRR6145059	Streptomyces sp. ZFG47	2184053	S	97	7	104	0.00001
SRR6145059	Streptomyces sp. RPA4-2	2721244	S	62	7	69	0.00001
SRR6145059	Streptomyces sp. C8S0	2585716	S	102	7	109	0.00001
SRR6145059	Staphylococcus virus IPLAC1C	1980931	S	5	7	12	0.00000
SRR6145059	Spirosoma sp. I-24	2666025	S	17	7	24	0.00000
SRR6145059	Spiroplasma monobiae	2136	S	7	0	7	0.00000
SRR6145059	Sphaerospermopsis kisseleviana	289435	S	7	0	7	0.00000
SRR6145059	Shewanella sediminis	271097	S	7	0	7	0.00000
SRR6145059	Shewanella loihica	359303	S	7	0	7	0.00000
SRR6145059	Shewanella livingstonensis	150120	S	7	0	7	0.00000
SRR6145059	Shewanella amazonensis	60478	S	7	0	7	0.00000
SRR6145059	Serratia sp. YD25	1759437	S	38	7	45	0.00001
SRR6145059	Serratia sp. JKS000199	1938820	S	1	7	8	0.00000
SRR6145059	Saccharopolyspora sp. E2A	2665642	S	144	7	151	0.00002
SRR6145059	Ruminococcus champanellensis	1161942	S	7	0	7	0.00000
SRR6145059	Roseburia hominis	301301	S	6	1	7	0.00000
SRR6145059	Rivularia sp. PCC 7116	373994	S	7	0	7	0.00000
SRR6145059	Rhizobium sp. TAL182	2020313	S	3	7	10	0.00000
SRR6145059	Rhizobium sp. NXC14	1981173	S	39	7	46	0.00001
SRR6145059	Rhizobium sp. ACO-34A	1571470	S	86	7	93	0.00001
SRR6145059	Raphidiopsis curvata	312883	S	7	0	7	0.00000
SRR6145059	Rahnella sp. Y9602	741091	S	2	7	9	0.00000
SRR6145059	Pseudomonas sp. NIBRBAC000502773	2590776	S	17	7	24	0.00000
SRR6145059	Pseudomonas sp. B10	118613	S	18	7	25	0.00000
SRR6145059	Pseudomonas sp. 09C 129	2054915	S	7	8	15	0.00000
SRR6145059	Pseudoalteromonas atlantica	288	S	5	2	7	0.00000
SRR6145059	Pseudarthrobacter sp. YJ56	2697569	S	56	7	63	0.00001
SRR6145059	Providencia rustigianii	158850	S	7	0	7	0.00000
SRR6145059	Proteiniphilum saccharofermentans	1642647	S	7	0	7	0.00000
SRR6145059	Polynucleobacter acidiphobus	556053	S	7	0	7	0.00000
SRR6145059	Phreatobacter sp. NMCR1094	2570229	S	102	7	109	0.00001
SRR6145059	Phaeobacter sp. LSS9	681157	S	6	7	13	0.00000
SRR6145059	Pediococcus acidilactici	1254	S	7	0	7	0.00000
SRR6145059	Pasteurella dagmatis	754	S	7	0	7	0.00000
SRR6145059	Parashewanella tropica	2547970	S	7	0	7	0.00000
SRR6145059	Paraglaciecola psychrophila	326544	S	7	0	7	0.00000
SRR6145059	Paraburkholderia sp. SOS3	1926494	S	501	7	508	0.00006
SRR6145059	Pandoravirus quercus	2107709	S	5	2	7	0.00000
SRR6145059	Paludibacter propionicigenes	185300	S	7	0	7	0.00000
SRR6145059	Paenibacillus sp. UniB2	2726185	S	49	7	56	0.00001
SRR6145059	Paenibacillus sp. IHBB 10380	1566358	S	7	0	7	0.00000
SRR6145059	Paenibacillus protaetiae	2509456	S	7	0	7	0.00000
SRR6145059	Paenibacillus lutimineralis	2707005	S	7	0	7	0.00000
SRR6145059	Paenibacillus cellulosilyticus	375489	S	7	0	7	0.00000
SRR6145059	Paenibacillus albus	2495582	S	7	0	7	0.00000
SRR6145059	Otariodibacter oris	1032623	S	7	0	7	0.00000
SRR6145059	Ornithinimicrobium sp. H23M54	2594265	S	216	7	223	0.00003
SRR6145059	Oceanisphaera avium	1903694	S	7	0	7	0.00000
SRR6145059	Nitrosomonas europaea	915	S	7	0	7	0.00000
SRR6145059	Nitrosococcus oceani	1229	S	6	1	7	0.00000
SRR6145059	Nitrosococcus halophilus	133539	S	7	0	7	0.00000
SRR6145059	Neptunomonas concharum	1031538	S	7	0	7	0.00000
SRR6145059	Natronolimnobius sulfurireducens	2044521	S	7	0	7	0.00000
SRR6145059	Myroides sp. A21	1583100	S	5	7	12	0.00000
SRR6145059	Mycoplasma orale	2121	S	7	0	7	0.00000
SRR6145059	Mycobacterium sp. DL440	2675523	S	122	7	129	0.00002
SRR6145059	Mycobacterium paraintracellulare	1138383	S	4	3	7	0.00000
SRR6145059	Microlunatus sp. KUDC0627	2596828	S	116	7	123	0.00001
SRR6145059	Microbacterium sp. ST-M6	2614638	S	176	7	183	0.00002
SRR6145059	Microbacterium sp. RG1	2489212	S	178	7	185	0.00002
SRR6145059	Methylomicrobium buryatense	95641	S	3	4	7	0.00000
SRR6145059	Methanopyrus kandleri	2320	S	7	0	7	0.00000
SRR6145059	Methanoculleus sp. MAB1	86622	S	2	7	9	0.00000
SRR6145059	Methanococcus maripaludis	39152	S	7	0	7	0.00000
SRR6145059	Methanocella paludicola	570267	S	7	0	7	0.00000
SRR6145059	Methanocella arvoryzae	1175445	S	7	0	7	0.00000
SRR6145059	Marinobacter salinus	1874317	S	7	0	7	0.00000
SRR6145059	Marinobacter adhaerens	1033846	S	3	4	7	0.00000
SRR6145059	Marinitoga piezophila	149715	S	2	5	7	0.00000
SRR6145059	Mannheimia granulomatis	85402	S	7	0	7	0.00000
SRR6145059	Magnetococcus marinus	1124597	S	7	0	7	0.00000
SRR6145059	Legionella anisa	28082	S	7	0	7	0.00000
SRR6145059	Lactobacillus sp. JM1	2690380	S	1	7	8	0.00000
SRR6145059	Lactobacillus acidipiscis	89059	S	7	0	7	0.00000
SRR6145059	Lacrimispora saccharolytica	84030	S	7	0	7	0.00000
SRR6145059	Labilibaculum antarcticum	1717717	S	7	0	7	0.00000
SRR6145059	Kroppenstedtia pulmonis	1380685	S	7	0	7	0.00000
SRR6145059	Kangiella sediminilitoris	1144748	S	7	0	7	0.00000
SRR6145059	Idiomarina andamanensis	1940690	S	7	0	7	0.00000
SRR6145059	Haloplanus sp. CBA1113	1547899	S	2	7	9	0.00000
SRR6145059	Halomonas sp. HG01	1609967	S	58	7	65	0.00001
SRR6145059	Hafnia alvei	569	S	4	3	7	0.00000
SRR6145059	Haematospirillum jordaniae	1549855	S	7	0	7	0.00000
SRR6145059	Gramella flava	1486245	S	7	0	7	0.00000
SRR6145059	Gottschalkia acidurici	1556	S	7	0	7	0.00000
SRR6145059	Georgenia sp. ZLJ0423	2483799	S	168	7	175	0.00002
SRR6145059	Geobacillus kaustophilus	1462	S	1	6	7	0.00000
SRR6145059	Gemmobacter sp. HYN0069	2169400	S	119	7	126	0.00001
SRR6145059	Gammapapillomavirus 1	333926	S	7	0	7	0.00000
SRR6145059	Fictibacillus arsenicus	255247	S	7	0	7	0.00000
SRR6145059	Fibrobacter succinogenes	833	S	7	0	7	0.00000
SRR6145059	Fervidobacterium pennivorans	93466	S	7	0	7	0.00000
SRR6145059	Exiguobacterium antarcticum	132920	S	7	0	7	0.00000
SRR6145059	Erwinia sp. Ejp617	215689	S	5	7	12	0.00000
SRR6145059	Enterococcus thailandicus	417368	S	7	0	7	0.00000
SRR6145059	Enterococcus avium	33945	S	7	0	7	0.00000
SRR6145059	Enterocloster clostridioformis	1531	S	4	3	7	0.00000
SRR6145059	Enterobacter sp. E20	1560339	S	3	7	10	0.00000
SRR6145059	Edwardsiella sp. EA181011	1578828	S	1	7	8	0.00000
SRR6145059	Edwardsiella ictaluri	67780	S	7	0	7	0.00000
SRR6145059	Echinicola strongylocentroti	1795355	S	7	0	7	0.00000
SRR6145059	Dysosmobacter welbionis	2093857	S	3	4	7	0.00000
SRR6145059	Dickeya solani	1089444	S	6	1	7	0.00000
SRR6145059	Dialister hominis	2582419	S	1	6	7	0.00000
SRR6145059	Desulfurispirillum indicum	936456	S	7	0	7	0.00000
SRR6145059	Desulfovibrio ferrophilus	241368	S	7	0	7	0.00000
SRR6145059	Desulfobacca acetoxidans	60893	S	7	0	7	0.00000
SRR6145059	Desulfallas gibsoniae	102134	S	7	0	7	0.00000
SRR6145059	Cryobacterium sp. LW097	1978566	S	96	7	103	0.00001
SRR6145059	Croceibacter atlanticus	313588	S	7	0	7	0.00000
SRR6145059	Crateriforma conspicua	2527996	S	7	0	7	0.00000
SRR6145059	Clostridium tyrobutyricum	1519	S	7	0	7	0.00000
SRR6145059	Clostridium taeniosporum	394958	S	7	0	7	0.00000
SRR6145059	Clostridium bornimense	1216932	S	7	0	7	0.00000
SRR6145059	Chthonomonas calidirosea	454171	S	7	0	7	0.00000
SRR6145059	Chloroflexus aggregans	152260	S	7	0	7	0.00000
SRR6145059	Cellvibrio sp. KY-YJ-3	454662	S	64	7	71	0.00001
SRR6145059	Cellulophaga lytica	979	S	7	0	7	0.00000
SRR6145059	Capnocytophaga stomatis	1848904	S	7	0	7	0.00000
SRR6145059	Candidatus Nitrotoga sp. AM1P	2559597	S	7	0	7	0.00000
SRR6145059	Candidatus Aquiluna sp. UB-MaderosW2red	1855377	S	7	0	7	0.00000
SRR6145059	Campylobacter curvus	200	S	7	0	7	0.00000
SRR6145059	Buttiauxella agrestis	82977	S	7	0	7	0.00000
SRR6145059	Burkholderia sp. THE68	758782	S	267	7	274	0.00003
SRR6145059	Brucella sp. 10RB9215	1149953	S	7	7	14	0.00000
SRR6145059	Brucella sp. 09RB8910	1844051	S	7	7	14	0.00000
SRR6145059	Blautia sp. SC05B48	2479767	S	53	7	60	0.00001
SRR6145059	Betapapillomavirus 1	337051	S	7	0	7	0.00000
SRR6145059	Bacillus thermocopriae	1215031	S	7	0	7	0.00000
SRR6145059	Bacillus kochii	859143	S	7	0	7	0.00000
SRR6145059	Bacillus halodurans	86665	S	7	0	7	0.00000
SRR6145059	Bacillus anthracis	1392	S	3	4	7	0.00000
SRR6145059	Azoarcus sp. DN11	356837	S	70	7	77	0.00001
SRR6145059	Azoarcus sp. CIB	198107	S	70	7	77	0.00001
SRR6145059	Aureimonas sp. AU20	1349819	S	172	7	179	0.00002
SRR6145059	Arthrobacter sp. 24S4-2	2575374	S	72	7	79	0.00001
SRR6145059	Arcobacter venerupis	1054033	S	7	0	7	0.00000
SRR6145059	Arcobacter nitrofigilis	28199	S	7	0	7	0.00000
SRR6145059	Arcobacter mytili	603050	S	7	0	7	0.00000
SRR6145059	Aquitalea sp. USM4	1590041	S	36	7	43	0.00001
SRR6145059	Apibacter sp. B2966	2656761	S	5	7	12	0.00000
SRR6145059	Anoxybacillus sp. PDR2	1636720	S	2	7	9	0.00000
SRR6145059	Aeromicrobium sp. A1-2	2107713	S	144	7	151	0.00002
SRR6145059	Actinomyces sp. 432	2057798	S	85	7	92	0.00001
SRR6145059	Actinobacillus porcitonsillarum	189834	S	7	0	7	0.00000
SRR6145059	Acinetobacter sp. C16S1	2609668	S	42	7	49	0.00001
SRR6145059	[Clostridium] hylemonae	89153	S	6	0	6	0.00000
SRR6145059	Yersinia entomophaga	935293	S	6	0	6	0.00000
SRR6145059	Yersinia aleksiciae	263819	S	6	0	6	0.00000
SRR6145059	Xenorhabdus nematophila	628	S	6	0	6	0.00000
SRR6145059	Wenyingzhuangia fucanilytica	1790137	S	6	0	6	0.00000
SRR6145059	Virgibacillus necropolis	163877	S	6	0	6	0.00000
SRR6145059	Vibrio tapetis	52443	S	6	0	6	0.00000
SRR6145059	Vibrio sp. EJY3	1116375	S	6	6	12	0.00000
SRR6145059	Vibrio rotiferianus	190895	S	6	0	6	0.00000
SRR6145059	Ureibacillus thermosphaericus	51173	S	6	0	6	0.00000
SRR6145059	Treponema succinifaciens	167	S	6	0	6	0.00000
SRR6145059	Thermosipho africanus	2421	S	6	0	6	0.00000
SRR6145059	Thermoproteus tenax	2271	S	6	0	6	0.00000
SRR6145059	Thermoanaerobacterium aotearoense	47490	S	6	0	6	0.00000
SRR6145059	Thermincola potens	863643	S	6	0	6	0.00000
SRR6145059	Thermanaerovibrio acidaminovorans	81462	S	6	0	6	0.00000
SRR6145059	Thalassotalea sp. HSM 43	2552945	S	6	0	6	0.00000
SRR6145059	Tetragenococcus osmophilus	526944	S	6	0	6	0.00000
SRR6145059	Terribacillus goriensis	386490	S	6	0	6	0.00000
SRR6145059	Teredinibacter turnerae	2426	S	6	0	6	0.00000
SRR6145059	Tenacibaculum sp. DSM 106434	2358479	S	6	3	9	0.00000
SRR6145059	Synechococcus sp. PCC 6312	195253	S	6	0	6	0.00000
SRR6145059	Synechococcus elongatus	32046	S	1	5	6	0.00000
SRR6145059	Sulfuriferula nivalis	2675298	S	6	0	6	0.00000
SRR6145059	Streptomyces sp. TLI_053	1855352	S	127	6	133	0.00002
SRR6145059	Streptomyces sp. SM18	1736046	S	70	6	76	0.00001
SRR6145059	Streptomyces sp. RTd22	1841249	S	123	6	129	0.00002
SRR6145059	Streptomyces sp. QMT-12	2717324	S	111	6	117	0.00001
SRR6145059	Streptococcus ratti	1341	S	6	0	6	0.00000
SRR6145059	Sporolactobacillus terrae	269673	S	6	0	6	0.00000
SRR6145059	Spirochaeta thermophila	154	S	6	0	6	0.00000
SRR6145059	Silvanigrella aquatica	1915309	S	6	0	6	0.00000
SRR6145059	Shewanella sp. MR-7	60481	S	11	6	17	0.00000
SRR6145059	Shewanella psychrophila	225848	S	6	0	6	0.00000
SRR6145059	Shewanella maritima	2520507	S	6	0	6	0.00000
SRR6145059	Shewanella denitrificans	192073	S	6	0	6	0.00000
SRR6145059	Serratia sp. ATCC 39006	104623	S	6	0	6	0.00000
SRR6145059	Serratia sp. 1D1416	2447890	S	4	6	10	0.00000
SRR6145059	Serratia quinivorans	137545	S	4	2	6	0.00000
SRR6145059	Sediminispirochaeta smaragdinae	55206	S	6	0	6	0.00000
SRR6145059	Salinispira pacifica	1307761	S	6	0	6	0.00000
SRR6145059	Ruminococcus albus	1264	S	6	0	6	0.00000
SRR6145059	Ruegeria sp. THAF33	2587853	S	23	6	29	0.00000
SRR6145059	Rhodoluna lacicola	529884	S	6	0	6	0.00000
SRR6145059	Rhodococcus sp. B7740	1564114	S	142	6	148	0.00002
SRR6145059	Rhodococcus sp. ABRD24	2507582	S	133	6	139	0.00002
SRR6145059	Reinekea forsetii	1336806	S	6	0	6	0.00000
SRR6145059	Pyrobaculum arsenaticum	121277	S	6	0	6	0.00000
SRR6145059	Psychroflexus torquis	57029	S	6	0	6	0.00000
SRR6145059	Pseudomonas sp. SGAir0191	2217867	S	12	6	18	0.00000
SRR6145059	Pseudomonas sp. R2-7-07	658641	S	1	6	7	0.00000
SRR6145059	Pseudomonas sp. R11-23-07	658632	S	1	6	7	0.00000
SRR6145059	Pseudomonas sp. CMR12a	658629	S	3	6	9	0.00000
SRR6145059	Pseudomonas savastanoi	29438	S	2	4	6	0.00000
SRR6145059	Pseudolabrys sp. FHR47	2562284	S	78	6	84	0.00001
SRR6145059	Pseudoclostridium thermosuccinogenes	84032	S	6	0	6	0.00000
SRR6145059	Pseudoalteromonas translucida	166935	S	5	1	6	0.00000
SRR6145059	Pseudoalteromonas spongiae	298657	S	6	0	6	0.00000
SRR6145059	Pseudoalteromonas piratica	1348114	S	6	0	6	0.00000
SRR6145059	Pseudoalteromonas haloplanktis	228	S	2	4	6	0.00000
SRR6145059	Propionibacterium virus PHL199M00	1982300	S	38	6	44	0.00001
SRR6145059	Polynucleobacter difficilis	556054	S	6	0	6	0.00000
SRR6145059	Polaribacter sp. BM10	1529069	S	5	6	11	0.00000
SRR6145059	Planctomycetes bacterium Mal52	2527995	S	7	6	13	0.00000
SRR6145059	Planctomycetes bacterium HG66A1	2527967	S	2	6	8	0.00000
SRR6145059	Photorhabdus thracensis	230089	S	6	0	6	0.00000
SRR6145059	Photobacterium profundum	74109	S	6	0	6	0.00000
SRR6145059	Phenylobacterium sp. HYN0004	2201350	S	168	6	174	0.00002
SRR6145059	Pectobacterium atrosepticum	29471	S	6	0	6	0.00000
SRR6145059	Pasteurellaceae bacterium NI1060	1679001	S	3	6	9	0.00000
SRR6145059	Paracoccus sp. BM15	1529068	S	254	6	260	0.00003
SRR6145059	Paenibacillus sp. lzh-N1	2069255	S	1	6	7	0.00000
SRR6145059	Oscillibacter valericigenes	351091	S	6	0	6	0.00000
SRR6145059	Orientia tsutsugamushi	784	S	6	0	6	0.00000
SRR6145059	Oligella urethralis	90245	S	6	0	6	0.00000
SRR6145059	Oleispira antarctica	188908	S	6	0	6	0.00000
SRR6145059	Oceanisphaera profunda	1416627	S	6	0	6	0.00000
SRR6145059	Obesumbacterium proteus	82983	S	3	3	6	0.00000
SRR6145059	Novosphingobium sp. P6W	1609758	S	154	6	160	0.00002
SRR6145059	Nostoc sp. NIES-2111	1973475	S	3	6	9	0.00000
SRR6145059	Nitrosospira lacus	1288494	S	6	0	6	0.00000
SRR6145059	Nitrosopumilus maritimus	338192	S	5	1	6	0.00000
SRR6145059	Nitrosomonas eutropha	916	S	6	0	6	0.00000
SRR6145059	Mycoplasma suis	57372	S	6	0	6	0.00000
SRR6145059	Mycoplasma gallinaceum	29556	S	6	0	6	0.00000
SRR6145059	Mycoplasma cynos	171284	S	6	0	6	0.00000
SRR6145059	Mycoplasma anserisalpingitidis	519450	S	6	0	6	0.00000
SRR6145059	Mycobacterium ulcerans	1809	S	6	0	6	0.00000
SRR6145059	Mycobacterium sp. EPa45	1545728	S	112	6	118	0.00001
SRR6145059	Mycobacterium pseudoshottsii	265949	S	5	1	6	0.00000
SRR6145059	Methyloceanibacter sp. wino2	2170729	S	44	6	50	0.00001
SRR6145059	Methanosarcina horonobensis	418008	S	6	0	6	0.00000
SRR6145059	Methanoregula formicica	882104	S	6	0	6	0.00000
SRR6145059	Methanobrevibacter smithii	2173	S	6	0	6	0.00000
SRR6145059	Melioribacter roseus	1134405	S	6	0	6	0.00000
SRR6145059	Mariprofundus ferrinatatus	1921087	S	6	0	6	0.00000
SRR6145059	Marinomonas posidonica	936476	S	6	0	6	0.00000
SRR6145059	Litorilituus sediminis	718192	S	6	0	6	0.00000
SRR6145059	Listeria ivanovii	1638	S	6	0	6	0.00000
SRR6145059	Limnobaculum parvum	2172103	S	6	0	6	0.00000
SRR6145059	Leminorella richardii	158841	S	6	0	6	0.00000
SRR6145059	Legionella spiritensis	452	S	6	0	6	0.00000
SRR6145059	Legionella fallonii	96230	S	6	0	6	0.00000
SRR6145059	Lactobacillus ruminis	1623	S	6	0	6	0.00000
SRR6145059	Lactobacillus dextrinicus	51664	S	6	0	6	0.00000
SRR6145059	Lacrimispora sphenoides	29370	S	6	0	6	0.00000
SRR6145059	Lacimicrobium alkaliphilum	1526571	S	6	0	6	0.00000
SRR6145059	Lachnoclostridium phytofermentans	66219	S	6	0	6	0.00000
SRR6145059	Kyrpidia tusciae	33943	S	4	2	6	0.00000
SRR6145059	Ketobacter alkanivorans	1917421	S	6	0	6	0.00000
SRR6145059	Kangiella profundi	1561924	S	6	0	6	0.00000
SRR6145059	Jeotgalibacillus malaysiensis	1508404	S	6	0	6	0.00000
SRR6145059	Ichthyobacterium seriolicida	242600	S	6	0	6	0.00000
SRR6145059	Hydrogenovibrio thermophilus	265883	S	4	2	6	0.00000
SRR6145059	Hungateiclostridium saccincola	1677857	S	6	0	6	0.00000
SRR6145059	Halothermothrix orenii	31909	S	6	0	6	0.00000
SRR6145059	Halorubrum sp. RHB-C	2739057	S	27	6	33	0.00000
SRR6145059	Halobacteroides halobius	42422	S	6	0	6	0.00000
SRR6145059	Halioglobus japonicus	930805	S	6	0	6	0.00000
SRR6145059	Halanaerobium hydrogeniformans	656519	S	6	0	6	0.00000
SRR6145059	Hafnia paralvei	546367	S	6	0	6	0.00000
SRR6145059	Gryllotalpicola sp. 2DFW10M-5	2419771	S	124	6	130	0.00002
SRR6145059	Geovibrio thiophilus	139438	S	6	0	6	0.00000
SRR6145059	Geobacter sp. DSM 9736	1277350	S	6	0	6	0.00000
SRR6145059	Frondihabitans sp. 762G35	1446794	S	106	6	112	0.00001
SRR6145059	Francisella uliginis	573570	S	6	0	6	0.00000
SRR6145059	Flavisolibacter sp. 17J28-1	2502779	S	82	6	88	0.00001
SRR6145059	Flagellimonas maritima	1383885	S	6	0	6	0.00000
SRR6145059	Fermentimonas caenicola	1562970	S	6	0	6	0.00000
SRR6145059	Ethanoligenens harbinense	253239	S	6	0	6	0.00000
SRR6145059	Diaphorobacter sp. HDW4B	2714925	S	94	6	100	0.00001
SRR6145059	Desulfotomaculum nigrificans	1565	S	6	0	6	0.00000
SRR6145059	Deferribacter desulfuricans	197162	S	6	0	6	0.00000
SRR6145059	Cryptobacterium curtum	84163	S	6	0	6	0.00000
SRR6145059	Crocosphaera subtropica	2546360	S	6	0	6	0.00000
SRR6145059	Corynebacterium sp. 2039	2675219	S	150	6	156	0.00002
SRR6145059	Colwellia psychrerythraea	28229	S	6	0	6	0.00000
SRR6145059	Cohnella abietis	2507935	S	6	0	6	0.00000
SRR6145059	Clostridium estertheticum	238834	S	6	0	6	0.00000
SRR6145059	Clostridium cochlearium	1494	S	6	0	6	0.00000
SRR6145059	Clostridium cellulovorans	1493	S	6	0	6	0.00000
SRR6145059	Citrobacter youngae	133448	S	2	4	6	0.00000
SRR6145059	Chryseobacterium sp. 3008163	2478663	S	142	6	148	0.00002
SRR6145059	Chlorobaculum parvum	274539	S	6	0	6	0.00000
SRR6145059	Campylobacter insulaenigrae	260714	S	6	0	6	0.00000
SRR6145059	Campylobacter hyointestinalis	198	S	6	0	6	0.00000
SRR6145059	Calditerrivibrio nitroreducens	477976	S	6	0	6	0.00000
SRR6145059	Burkholderia sp. NRF60-BP8	1637853	S	61	6	67	0.00001
SRR6145059	Brucella sp. 09RB8471	1149952	S	4	6	10	0.00000
SRR6145059	Brachyspira hampsonii	1287055	S	6	0	6	0.00000
SRR6145059	Borrelia crocidurae	29520	S	3	3	6	0.00000
SRR6145059	Bibersteinia trehalosi	47735	S	6	0	6	0.00000
SRR6145059	Basilea psittacipulmonis	1472345	S	6	0	6	0.00000
SRR6145059	Bartonella bacilliformis	774	S	6	0	6	0.00000
SRR6145059	Barnesiella viscericola	397865	S	6	0	6	0.00000
SRR6145059	Bacteroides xylanisolvens	371601	S	4	2	6	0.00000
SRR6145059	Bacillus muralis	264697	S	6	0	6	0.00000
SRR6145059	Bacillus lentus	1467	S	6	0	6	0.00000
SRR6145059	Avibacterium volantium	762	S	6	0	6	0.00000
SRR6145059	Arthrobacter sp. PAMC25564	2565366	S	67	6	73	0.00001
SRR6145059	Arsenophonus nasoniae	638	S	6	0	6	0.00000
SRR6145059	Arcticibacterium luteifluviistationis	1784714	S	6	0	6	0.00000
SRR6145059	Arcobacter molluscorum	1032072	S	6	0	6	0.00000
SRR6145059	Arcobacter cloacae	1054034	S	5	1	6	0.00000
SRR6145059	Arcobacter anaerophilus	877500	S	6	0	6	0.00000
SRR6145059	Anaerostipes rhamnosivorans	1229621	S	6	0	6	0.00000
SRR6145059	Anaerohalosphaera lusitana	1936003	S	6	0	6	0.00000
SRR6145059	Anabaenopsis circularis	109266	S	5	1	6	0.00000
SRR6145059	Aminipila butyrica	433296	S	6	0	6	0.00000
SRR6145059	Alteromonas stellipolaris	233316	S	2	4	6	0.00000
SRR6145059	Alteromonas pelagimontana	1858656	S	6	0	6	0.00000
SRR6145059	Altererythrobacter sp. BO-6	2604537	S	95	6	101	0.00001
SRR6145059	Agarivorans gilvus	680279	S	6	0	6	0.00000
SRR6145059	Acinetobacter sp. WCHAc010052	2004647	S	31	6	37	0.00000
SRR6145059	Acinetobacter sp. WCHAc010034	1879049	S	87	6	93	0.00001
SRR6145059	Acinetobacter sp. TTH0-4	1646498	S	123	6	129	0.00002
SRR6145059	Acholeplasma palmae	38986	S	6	0	6	0.00000
SRR6145059	Acetobacter oryzifermentans	1633874	S	1	5	6	0.00000
SRR6145059	[Haemophilus] ducreyi	730	S	5	0	5	0.00000
SRR6145059	Yersinia ruckeri	29486	S	5	0	5	0.00000
SRR6145059	Yersinia canariae	2607663	S	5	0	5	0.00000
SRR6145059	Yersinia aldovae	29483	S	5	0	5	0.00000
SRR6145059	Xenorhabdus hominickii	351679	S	5	0	5	0.00000
SRR6145059	Xanthomonas citri phage CP2	1188795	S	5	0	5	0.00000
SRR6145059	Weissella viridescens	1629	S	5	0	5	0.00000
SRR6145059	Weissella hellenica	46256	S	5	0	5	0.00000
SRR6145059	Virgibacillus phasianinus	2017483	S	5	0	5	0.00000
SRR6145059	Vibrio tasmaniensis	212663	S	5	0	5	0.00000
SRR6145059	Vibrio sp. 2521-89	2014742	S	4	5	9	0.00000
SRR6145059	Vibrio scophthalmi	45658	S	5	0	5	0.00000
SRR6145059	Vibrio rumoiensis	76258	S	5	0	5	0.00000
SRR6145059	Vibrio neocaledonicus	1208308	S	1	4	5	0.00000
SRR6145059	Vibrio mediterranei	689	S	5	0	5	0.00000
SRR6145059	Vibrio harveyi	669	S	5	0	5	0.00000
SRR6145059	Vibrio gazogenes	687	S	5	0	5	0.00000
SRR6145059	Vibrio alfacsensis	1074311	S	5	0	5	0.00000
SRR6145059	Trichormus azollae	1164	S	5	0	5	0.00000
SRR6145059	Thiomicrospira cyclica	147268	S	5	0	5	0.00000
SRR6145059	Thiolapillus brandeum	1076588	S	5	0	5	0.00000
SRR6145059	Thermoanaerobacter kivui	2325	S	3	2	5	0.00000
SRR6145059	Thermoactinomyces vulgaris	2026	S	5	0	5	0.00000
SRR6145059	Taylorella asinigenitalis	84590	S	5	0	5	0.00000
SRR6145059	Synechocystis sp. CACIAM 05	1933929	S	5	5	10	0.00000
SRR6145059	Synechococcus sp. WH 8103	29410	S	5	8	13	0.00000
SRR6145059	Sulfurospirillum multivorans	66821	S	3	2	5	0.00000
SRR6145059	Streptomyces sp. GSSD-12	2282738	S	103	5	108	0.00001
SRR6145059	Streptomonospora sp. M2	2498135	S	129	5	134	0.00002
SRR6145059	Streptobacillus moniliformis	34105	S	5	0	5	0.00000
SRR6145059	Staphylococcus virus Stau2	2042206	S	2	5	7	0.00000
SRR6145059	Staphylococcus virus SEP1	1980930	S	4	5	9	0.00000
SRR6145059	Staphylococcus virus MCE2014	1924733	S	5	5	10	0.00000
SRR6145059	Spiroplasma litorale	216942	S	5	0	5	0.00000
SRR6145059	Sphaerochaeta pleomorpha	1131707	S	5	0	5	0.00000
SRR6145059	Shewanella pealeana	70864	S	5	0	5	0.00000
SRR6145059	Shewanella benthica	43661	S	5	0	5	0.00000
SRR6145059	Serratia sp. P2ACOL2	2482769	S	5	5	10	0.00000
SRR6145059	Saprospira grandis	1008	S	5	0	5	0.00000
SRR6145059	Salinimonas sediminis	2303538	S	5	0	5	0.00000
SRR6145059	Ruminiclostridium cellulolyticum	1521	S	5	0	5	0.00000
SRR6145059	Rhodospirillaceae bacterium B3	2728875	S	100	5	105	0.00001
SRR6145059	Rhodoplanes sp. Z2-YC6860	674703	S	124	5	129	0.00002
SRR6145059	Rhizobium sp. WL3	2603277	S	107	5	112	0.00001
SRR6145059	Pyrobaculum aerophilum	13773	S	5	0	5	0.00000
SRR6145059	Psychrobacillus glaciei	2283160	S	5	0	5	0.00000
SRR6145059	Pseudothermotoga thermarum	119394	S	2	3	5	0.00000
SRR6145059	Pseudomonas sp. SK	2729423	S	58	5	63	0.00001
SRR6145059	Pseudomonas sp. SCB32	2653853	S	91	5	96	0.00001
SRR6145059	Pseudomonas sp. R3-18-08	1173283	S	3	5	8	0.00000
SRR6145059	Pseudomonas sp. PE08	2604832	S	109	5	114	0.00001
SRR6145059	Pseudomonas sp. CMR5c	658630	S	34	5	39	0.00000
SRR6145059	Pseudomonas sp. ADAK22	2730851	S	3	5	8	0.00000
SRR6145059	Pseudoalteromonas rubra	43658	S	5	0	5	0.00000
SRR6145059	Pseudoalteromonas phenolica	161398	S	5	0	5	0.00000
SRR6145059	Providencia vermicola	333965	S	5	0	5	0.00000
SRR6145059	Planococcus sp. PAMC 21323	1526927	S	5	0	5	0.00000
SRR6145059	Phascolarctobacterium faecium	33025	S	1	4	5	0.00000
SRR6145059	Pandoravirus neocaledonia	2107708	S	5	0	5	0.00000
SRR6145059	Paenibacillus riograndensis	483937	S	5	0	5	0.00000
SRR6145059	Paenibacillus crassostreae	1763538	S	5	0	5	0.00000
SRR6145059	Paenibacillus barcinonensis	198119	S	5	0	5	0.00000
SRR6145059	Paenibacillus alvei	44250	S	5	0	5	0.00000
SRR6145059	Opitutus sp. GAS368	1882749	S	58	5	63	0.00001
SRR6145059	Octadecabacter sp. SW4	2602067	S	35	5	40	0.00000
SRR6145059	Nostoc sp. NIES-3756	1751286	S	2	5	7	0.00000
SRR6145059	Nostoc sp. ATCC 53789	76335	S	5	4	9	0.00000
SRR6145059	Nitratireductor sp. OM-1	1756988	S	79	5	84	0.00001
SRR6145059	Myroides profundi	480520	S	5	0	5	0.00000
SRR6145059	Mycoplasma meleagridis	29561	S	5	0	5	0.00000
SRR6145059	Mycoplasma iowae	2116	S	5	0	5	0.00000
SRR6145059	Mycoplasma hyorhinis	2100	S	5	0	5	0.00000
SRR6145059	Mycoplasma crocodyli	50052	S	5	0	5	0.00000
SRR6145059	Mycoplasma cloacale	92401	S	5	0	5	0.00000
SRR6145059	Mycoplasma citelli	171281	S	5	0	5	0.00000
SRR6145059	Mycoplasma californicum	2113	S	5	0	5	0.00000
SRR6145059	Mycoplasma anseris	92400	S	5	0	5	0.00000
SRR6145059	Mycobacterium virus JC27	1034108	S	1	5	6	0.00000
SRR6145059	Moritella viscosa	80854	S	5	0	5	0.00000
SRR6145059	Moorella glycerini	55779	S	5	0	5	0.00000
SRR6145059	Mobilicoccus sp. NJES-13	2716227	S	174	5	179	0.00002
SRR6145059	Microbacterium sp. ABRD_28	2268461	S	213	5	218	0.00003
SRR6145059	Methylomonas methanica	421	S	5	0	5	0.00000
SRR6145059	Methylomicrobium alcaliphilum	271065	S	2	3	5	0.00000
SRR6145059	Methanothermus fervidus	2180	S	5	0	5	0.00000
SRR6145059	Methanosarcina siciliae	38027	S	5	0	5	0.00000
SRR6145059	Methanosarcina mazei	2209	S	5	0	5	0.00000
SRR6145059	Methanosarcina acetivorans	2214	S	5	0	5	0.00000
SRR6145059	Mesotoga infera	1236046	S	5	0	5	0.00000
SRR6145059	Mesoplasma florum	2151	S	4	1	5	0.00000
SRR6145059	Megavirus chiliensis	1094892	S	4	1	5	0.00000
SRR6145059	Marivivens sp. JLT3646	1920883	S	15	5	20	0.00000
SRR6145059	Listeria grayi	1641	S	5	0	5	0.00000
SRR6145059	Leuconostoc kimchii	136609	S	1	4	5	0.00000
SRR6145059	Leptospira tipperaryensis	2564040	S	5	0	5	0.00000
SRR6145059	Leptolyngbya sp. PCC 7376	111781	S	5	0	5	0.00000
SRR6145059	Legionella oakridgensis	29423	S	5	0	5	0.00000
SRR6145059	Legionella israelensis	454	S	5	0	5	0.00000
SRR6145059	Legionella adelaidensis	45056	S	5	0	5	0.00000
SRR6145059	Lactobacillus zymae	267363	S	5	0	5	0.00000
SRR6145059	Lactobacillus sp. C25	2692757	S	4	5	9	0.00000
SRR6145059	Lactobacillus murinus	1622	S	5	0	5	0.00000
SRR6145059	Lactobacillus manihotivorans	88233	S	5	0	5	0.00000
SRR6145059	Lactobacillus hordei	468911	S	5	0	5	0.00000
SRR6145059	Lactobacillus backii	375175	S	5	0	5	0.00000
SRR6145059	Lactobacillus acetotolerans	1600	S	5	0	5	0.00000
SRR6145059	Jeotgalibaca porci	1868793	S	5	0	5	0.00000
SRR6145059	Hymenobacter sp. 17J36-26	2496028	S	4	5	9	0.00000
SRR6145059	Hirschia baltica	2724	S	5	0	5	0.00000
SRR6145059	Helicobacter cetorum	138563	S	5	0	5	0.00000
SRR6145059	Halomonas sp. KO116	1504981	S	59	5	64	0.00001
SRR6145059	Halobacillus halophilus	1570	S	5	0	5	0.00000
SRR6145059	Halarcobacter ebronensis	1462615	S	5	0	5	0.00000
SRR6145059	Halanaerobium praevalens	2331	S	5	0	5	0.00000
SRR6145059	Gordonia sp. HY186	2597659	S	188	5	193	0.00002
SRR6145059	Gloeomargarita lithophora	1188228	S	5	0	5	0.00000
SRR6145059	Geosporobacter ferrireducens	1424294	S	5	0	5	0.00000
SRR6145059	Georgenia sp. Z443	2589797	S	164	5	169	0.00002
SRR6145059	Frischella perrara	1267021	S	5	0	5	0.00000
SRR6145059	Francisella hispaniensis	622488	S	3	2	5	0.00000
SRR6145059	Erysipelothrix larvae	1514105	S	5	0	5	0.00000
SRR6145059	Erwinia amylovora	552	S	5	0	5	0.00000
SRR6145059	Enterococcus sp. DA9	2603296	S	1	5	6	0.00000
SRR6145059	Duncaniella dubosii	2518971	S	5	0	5	0.00000
SRR6145059	Desulfotomaculum ruminis	1564	S	5	0	5	0.00000
SRR6145059	Desulfotomaculum ferrireducens	1833852	S	5	0	5	0.00000
SRR6145059	Desulfomonile tiedjei	2358	S	5	0	5	0.00000
SRR6145059	Desulfofarcimen acetoxidans	58138	S	5	0	5	0.00000
SRR6145059	Desulfobacula toluolica	28223	S	5	0	5	0.00000
SRR6145059	Desulfitobacterium dichloroeliminans	233055	S	5	0	5	0.00000
SRR6145059	Denitrovibrio acetiphilus	118000	S	5	0	5	0.00000
SRR6145059	Denitrobacterium detoxificans	79604	S	5	0	5	0.00000
SRR6145059	Denitratisoma sp. DHT3	1981880	S	48	5	53	0.00001
SRR6145059	Deinococcus sp. AJ005	2652443	S	234	5	239	0.00003
SRR6145059	Dehalococcoides mccartyi	61435	S	3	2	5	0.00000
SRR6145059	Cylindrospermum stagnale	142864	S	5	0	5	0.00000
SRR6145059	Clostridium formicaceticum	1497	S	5	0	5	0.00000
SRR6145059	Chryseobacterium sp. G0201	2487065	S	86	5	91	0.00001
SRR6145059	Carp sprivivirus	696863	S	5	0	5	0.00000
SRR6145059	Candidatus Pelagibacter sp. HIMB1321	1388755	S	5	0	5	0.00000
SRR6145059	Candidatus Pelagibacter sp. FZCC0015	2268451	S	5	0	5	0.00000
SRR6145059	Campylobacter upsaliensis	28080	S	5	0	5	0.00000
SRR6145059	Campylobacter subantarcticus	497724	S	5	0	5	0.00000
SRR6145059	Caldisphaera lagunensis	200415	S	5	0	5	0.00000
SRR6145059	Butyrivibrio hungatei	185008	S	5	0	5	0.00000
SRR6145059	Burkholderiales bacterium JOSHI_001	864051	S	297	5	302	0.00004
SRR6145059	Brachyspira murdochii	84378	S	5	0	5	0.00000
SRR6145059	Borrelia turcica	229155	S	5	0	5	0.00000
SRR6145059	Bifidobacterium indicum	1691	S	3	2	5	0.00000
SRR6145059	Bermanella marisrubri	207949	S	5	0	5	0.00000
SRR6145059	Bdellovibrio sp. NC01	2220073	S	20	5	25	0.00000
SRR6145059	Bartonella vinsonii	33047	S	5	0	5	0.00000
SRR6145059	Bacillus wiedmannii	1890302	S	5	0	5	0.00000
SRR6145059	Bacillus pacificus	2026187	S	2	3	5	0.00000
SRR6145059	Bacillus mesonae	1193713	S	5	0	5	0.00000
SRR6145059	Bacillus luti	2026191	S	5	0	5	0.00000
SRR6145059	Bacillus licheniformis	1402	S	2	3	5	0.00000
SRR6145059	Bacillus krulwichiae	199441	S	5	0	5	0.00000
SRR6145059	Bacillus infantis	324767	S	5	0	5	0.00000
SRR6145059	Bacillus horikoshii	79883	S	5	0	5	0.00000
SRR6145059	Bacillus gobiensis	1441095	S	5	0	5	0.00000
SRR6145059	Arthrobacter sp. ZXY-2	1806905	S	69	5	74	0.00001
SRR6145059	Arcobacter trophiarum	708186	S	5	0	5	0.00000
SRR6145059	Arcobacter thereius	544718	S	5	0	5	0.00000
SRR6145059	Arcobacter suis	1278212	S	5	0	5	0.00000
SRR6145059	Arcobacter pacificus	1080223	S	5	0	5	0.00000
SRR6145059	Arcobacter cibarius	255507	S	5	0	5	0.00000
SRR6145059	Anoxybacter fermentans	1323375	S	5	0	5	0.00000
SRR6145059	Anoxybacillus amylolyticus	294699	S	5	0	5	0.00000
SRR6145059	Anabaena sp. 90	46234	S	1	5	6	0.00000
SRR6145059	Ammonifex degensii	42838	S	5	0	5	0.00000
SRR6145059	Alteromonas sp. RW2A1	1917158	S	2	5	7	0.00000
SRR6145059	Alkaliphilus oremlandii	461876	S	5	0	5	0.00000
SRR6145059	Aliivibrio wodanis	80852	S	5	0	5	0.00000
SRR6145059	Alcanivorax sp. N3-2A	2014542	S	70	5	75	0.00001
SRR6145059	Aeropyrum pernix	56636	S	4	1	5	0.00000
SRR6145059	Actinobacillus delphinicola	51161	S	5	0	5	0.00000
SRR6145059	Aciduliprofundum boonei	379547	S	1	4	5	0.00000
SRR6145059	Acholeplasma oculi	35623	S	5	0	5	0.00000
SRR6145059	Acholeplasma laidlawii	2148	S	5	0	5	0.00000
SRR6145059	Acholeplasma axanthum	29552	S	5	0	5	0.00000
SRR6145059	[Pasteurella] aerogenes	749	S	4	0	4	0.00000
SRR6145059	[Clostridium] cellulosi	29343	S	4	0	4	0.00000
SRR6145059	[Arcobacter] porcinus	1935204	S	4	0	4	0.00000
SRR6145059	Yersinia rohdei	29485	S	4	0	4	0.00000
SRR6145059	Yersinia massiliensis	419257	S	1	3	4	0.00000
SRR6145059	Wolbachia pipientis	955	S	1	3	4	0.00000
SRR6145059	Wigglesworthia glossinidia	51229	S	4	0	4	0.00000
SRR6145059	Weissella soli	155866	S	4	0	4	0.00000
SRR6145059	Weissella koreensis	165096	S	4	0	4	0.00000
SRR6145059	Vibrio splendidus	29497	S	4	0	4	0.00000
SRR6145059	Vibrio metoecus	1481663	S	4	0	4	0.00000
SRR6145059	Vibrio europaeus	300876	S	4	0	4	0.00000
SRR6145059	Vibrio cidicii	1763883	S	4	0	4	0.00000
SRR6145059	Undibacterium sp. KW1	2058624	S	24	4	28	0.00000
SRR6145059	Treponema caldarium	215591	S	4	0	4	0.00000
SRR6145059	Treponema azotonutricium	150829	S	4	0	4	0.00000
SRR6145059	Tomitella sp. HY188	2597660	S	144	4	148	0.00002
SRR6145059	Thermosynechococcus sp. NK55a	1394889	S	2	4	6	0.00000
SRR6145059	Thermosulfidibacter takaii	412593	S	4	0	4	0.00000
SRR6145059	Thermococcus siculi	72803	S	4	0	4	0.00000
SRR6145059	Thermobaculum terrenum	166501	S	4	0	4	0.00000
SRR6145059	Thermoanaerobacter wiegelii	46354	S	1	3	4	0.00000
SRR6145059	Thermanaerovibrio velox	108007	S	4	0	4	0.00000
SRR6145059	Thermanaeromonas toyohensis	161154	S	4	0	4	0.00000
SRR6145059	Thalassotalea crassostreae	1763536	S	4	0	4	0.00000
SRR6145059	Tenacibaculum mesophilum	104268	S	3	1	4	0.00000
SRR6145059	Taylorella equigenitalis	29575	S	4	0	4	0.00000
SRR6145059	Syntrophus aciditrophicus	316277	S	4	0	4	0.00000
SRR6145059	Synechocystis sp. PCC 6714	1147	S	4	0	4	0.00000
SRR6145059	Synechococcus sp. PCC 7502	1173263	S	4	0	4	0.00000
SRR6145059	Sulfurospirillum sp. UCH001	1581011	S	8	4	12	0.00000
SRR6145059	Sulfurisphaera ohwakuensis	69656	S	3	1	4	0.00000
SRR6145059	Sulfurimonas denitrificans	39766	S	4	0	4	0.00000
SRR6145059	Sulfurimonas autotrophica	202747	S	4	0	4	0.00000
SRR6145059	Sulfuracidifex tepidarius	1294262	S	4	0	4	0.00000
SRR6145059	Sulfolobus islandicus	43080	S	2	2	4	0.00000
SRR6145059	Suicoccus acidiformans	2036206	S	4	0	4	0.00000
SRR6145059	Streptomyces sp. PVA 94-07	1223307	S	4	40	44	0.00001
SRR6145059	Streptomyces sp. GBA 94-10	1218177	S	4	35	39	0.00000
SRR6145059	Streptococcus ruminantium	1917441	S	2	2	4	0.00000
SRR6145059	Streptococcus phage SpSL1	1566990	S	3	4	7	0.00000
SRR6145059	Streptococcus pantholopis	1811193	S	4	0	4	0.00000
SRR6145059	Staphylothermus hellenicus	84599	S	4	0	4	0.00000
SRR6145059	Staphylospora marina	2490858	S	4	0	4	0.00000
SRR6145059	Staphylococcus virus SA12	1924730	S	2	4	6	0.00000
SRR6145059	Staphylococcus phage phiRS7	1403390	S	3	4	7	0.00000
SRR6145059	Sporosarcina sp. P33	1930764	S	2	4	6	0.00000
SRR6145059	Spiroplasma tabanidicola	324079	S	4	0	4	0.00000
SRR6145059	Spiroplasma helicoides	216938	S	4	0	4	0.00000
SRR6145059	Spiroplasma chinense	216932	S	4	0	4	0.00000
SRR6145059	Spiroplasma cantharicola	362837	S	4	0	4	0.00000
SRR6145059	Spiroplasma apis	2137	S	4	0	4	0.00000
SRR6145059	Spirochaeta perfilievii	252967	S	4	0	4	0.00000
SRR6145059	Sphingorhabdus sp. M41	1806885	S	62	4	66	0.00001
SRR6145059	Solimonas sp. K1W22B-7	2303331	S	849	4	853	0.00010
SRR6145059	Sinorhizobium sp. CCBAU 05631	794846	S	4	4	8	0.00000
SRR6145059	Simkania negevensis	83561	S	4	0	4	0.00000
SRR6145059	Shewanella sp. W3-18-1	351745	S	1	4	5	0.00000
SRR6145059	Shewanella sp. MR-4	60480	S	6	4	10	0.00000
SRR6145059	Shewanella halifaxensis	271098	S	4	0	4	0.00000
SRR6145059	Shewanella frigidimarina	56812	S	4	0	4	0.00000
SRR6145059	Shewanella donghaensis	238836	S	4	0	4	0.00000
SRR6145059	Sedimentisphaera cyanobacteriorum	1940790	S	3	1	4	0.00000
SRR6145059	Sebaldella termitidis	826	S	4	0	4	0.00000
SRR6145059	Sanguibacter sp. HDW7	2714931	S	139	4	143	0.00002
SRR6145059	Saliniradius amylolyticus	2183582	S	4	0	4	0.00000
SRR6145059	Saccharomonospora sp. 31sw	2528243	S	73	4	77	0.00001
SRR6145059	Psychrobacter sp. P2G3	1699622	S	7	4	11	0.00000
SRR6145059	Pseudomonas sp. Z003-0.4C(8344-21)	1855380	S	9	4	13	0.00000
SRR6145059	Pseudomonas sp. R76	1573711	S	30	4	34	0.00000
SRR6145059	Pseudomonas sp. R1-43-08	1173270	S	1	4	5	0.00000
SRR6145059	Pseudomonas sp. LG1D9	2083054	S	2	4	6	0.00000
SRR6145059	Pseudohongiella spirulinae	1249552	S	4	0	4	0.00000
SRR6145059	Pseudoalteromonas sp. Bsw20308	283699	S	3	4	7	0.00000
SRR6145059	Pseudoalteromonas espejiana	28107	S	4	0	4	0.00000
SRR6145059	Providencia sneebia	516075	S	4	0	4	0.00000
SRR6145059	Providencia alcalifaciens	126385	S	4	0	4	0.00000
SRR6145059	Proteus hauseri	183417	S	4	0	4	0.00000
SRR6145059	Propionibacterium virus G4	2169873	S	1	4	5	0.00000
SRR6145059	Pragia fontium	82985	S	4	0	4	0.00000
SRR6145059	Polynucleobacter wuianus	1743168	S	4	0	4	0.00000
SRR6145059	Polynucleobacter paneuropaeus	2527775	S	4	0	4	0.00000
SRR6145059	Planococcus donghaensis	414778	S	4	0	4	0.00000
SRR6145059	Planktothrix agardhii	1160	S	4	0	4	0.00000
SRR6145059	Planctomycetes bacterium Pan110	2528028	S	1	4	5	0.00000
SRR6145059	Planctomycetes bacterium EC9	1930277	S	10	4	14	0.00000
SRR6145059	Planctomycetes bacterium CA51	2527990	S	3	4	7	0.00000
SRR6145059	Phascolarctobacterium succinatutens	626940	S	1	3	4	0.00000
SRR6145059	Petrocella atlantisensis	2173034	S	4	0	4	0.00000
SRR6145059	Pelolinea submarina	913107	S	4	0	4	0.00000
SRR6145059	Pelodictyon luteolum	1100	S	4	0	4	0.00000
SRR6145059	Pandoravirus salinus	1349410	S	4	0	4	0.00000
SRR6145059	Paenisporosarcina antarctica	417367	S	4	0	4	0.00000
SRR6145059	Paenibacillus sp. FSL H7-0737	1536775	S	4	0	4	0.00000
SRR6145059	Paenibacillus odorifer	189426	S	4	0	4	0.00000
SRR6145059	Paenibacillus lentus	1338368	S	4	0	4	0.00000
SRR6145059	Paenibacillus kribbensis	172713	S	4	0	4	0.00000
SRR6145059	Paenibacillus guangzhouensis	1473112	S	4	0	4	0.00000
SRR6145059	Paenalcaligenes hominis	643674	S	4	0	4	0.00000
SRR6145059	Oxalobacter formigenes	847	S	4	0	4	0.00000
SRR6145059	Owenweeksia hongkongensis	253245	S	4	0	4	0.00000
SRR6145059	Olsenella sp. GAM18	2109685	S	29	4	33	0.00000
SRR6145059	Oenococcus sp. UCMA 16435	2259623	S	4	0	4	0.00000
SRR6145059	Nostoc sp. PCC 7107	317936	S	4	0	4	0.00000
SRR6145059	Nitrosomonadales bacterium 0125_3	2732067	S	96	4	100	0.00001
SRR6145059	Natrinema sp. J7-2	406552	S	19	4	23	0.00000
SRR6145059	Natranaerobius thermophilus	375929	S	4	0	4	0.00000
SRR6145059	Mycoplasma yeatsii	51365	S	4	0	4	0.00000
SRR6145059	Mycoplasma sp. Mirounga ES2806-NAS	754516	S	4	0	4	0.00000
SRR6145059	Mycoplasma phocidae	142651	S	4	0	4	0.00000
SRR6145059	Mycoplasma mycoides	2102	S	4	0	4	0.00000
SRR6145059	Mycoplasma hyosynoviae	29559	S	4	0	4	0.00000
SRR6145059	Mycoplasma hominis	2098	S	4	0	4	0.00000
SRR6145059	Mycoplasma felis	33923	S	4	0	4	0.00000
SRR6145059	Mycoplasma canis	29555	S	4	0	4	0.00000
SRR6145059	Mycoplasma canadense	29554	S	4	0	4	0.00000
SRR6145059	Mycobacterium sp. DL592	2675524	S	137	4	141	0.00002
SRR6145059	Mycobacterium liflandii	261524	S	3	1	4	0.00000
SRR6145059	Methylovorus sp. MP688	887061	S	4	4	8	0.00000
SRR6145059	Methylotenera versatilis	1055487	S	4	0	4	0.00000
SRR6145059	Methylotenera mobilis	359408	S	4	0	4	0.00000
SRR6145059	Methylacidiphilum kamchatkense	431057	S	3	1	4	0.00000
SRR6145059	Methylacidiphilum fumariolicum	591154	S	3	1	4	0.00000
SRR6145059	Methanosarcina lacustris	170861	S	4	0	4	0.00000
SRR6145059	Methanosalsum zhilinae	39669	S	4	0	4	0.00000
SRR6145059	Methanoculleus bourgensis	83986	S	1	3	4	0.00000
SRR6145059	Methanococcus vannielii	2187	S	4	0	4	0.00000
SRR6145059	Methanocella conradii	1175444	S	4	0	4	0.00000
SRR6145059	Methanobrevibacter millerae	230361	S	4	0	4	0.00000
SRR6145059	Mariprofundus aestuarium	1921086	S	4	0	4	0.00000
SRR6145059	Maribacter sp. MAR_2009_60	1250153	S	2	4	6	0.00000
SRR6145059	Mahella australiensis	252966	S	4	0	4	0.00000
SRR6145059	Macrococcus sp. IME1552	1898474	S	64	4	68	0.00001
SRR6145059	Lysinibacillus fusiformis	28031	S	2	2	4	0.00000
SRR6145059	Listeria weihenstephanensis	1006155	S	4	0	4	0.00000
SRR6145059	Limihaloglobus sulfuriphilus	1851148	S	4	0	4	0.00000
SRR6145059	Leptospira santarosai	28183	S	4	0	4	0.00000
SRR6145059	Leptospira kmetyi	408139	S	4	0	4	0.00000
SRR6145059	Lelliottia jeotgali	1907578	S	4	0	4	0.00000
SRR6145059	Legionella lansingensis	45067	S	4	0	4	0.00000
SRR6145059	Lactobacillus zhachilii	2304606	S	4	0	4	0.00000
SRR6145059	Lactobacillus terrae	2269374	S	4	0	4	0.00000
SRR6145059	Lactobacillus paracollinoides	240427	S	4	0	4	0.00000
SRR6145059	Lactobacillus nagelii	82688	S	4	0	4	0.00000
SRR6145059	Lactobacillus mali	1618	S	4	0	4	0.00000
SRR6145059	Lactobacillus kunkeei	148814	S	4	0	4	0.00000
SRR6145059	Lactobacillus kullabergensis	1218493	S	4	0	4	0.00000
SRR6145059	Lactobacillus frumenti	104955	S	4	0	4	0.00000
SRR6145059	Lactobacillus fructivorans	1614	S	4	0	4	0.00000
SRR6145059	Lactobacillus farciminis	1612	S	4	0	4	0.00000
SRR6145059	Lactobacillus crustorum	392416	S	4	0	4	0.00000
SRR6145059	Lactobacillus amylovorus	1604	S	4	0	4	0.00000
SRR6145059	Lactobacillus amylolyticus	83683	S	4	0	4	0.00000
SRR6145059	Lactobacillus agilis	1601	S	4	0	4	0.00000
SRR6145059	Kosmotoga olearia	651457	S	4	0	4	0.00000
SRR6145059	Jeotgalibaca arthritidis	1868794	S	4	0	4	0.00000
SRR6145059	Janthinobacterium sp. Marseille	375286	S	22	4	26	0.00000
SRR6145059	Ignavibacterium album	591197	S	4	0	4	0.00000
SRR6145059	Hymenobacter sp. DG25B	1385664	S	25	4	29	0.00000
SRR6145059	Hymenobacter sp. DG25A	1385663	S	21	4	25	0.00000
SRR6145059	Hydrogenovibrio marinus	28885	S	4	0	4	0.00000
SRR6145059	Hungateiclostridium clariflavum	288965	S	4	0	4	0.00000
SRR6145059	Helicobacter cinaedi	213	S	4	0	4	0.00000
SRR6145059	Helicobacter bilis	37372	S	4	0	4	0.00000
SRR6145059	Haloferax mediterranei	2252	S	4	0	4	0.00000
SRR6145059	Halobacillus mangrovi	402384	S	4	0	4	0.00000
SRR6145059	Gordonia virus Horus	2734202	S	2	4	6	0.00000
SRR6145059	Geoglobus acetivorans	565033	S	4	0	4	0.00000
SRR6145059	Geobacillus thermocatenulatus	33938	S	3	1	4	0.00000
SRR6145059	Geoalkalibacter subterraneus	483547	S	4	0	4	0.00000
SRR6145059	Gammapapillomavirus 15	1513260	S	4	0	4	0.00000
SRR6145059	Gammapapillomavirus 12	1513257	S	4	0	4	0.00000
SRR6145059	Frankia sp. EAN1pec	298653	S	158	4	162	0.00002
SRR6145059	Francisella adeliensis	2007306	S	4	0	4	0.00000
SRR6145059	Fervidobacterium nodosum	2424	S	4	0	4	0.00000
SRR6145059	Faecalibaculum rodentium	1702221	S	4	0	4	0.00000
SRR6145059	Exiguobacterium sp. AT1b	360911	S	255	4	259	0.00003
SRR6145059	Euzebyella marina	1761453	S	4	0	4	0.00000
SRR6145059	Escherichia virus N15	40631	S	1	4	5	0.00000
SRR6145059	Enterococcus saigonensis	1805431	S	4	0	4	0.00000
SRR6145059	Ehrlichia ruminantium	779	S	4	0	4	0.00000
SRR6145059	Edwardsiella hoshinae	93378	S	4	0	4	0.00000
SRR6145059	Dictyoglomus turgidum	513050	S	4	0	4	0.00000
SRR6145059	Desulfurella acetivorans	33002	S	4	0	4	0.00000
SRR6145059	Desulfovibrio hydrothermalis	191026	S	4	0	4	0.00000
SRR6145059	Desulfotalea psychrophila	84980	S	4	0	4	0.00000
SRR6145059	Desulfosporosinus youngiae	339862	S	4	0	4	0.00000
SRR6145059	Desulfosporosinus orientis	1563	S	4	0	4	0.00000
SRR6145059	Desulfosporosinus acidiphilus	885581	S	4	0	4	0.00000
SRR6145059	Desulfobacter postgatei	2293	S	3	1	4	0.00000
SRR6145059	Desulfitobacterium dehalogenans	36854	S	4	0	4	0.00000
SRR6145059	Dehalobacterium formicoaceticum	51515	S	4	0	4	0.00000
SRR6145059	Corynebacterium phage Adelaide	2588499	S	2	4	6	0.00000
SRR6145059	Colwellia sp. PAMC 21821	1816219	S	4	0	4	0.00000
SRR6145059	Clostridiales bacterium CCNA10	2109688	S	21	4	25	0.00000
SRR6145059	Chryseobacterium sp. StRB126	878220	S	74	4	78	0.00001
SRR6145059	Chromobacterium sp. 257-1	2605945	S	33	4	37	0.00000
SRR6145059	Chloroherpeton thalassium	100716	S	4	0	4	0.00000
SRR6145059	Chlorobium phaeobacteroides	1096	S	4	0	4	0.00000
SRR6145059	Cetia pacifica	1424653	S	4	0	4	0.00000
SRR6145059	Cellvibrio sp. PSBB023	1945512	S	72	4	76	0.00001
SRR6145059	Capnocytophaga sp. H4358	1945658	S	2	4	6	0.00000
SRR6145059	Candidatus Izimaplasma sp. HR1	1541959	S	4	0	4	0.00000
SRR6145059	Campylobacter sp. CCUG 57310	2517362	S	4	0	4	0.00000
SRR6145059	Campylobacter geochelonis	1780362	S	4	0	4	0.00000
SRR6145059	Campylobacter blaseri	2042961	S	4	0	4	0.00000
SRR6145059	Calothrix sp. 336/3	1337936	S	12	4	16	0.00000
SRR6145059	Caloranaerobacter azorensis	116090	S	4	0	4	0.00000
SRR6145059	Caldicellulosiruptor obsidiansis	717609	S	4	0	4	0.00000
SRR6145059	Caldicellulosiruptor changbaiensis	1222016	S	3	1	4	0.00000
SRR6145059	Burkholderia sp. MSMB0266	1637837	S	9	4	13	0.00000
SRR6145059	Burkholderia sp. LA-2-3-30-S1-D2	1637862	S	38	4	42	0.00000
SRR6145059	Burkholderia sp. DHOD12	2571746	S	351	4	355	0.00004
SRR6145059	Burkholderia sp. BDU8	1385592	S	73	4	77	0.00001
SRR6145059	Breoghania sp. L-A4	2304600	S	98	4	102	0.00001
SRR6145059	Blattabacterium punctulatus	164514	S	2	2	4	0.00000
SRR6145059	Blattabacterium cuenoti	1653831	S	4	0	4	0.00000
SRR6145059	Beggiatoa leptomitoformis	288004	S	4	0	4	0.00000
SRR6145059	Bdellovibrio sp. ZAP7	2231053	S	17	4	21	0.00000
SRR6145059	Bartonella schoenbuchensis	165694	S	3	1	4	0.00000
SRR6145059	Bartonella quintana	803	S	4	0	4	0.00000
SRR6145059	Bartonella henselae	38323	S	4	0	4	0.00000
SRR6145059	Bartonella birtlesii	111504	S	4	0	4	0.00000
SRR6145059	Bacillus vietnamensis	218284	S	4	0	4	0.00000
SRR6145059	Bacillus sp. SYJ	2529386	S	5	4	9	0.00000
SRR6145059	Bacillus mojavensis	72360	S	4	0	4	0.00000
SRR6145059	Bacillus halotolerans	260554	S	2	2	4	0.00000
SRR6145059	Aurantimicrobium sp. MWH-Uga1	2079575	S	12	4	16	0.00000
SRR6145059	Arthrobacter sp. YC-RL1	1652545	S	108	4	112	0.00001
SRR6145059	Arthrobacter sp. QXT-31	1357915	S	75	4	79	0.00001
SRR6145059	Arcobacter marinus	505249	S	3	1	4	0.00000
SRR6145059	Arcobacter lanthieri	1355374	S	4	0	4	0.00000
SRR6145059	Arcobacter canalis	1912871	S	3	1	4	0.00000
SRR6145059	Alteromonas naphthalenivorans	715451	S	4	0	4	0.00000
SRR6145059	Allopseudarcicella aquatilis	998844	S	4	0	4	0.00000
SRR6145059	Adlercreutzia sp. 8CFCBH1	2707299	S	10	4	14	0.00000
SRR6145059	Actinobacillus suis	716	S	4	0	4	0.00000
SRR6145059	Acinetobacter virus WCHABP1	2560272	S	1	4	5	0.00000
SRR6145059	Acidianus sulfidivorans	312539	S	4	0	4	0.00000
SRR6145059	Acidaminococcus fermentans	905	S	4	0	4	0.00000
SRR6145059	Acholeplasma brassicae	61635	S	4	0	4	0.00000
SRR6145059	Acetohalobium arabaticum	28187	S	4	0	4	0.00000
SRR6145059	Absiella sp. 9CBEGH2	2583452	S	1	4	5	0.00000
SRR6145059	[Bacillus] selenitireducens	85683	S	3	0	3	0.00000
SRR6145059	Yersinia mollaretii	33060	S	3	0	3	0.00000
SRR6145059	Xenorhabdus doucetiae	351671	S	3	0	3	0.00000
SRR6145059	Wolinella succinogenes	844	S	3	0	3	0.00000
SRR6145059	Weissella cryptocerci	2506420	S	3	0	3	0.00000
SRR6145059	Waddlia chondrophila	71667	S	3	0	3	0.00000
SRR6145059	Vibrio tubiashii	29498	S	3	0	3	0.00000
SRR6145059	Vibrio sp. dhg	2163016	S	3	3	6	0.00000
SRR6145059	Vibrio mimicus	674	S	3	0	3	0.00000
SRR6145059	Vibrio cyclitrophicus	47951	S	3	0	3	0.00000
SRR6145059	Vibrio coralliilyticus	190893	S	3	0	3	0.00000
SRR6145059	Vibrio chagasii	170679	S	3	0	3	0.00000
SRR6145059	Verrucomicrobia bacterium IMCC26134	1637999	S	48	3	51	0.00001
SRR6145059	Undibacterium sp. YM2	2058625	S	21	3	24	0.00000
SRR6145059	Thiomicrorhabdus aquaedulcis	2211106	S	3	0	3	0.00000
SRR6145059	Thermosediminibacter oceani	291990	S	3	0	3	0.00000
SRR6145059	Thermofilum pendens	2269	S	3	0	3	0.00000
SRR6145059	Thermodesulfobium narugense	184064	S	3	0	3	0.00000
SRR6145059	Thermodesulfobium acidiphilum	1794699	S	3	0	3	0.00000
SRR6145059	Thermocrinis ruber	75906	S	3	0	3	0.00000
SRR6145059	Thermococcus sp. 5-4	2008440	S	2	3	5	0.00000
SRR6145059	Thermococcus profundus	49899	S	3	0	3	0.00000
SRR6145059	Thermococcus guaymasensis	110164	S	3	0	3	0.00000
SRR6145059	Syntrophothermus lipocalidus	86170	S	3	0	3	0.00000
SRR6145059	Synechococcus sp. WH 8109	166314	S	3	0	3	0.00000
SRR6145059	Synechococcus sp. PCC 7003	374981	S	3	0	3	0.00000
SRR6145059	Synechococcus lividus	33070	S	3	0	3	0.00000
SRR6145059	Sulfurimonas gotlandica	1176482	S	3	0	3	0.00000
SRR6145059	Streptomyces sp. NHF165	2175864	S	117	3	120	0.00001
SRR6145059	Sterolibacteriaceae bacterium J5B	2211108	S	24	3	27	0.00000
SRR6145059	Spiroplasma turonicum	216946	S	3	0	3	0.00000
SRR6145059	Spiroplasma sabaudiense	216944	S	3	0	3	0.00000
SRR6145059	Spiroplasma poulsonii	2138	S	3	0	3	0.00000
SRR6145059	Spiroplasma eriocheiris	315358	S	3	0	3	0.00000
SRR6145059	Spiroplasma culicicola	216935	S	3	0	3	0.00000
SRR6145059	Spiroplasma citri	2133	S	1	2	3	0.00000
SRR6145059	Sphingosinicella sp. BN140058	1892855	S	249	3	252	0.00003
SRR6145059	Sphingomonas sp. HDW15C	2714944	S	112	3	115	0.00001
SRR6145059	Sphaerochaeta coccoides	273376	S	3	0	3	0.00000
SRR6145059	Sinimarinibacterium sp. NLF-5-8	2698684	S	45	3	48	0.00001
SRR6145059	Shewanella woodyi	60961	S	3	0	3	0.00000
SRR6145059	Shewanella violacea	60217	S	3	0	3	0.00000
SRR6145059	Shewanella sp. SNU WT4	2590015	S	3	0	3	0.00000
SRR6145059	Shewanella polaris	2588449	S	2	1	3	0.00000
SRR6145059	Salinibacterium sp. dk2585	2603292	S	65	3	68	0.00001
SRR6145059	Salimicrobium jeotgali	1230341	S	3	0	3	0.00000
SRR6145059	Rufibacter sp. DG15C	1379909	S	12	3	15	0.00000
SRR6145059	Ruegeria sp. TM1040	292414	S	26	3	29	0.00000
SRR6145059	Rodentibacter pneumotropicus	758	S	3	0	3	0.00000
SRR6145059	Rodentibacter heylii	1906744	S	1	2	3	0.00000
SRR6145059	Rickettsia philipii	1105106	S	1	2	3	0.00000
SRR6145059	Pyrobaculum neutrophilum	70771	S	3	0	3	0.00000
SRR6145059	Psychrobacter sp. FME2	86185	S	83	3	86	0.00001
SRR6145059	Psychrobacillus sp. AK 1817	2303505	S	3	0	3	0.00000
SRR6145059	Pseudomonas virus MP1412	1981049	S	2	3	5	0.00000
SRR6145059	Pseudomonas sp. UW4	1207075	S	33	3	36	0.00000
SRR6145059	Pseudomonas sp. TCU-HL1	1856685	S	83	3	86	0.00001
SRR6145059	Pseudomonas sp. S35	1573719	S	22	3	25	0.00000
SRR6145059	Pseudomonas sp. R32	1573704	S	40	3	43	0.00001
SRR6145059	Pseudomonas sp. R2-37-08W	1173273	S	1	3	4	0.00000
SRR6145059	Pseudomonas sp. NS1(2017)	2025658	S	17	3	20	0.00000
SRR6145059	Pseudomonas sp. Leaf58	1736226	S	49	3	52	0.00001
SRR6145059	Pseudomonas sp. LG1E9	2219057	S	24	3	27	0.00000
SRR6145059	Pseudomonadaceae bacterium SI-3	2079806	S	5	3	8	0.00000
SRR6145059	Pseudodesulfovibrio piezophilus	879567	S	3	0	3	0.00000
SRR6145059	Pseudobutyrivibrio xylanivorans	185007	S	3	0	3	0.00000
SRR6145059	Pseudoalteromonas ruthenica	151081	S	2	1	3	0.00000
SRR6145059	Pseudoalteromonas issachenkonii	152297	S	1	2	3	0.00000
SRR6145059	Pseudoalteromonas carrageenovora	227	S	3	0	3	0.00000
SRR6145059	Pseudoalteromonas aliena	247523	S	3	0	3	0.00000
SRR6145059	Providencia sp. WCHPHu000369	2027290	S	2	3	5	0.00000
SRR6145059	Prosthecochloris sp. CIB 2401	1868325	S	3	0	3	0.00000
SRR6145059	Prosthecochloris aestuarii	1102	S	3	0	3	0.00000
SRR6145059	Prochlorococcus sp. MIT 0604	1501268	S	3	7	10	0.00000
SRR6145059	Pontibacter sp. SGAir0037	2571030	S	19	3	22	0.00000
SRR6145059	Pleurocapsa minor	54308	S	3	0	3	0.00000
SRR6145059	Planococcus halocryophilus	1215089	S	3	0	3	0.00000
SRR6145059	Planctomycetes bacterium I41	2528024	S	84	3	87	0.00001
SRR6145059	Pigmentiphaga sp. H8	2488560	S	120	3	123	0.00001
SRR6145059	Petrotoga mobilis	69499	S	3	0	3	0.00000
SRR6145059	Pelosinus fermentans	365349	S	3	0	3	0.00000
SRR6145059	Pediococcus inopinatus	114090	S	3	0	3	0.00000
SRR6145059	Pediococcus damnosus	51663	S	3	0	3	0.00000
SRR6145059	Pediococcus claussenii	187452	S	3	0	3	0.00000
SRR6145059	Pectobacterium punjabense	2108399	S	3	0	3	0.00000
SRR6145059	Parashewanella spongiae	342950	S	3	0	3	0.00000
SRR6145059	Parachlamydia acanthamoebae	83552	S	3	0	3	0.00000
SRR6145059	Pajaroellobacter abortibovis	1882918	S	3	0	3	0.00000
SRR6145059	Paenibacillus swuensis	1178515	S	3	0	3	0.00000
SRR6145059	Paenibacillus sp. FSL R5-0912	1536771	S	3	1	4	0.00000
SRR6145059	Paenibacillus antarcticus	253703	S	3	0	3	0.00000
SRR6145059	Oscillatoria acuminata	118323	S	3	0	3	0.00000
SRR6145059	Orpheovirus IHUMI-LCC2	2023057	S	3	0	3	0.00000
SRR6145059	Oceanicoccus sagamiensis	716816	S	3	0	3	0.00000
SRR6145059	Noviherbaspirillum sp. UKPF54	2601898	S	94	3	97	0.00001
SRR6145059	Nonlabens sp. MIC269	1476901	S	3	3	6	0.00000
SRR6145059	Nitrososphaera viennensis	1034015	S	3	0	3	0.00000
SRR6145059	Nitrosococcus wardiae	1814290	S	3	0	3	0.00000
SRR6145059	Nibribacter sp. BT10	2698458	S	13	3	16	0.00000
SRR6145059	Neorickettsia helminthoeca	33994	S	3	0	3	0.00000
SRR6145059	Myroides sp. ZB35	1458492	S	2	3	5	0.00000
SRR6145059	Mycoplasma synoviae	2109	S	3	0	3	0.00000
SRR6145059	Mycoplasma struthionis	538220	S	3	0	3	0.00000
SRR6145059	Mycoplasma sp. Mirounga ES2806-GEN	754515	S	3	0	3	0.00000
SRR6145059	Mycoplasma phocirhinis	142650	S	3	0	3	0.00000
SRR6145059	Mycoplasma penetrans	28227	S	3	0	3	0.00000
SRR6145059	Mycoplasma parvum	984991	S	3	0	3	0.00000
SRR6145059	Mycoplasma glycophilum	171285	S	3	0	3	0.00000
SRR6145059	Mycoplasma gallopavonis	76629	S	3	0	3	0.00000
SRR6145059	Mycoplasma columbinum	114881	S	3	0	3	0.00000
SRR6145059	Mycoplasma arginini	2094	S	3	0	3	0.00000
SRR6145059	Mycobacterium sp. MOTT36Y	1168287	S	5	3	8	0.00000
SRR6145059	Mycobacterium sp. JS623	212767	S	224	3	227	0.00003
SRR6145059	Moritella marina	90736	S	3	0	3	0.00000
SRR6145059	Methylovorus glucosotrophus	266009	S	2	1	3	0.00000
SRR6145059	Methylacidiphilum infernorum	511746	S	3	0	3	0.00000
SRR6145059	Methanotorris igneus	2189	S	3	0	3	0.00000
SRR6145059	Methanospirillum hungatei	2203	S	3	0	3	0.00000
SRR6145059	Methanosphaerula palustris	475088	S	3	0	3	0.00000
SRR6145059	Methanosphaera stadtmanae	2317	S	3	0	3	0.00000
SRR6145059	Methanosarcina vacuolata	2215	S	2	1	3	0.00000
SRR6145059	Methanoplanus limicola	2315	S	3	0	3	0.00000
SRR6145059	Methanohalophilus halophilus	2177	S	2	1	3	0.00000
SRR6145059	Methanocaldococcus infernus	67760	S	3	0	3	0.00000
SRR6145059	Methanobrevibacter olleyae	294671	S	3	0	3	0.00000
SRR6145059	Methanobacterium subterraneum	59277	S	2	1	3	0.00000
SRR6145059	Methanobacterium paludis	868131	S	3	0	3	0.00000
SRR6145059	Methanobacterium lacus	877455	S	3	0	3	0.00000
SRR6145059	Methanobacterium congolense	118062	S	3	0	3	0.00000
SRR6145059	Mesotoga prima	1184387	S	3	0	3	0.00000
SRR6145059	Mesoplasma tabanidae	219745	S	3	0	3	0.00000
SRR6145059	Mesoplasma entomophilum	2149	S	3	0	3	0.00000
SRR6145059	Marinobacter psychrophilus	330734	S	2	1	3	0.00000
SRR6145059	Longibaculum sp. KGMB06250	2584943	S	11	3	14	0.00000
SRR6145059	Listeria welshimeri	1643	S	3	0	3	0.00000
SRR6145059	Leucobacter sp. HDW9C	2714935	S	46	3	49	0.00001
SRR6145059	Leptospirillum ferrooxidans	180	S	3	0	3	0.00000
SRR6145059	Leptolyngbya sp. O-77	1080068	S	21	3	24	0.00000
SRR6145059	Lentibacillus amyloliquefaciens	1472767	S	3	0	3	0.00000
SRR6145059	Lactococcus sp. KACC 19320	2592653	S	3	0	3	0.00000
SRR6145059	Lactobacillus sp. P38	2692756	S	32	3	35	0.00000
SRR6145059	Lactobacillus malefermentans	176292	S	3	0	3	0.00000
SRR6145059	Lactobacillus lindneri	53444	S	3	0	3	0.00000
SRR6145059	Lactobacillus hilgardii	1588	S	3	0	3	0.00000
SRR6145059	Lactobacillus heilongjiangensis	1074467	S	3	0	3	0.00000
SRR6145059	Lactobacillus ginsenosidimutans	1007676	S	3	0	3	0.00000
SRR6145059	Lactobacillus gastricus	227942	S	3	0	3	0.00000
SRR6145059	Lactobacillus fuchuensis	164393	S	3	0	3	0.00000
SRR6145059	Lactobacillus bifermentans	1607	S	3	0	3	0.00000
SRR6145059	Lactobacillus apis	303541	S	3	0	3	0.00000
SRR6145059	Lactobacillus animalis	1605	S	3	0	3	0.00000
SRR6145059	Lactobacillus acidophilus	1579	S	3	0	3	0.00000
SRR6145059	Lachnoclostridium phocaeense	1871021	S	3	0	3	0.00000
SRR6145059	Jatrophihabitans sp. GAS493	1907575	S	76	3	79	0.00001
SRR6145059	Ignicoccus hospitalis	160233	S	3	0	3	0.00000
SRR6145059	Hymenobacter sp. BT182	2697562	S	62	3	65	0.00001
SRR6145059	Herbinix luporum	1679721	S	3	0	3	0.00000
SRR6145059	Heliorestis convoluta	356322	S	3	0	3	0.00000
SRR6145059	Helicobacter felis	214	S	3	0	3	0.00000
SRR6145059	Helicobacter canis	29419	S	3	0	3	0.00000
SRR6145059	Haloquadratum walsbyi	293091	S	3	0	3	0.00000
SRR6145059	Halomonas sp. THAF5a	2587844	S	54	3	57	0.00001
SRR6145059	Halobacillus litoralis	45668	S	3	0	3	0.00000
SRR6145059	Gudongella oleilytica	1582259	S	3	0	3	0.00000
SRR6145059	Gordonia virus Getalong	2734200	S	3	3	6	0.00000
SRR6145059	Gordonia virus BENtherdunthat	2734199	S	3	3	6	0.00000
SRR6145059	Geobacter sp. M18	443143	S	30	3	33	0.00000
SRR6145059	Geobacillus sp. C56-T3	691437	S	1	3	4	0.00000
SRR6145059	Gemella sp. ND 6198	2040624	S	3	9	12	0.00000
SRR6145059	Gammapapillomavirus 18	1513263	S	3	0	3	0.00000
SRR6145059	Frankineae bacterium MT45	1882833	S	65	3	68	0.00001
SRR6145059	Francisella persica	954	S	3	0	3	0.00000
SRR6145059	Francisella halioticida	549298	S	3	0	3	0.00000
SRR6145059	Francisella frigiditurris	1542390	S	3	0	3	0.00000
SRR6145059	Euhalothece natronophila	577489	S	3	0	3	0.00000
SRR6145059	Escherichia virus WA45	1945582	S	1	3	4	0.00000
SRR6145059	Entomoplasma somnilux	215578	S	3	0	3	0.00000
SRR6145059	Entomoplasma freundtii	74700	S	3	0	3	0.00000
SRR6145059	Enterococcus sp. CR-Ec1	2057791	S	4	3	7	0.00000
SRR6145059	Endomicrobium proavitum	1408281	S	3	0	3	0.00000
SRR6145059	Ectothiorhodospira sp. BSL-9	1442136	S	18	3	21	0.00000
SRR6145059	Dictyoglomus thermophilum	14	S	3	0	3	0.00000
SRR6145059	Dickeya sp. Secpp 1600	2037915	S	3	18	21	0.00000
SRR6145059	Dickeya sp. NCPPB 3274	568766	S	3	1	4	0.00000
SRR6145059	Dichelobacter nodosus	870	S	3	0	3	0.00000
SRR6145059	Desulfovibrio salexigens	880	S	3	0	3	0.00000
SRR6145059	Desulfocapsa sulfexigens	65555	S	3	0	3	0.00000
SRR6145059	Desulfitobacterium metallireducens	142877	S	3	0	3	0.00000
SRR6145059	Defluviitoga tunisiensis	1006576	S	3	0	3	0.00000
SRR6145059	Cycloclasticus zancles	1329899	S	3	0	3	0.00000
SRR6145059	Cuniculiplasma divulgatum	1673428	S	3	0	3	0.00000
SRR6145059	Coxiella burnetii	777	S	2	1	3	0.00000
SRR6145059	Colwellia beringensis	1967665	S	3	0	3	0.00000
SRR6145059	Citrobacter sp. LY-1	2546350	S	17	3	20	0.00000
SRR6145059	Chlorobium phaeovibrioides	1094	S	3	0	3	0.00000
SRR6145059	Chlamydia suis	83559	S	3	0	3	0.00000
SRR6145059	Chlamydia psittaci	83554	S	3	0	3	0.00000
SRR6145059	Chitinophaga sp. H33E-04	2703787	S	16	3	19	0.00000
SRR6145059	Carboxydothermus hydrogenoformans	129958	S	3	0	3	0.00000
SRR6145059	Candidatus Pelagibacter sp. RS39	1977864	S	3	0	3	0.00000
SRR6145059	Campylobacter volucris	1031542	S	3	0	3	0.00000
SRR6145059	Campylobacter peloridis	488546	S	3	0	3	0.00000
SRR6145059	Campylobacter iguaniorum	1244531	S	3	0	3	0.00000
SRR6145059	Campylobacter helveticus	28898	S	3	0	3	0.00000
SRR6145059	Campylobacter corcagiensis	1448857	S	3	0	3	0.00000
SRR6145059	Campylobacter canadensis	449520	S	3	0	3	0.00000
SRR6145059	Campylobacter avium	522485	S	3	0	3	0.00000
SRR6145059	Caldimicrobium thiodismutans	1653476	S	3	0	3	0.00000
SRR6145059	Caldicellulosiruptor owensensis	55205	S	3	0	3	0.00000
SRR6145059	Butyrivibrio fibrisolvens	831	S	3	0	3	0.00000
SRR6145059	Burkholderia sp. Bp7605	1740163	S	163	3	166	0.00002
SRR6145059	Burkholderia sp. BDU6	1385591	S	44	3	47	0.00001
SRR6145059	Brevibacillus sp. 7WMA2	2683193	S	1	3	4	0.00000
SRR6145059	Brevibacillus formosus	54913	S	3	0	3	0.00000
SRR6145059	Brevefilum fermentans	1986204	S	3	0	3	0.00000
SRR6145059	Borreliella burgdorferi	139	S	3	0	3	0.00000
SRR6145059	Borrelia duttonii	40834	S	1	2	3	0.00000
SRR6145059	Bordetella sp. N	1746199	S	91	3	94	0.00001
SRR6145059	Bordetella genomosp. 9	1416803	S	69	3	72	0.00001
SRR6145059	Blattabacterium sp. (Nauphoeta cinerea)	1316444	S	3	0	3	0.00000
SRR6145059	Basfia succiniciproducens	653940	S	1	2	3	0.00000
SRR6145059	Bartonella tribocorum	85701	S	1	2	3	0.00000
SRR6145059	Bartonella krasnovii	2267275	S	2	1	3	0.00000
SRR6145059	Bacteroides caecimuris	1796613	S	3	0	3	0.00000
SRR6145059	Bacillus tequilensis	227866	S	3	0	3	0.00000
SRR6145059	Bacillus sp. N1-1	2682541	S	5	3	8	0.00000
SRR6145059	Bacillus sonorensis	119858	S	3	0	3	0.00000
SRR6145059	Bacillus smithii	1479	S	3	0	3	0.00000
SRR6145059	Bacillus methanolicus	1471	S	3	0	3	0.00000
SRR6145059	Bacillus lehensis	300825	S	3	0	3	0.00000
SRR6145059	Bacillus asahii	228899	S	3	0	3	0.00000
SRR6145059	Arthrobacter sp. YN	2020486	S	54	3	57	0.00001
SRR6145059	Arthrobacter sp. Rue61a	1118963	S	1	3	4	0.00000
SRR6145059	Arthrobacter sp. PGP41	2079227	S	61	3	64	0.00001
SRR6145059	Arcobacter sp. LPB0137	1850254	S	3	3	6	0.00000
SRR6145059	Aquitalea sp. THG-DN7.12	1537400	S	42	3	45	0.00001
SRR6145059	Aquifex aeolicus	63363	S	3	0	3	0.00000
SRR6145059	Allofrancisella guangzhouensis	594679	S	3	0	3	0.00000
SRR6145059	Aeromonas sp. CA23	2033032	S	18	3	21	0.00000
SRR6145059	Actinobacillus succinogenes	67854	S	3	0	3	0.00000
SRR6145059	Actinobacillus lignieresii	720	S	3	0	3	0.00000
SRR6145059	Actinobacillus indolicus	51049	S	3	0	3	0.00000
SRR6145059	Acinetobacter sp. NCu2D-2	1608473	S	39	3	42	0.00000
SRR6145059	Acidithiobacillus thiooxidans	930	S	3	0	3	0.00000
SRR6145059	Acidianus brierleyi	41673	S	3	0	3	0.00000
SRR6145059	Achromobacter sp. B7	2282475	S	40	3	43	0.00001
SRR6145059	Acetobacterium woodii	33952	S	3	0	3	0.00000
SRR6145059	uncultured crAssphage	1211417	S	2	0	2	0.00000
SRR6145059	bacterium BFN5	2717699	S	2	0	2	0.00000
SRR6145059	Yersinia hibernica	2339259	S	1	1	2	0.00000
SRR6145059	Vulcanisaeta moutnovskia	985052	S	2	0	2	0.00000
SRR6145059	Vulcanisaeta distributa	164451	S	2	0	2	0.00000
SRR6145059	Vogesella sp. LIG4	1192162	S	57	2	59	0.00001
SRR6145059	Virgibacillus dokdonensis	302167	S	2	0	2	0.00000
SRR6145059	Vibrio qinghaiensis	2025808	S	2	0	2	0.00000
SRR6145059	Vibrio hyugaensis	1534743	S	2	0	2	0.00000
SRR6145059	Ureaplasma urealyticum	2130	S	2	0	2	0.00000
SRR6145059	Turicibacter sanguinis	154288	S	2	0	2	0.00000
SRR6145059	Treponema pallidum	160	S	1	1	2	0.00000
SRR6145059	Tobacco vein clearing virus	107324	S	2	0	2	0.00000
SRR6145059	Thermotoga sp. RQ2	126740	S	1	2	3	0.00000
SRR6145059	Thermotoga profunda	1508420	S	2	0	2	0.00000
SRR6145059	Thermotoga petrophila	93929	S	1	1	2	0.00000
SRR6145059	Thermotoga caldifontis	1508419	S	2	0	2	0.00000
SRR6145059	Thermosulfuriphilus ammonigenes	1936021	S	2	0	2	0.00000
SRR6145059	Thermosulfurimonas marina	2047767	S	2	0	2	0.00000
SRR6145059	Thermoleptolyngbya sp. PKUAC-SCTA183	2737172	S	13	2	15	0.00000
SRR6145059	Thermofilum adornatum	1365176	S	2	0	2	0.00000
SRR6145059	Thermodesulfobacterium commune	1741	S	2	0	2	0.00000
SRR6145059	Thermodesulfatator indicus	171695	S	2	0	2	0.00000
SRR6145059	Thermocrinis albus	136094	S	2	0	2	0.00000
SRR6145059	Thermococcus peptonophilus	53952	S	2	0	2	0.00000
SRR6145059	Thermococcus gammatolerans	187878	S	2	0	2	0.00000
SRR6145059	Thermococcus cleftensis	163003	S	2	0	2	0.00000
SRR6145059	Thermococcus celer	2264	S	2	0	2	0.00000
SRR6145059	Thermococcus barossii	54077	S	2	0	2	0.00000
SRR6145059	Tanapox virus	99000	S	2	0	2	0.00000
SRR6145059	Syntrophomonas wolfei	863	S	2	0	2	0.00000
SRR6145059	Syntrophobotulus glycolicus	51197	S	2	0	2	0.00000
SRR6145059	Synechococcus sp. PCC 7117	195498	S	2	1	3	0.00000
SRR6145059	Sulfurospirillum cavolei	366522	S	2	0	2	0.00000
SRR6145059	Sulfurisphaera tokodaii	111955	S	2	0	2	0.00000
SRR6145059	Sulfuricurvum kujiense	148813	S	2	0	2	0.00000
SRR6145059	Streptococcus virus phiAbc2	633135	S	3	2	5	0.00000
SRR6145059	Streptococcus sp. HSISB1	1316409	S	2	2	4	0.00000
SRR6145059	Streptococcus phage PH10	644007	S	10	2	12	0.00000
SRR6145059	Staphylococcus virus Sextaec	1922246	S	12	2	14	0.00000
SRR6145059	Staphylococcus virus JD7	1924729	S	1	2	3	0.00000
SRR6145059	Staphylococcus virus BP39	2732596	S	1	2	3	0.00000
SRR6145059	Sporosarcina ureilytica	298596	S	2	0	2	0.00000
SRR6145059	Spirosoma sp. TS118	2735870	S	33	2	35	0.00000
SRR6145059	Spirosoma sp. CJU-R4	2728024	S	43	2	45	0.00001
SRR6145059	Spiroplasma taiwanense	2145	S	2	0	2	0.00000
SRR6145059	Spiroplasma melliferum	2134	S	1	1	2	0.00000
SRR6145059	Spiroplasma kunkelii	47834	S	1	1	2	0.00000
SRR6145059	Spiroplasma clarkii	2139	S	2	0	2	0.00000
SRR6145059	Spiroplasma alleghenense	216931	S	2	0	2	0.00000
SRR6145059	Sphingomonas sp. HDW15B	2714943	S	113	2	115	0.00001
SRR6145059	Sphingomonas sp. CSW-10	2698828	S	121	2	123	0.00001
SRR6145059	Sphaerochaeta globosa	1131703	S	2	0	2	0.00000
SRR6145059	Shewanella sp. MEBiC00475	2575361	S	3	2	5	0.00000
SRR6145059	Shewanella aestuarii	1028752	S	2	0	2	0.00000
SRR6145059	Serratia sp. KUDC3025	2597702	S	7	2	9	0.00000
SRR6145059	Sedimentisphaera salicampi	1941349	S	2	0	2	0.00000
SRR6145059	Salmonella virus FSL SP-076	2170217	S	2	0	2	0.00000
SRR6145059	Ruegeria sp. AD91A	2293862	S	21	2	23	0.00000
SRR6145059	Rickettsia typhi	785	S	2	0	2	0.00000
SRR6145059	Rickettsia sibirica	35793	S	1	1	2	0.00000
SRR6145059	Rickettsia peacockii	47589	S	1	1	2	0.00000
SRR6145059	Rickettsia japonica	35790	S	1	1	2	0.00000
SRR6145059	Rickettsia conorii	781	S	1	1	2	0.00000
SRR6145059	Rickettsia canadensis	788	S	2	0	2	0.00000
SRR6145059	Rickettsia africae	35788	S	1	1	2	0.00000
SRR6145059	Rhodococcus sp. WMMA185	679318	S	93	2	95	0.00001
SRR6145059	Rhodococcus sp. P1Y	1302308	S	100	2	102	0.00001
SRR6145059	Rhizobium sp. NXC24	2048897	S	47	2	49	0.00001
SRR6145059	Rhizobium sp. 11515TR	2028343	S	51	2	53	0.00001
SRR6145059	Pyrolobus fumarii	54252	S	2	0	2	0.00000
SRR6145059	Pyrococcus kukulkanii	1609559	S	2	0	2	0.00000
SRR6145059	Pyrococcus horikoshii	53953	S	2	0	2	0.00000
SRR6145059	Pyrobaculum islandicum	2277	S	2	0	2	0.00000
SRR6145059	Pseudomonas sp. StFLB209	1028989	S	57	2	59	0.00001
SRR6145059	Pseudomonas sp. S34	1573718	S	21	2	23	0.00000
SRR6145059	Pseudomonas sp. S1-A32-2	2731681	S	95	2	97	0.00001
SRR6145059	Pseudomonas sp. R84	1573712	S	13	2	15	0.00000
SRR6145059	Pseudomonas sp. R5-89-07	658644	S	14	2	16	0.00000
SRR6145059	Pseudomonas sp. MPC6	2498848	S	26	2	28	0.00000
SRR6145059	Pseudomonas sp. IB20	1702250	S	12	2	14	0.00000
SRR6145059	Pseudomonas sp. DY-1	1755504	S	67	2	69	0.00001
SRR6145059	Pseudomonas sp. DTU12.3	2073078	S	22	2	24	0.00000
SRR6145059	Pseudomonas sp. DTU12.1	2654238	S	1	2	3	0.00000
SRR6145059	Pseudomonas sp. ADAK13	2730847	S	15	2	17	0.00000
SRR6145059	Pseudomonas sp. 31-12	2201356	S	16	2	18	0.00000
SRR6145059	Pseudomonas sp. 11K1	2505979	S	22	2	24	0.00000
SRR6145059	Pseudomonas cerasi	1583341	S	1	1	2	0.00000
SRR6145059	Pseudogulbenkiania sp. NH8B	748280	S	56	2	58	0.00001
SRR6145059	Pseudoalteromonas arctica	394751	S	2	0	2	0.00000
SRR6145059	Pseudactinotalea sp. HY158	2654547	S	145	2	147	0.00002
SRR6145059	Proteus columbae	1987580	S	2	0	2	0.00000
SRR6145059	Propionimicrobium sp. Marseille-P3275	1871034	S	82	2	84	0.00001
SRR6145059	Polynucleobacter duraquae	1835254	S	2	0	2	0.00000
SRR6145059	Planococcus maritimus	192421	S	2	0	2	0.00000
SRR6145059	Planococcus faecalis	1598147	S	1	1	2	0.00000
SRR6145059	Planococcus antarcticus	161360	S	2	0	2	0.00000
SRR6145059	Planctomycetes bacterium Poly24	2528017	S	10	2	12	0.00000
SRR6145059	Planctomycetes bacterium Pan153	2528029	S	2	2	4	0.00000
SRR6145059	Pigeonpox virus	10264	S	2	0	2	0.00000
SRR6145059	Picrophilus torridus	82076	S	2	0	2	0.00000
SRR6145059	Photorhabdus laumondii	2218628	S	2	0	2	0.00000
SRR6145059	Phoenicibacter congonensis	1944646	S	2	0	2	0.00000
SRR6145059	Persephonella marina	309805	S	2	0	2	0.00000
SRR6145059	Pepper chlorotic spot virus	1414655	S	2	0	2	0.00000
SRR6145059	Pedobacter sp. KBS0701	2578106	S	27	2	29	0.00000
SRR6145059	Parageobacillus toebii	153151	S	2	0	2	0.00000
SRR6145059	Pantoea sp. SO10	2575375	S	43	2	45	0.00001
SRR6145059	Pandoravirus inopinatum	1605721	S	2	0	2	0.00000
SRR6145059	Paenibacillus sp. Y412MC10	481743	S	12	2	14	0.00000
SRR6145059	Paenibacillus sp. FSL R5-0345	1536770	S	2	0	2	0.00000
SRR6145059	Paenibacillus sp. Cedars	1980674	S	1	2	3	0.00000
SRR6145059	Ostreococcus lucimarinus virus 1	880162	S	2	0	2	0.00000
SRR6145059	Orgyia pseudotsugata multiple nucleopolyhedrovirus	262177	S	2	0	2	0.00000
SRR6145059	Oenococcus oeni	1247	S	2	0	2	0.00000
SRR6145059	Oceanicola sp. D3	2587163	S	105	2	107	0.00001
SRR6145059	Nostoc sp. TCL240-02	2572090	S	5	2	7	0.00000
SRR6145059	Nitrosomonas stercoris	1444684	S	2	0	2	0.00000
SRR6145059	Neokomagataea tanensis	661191	S	2	0	2	0.00000
SRR6145059	Nautilia profundicola	244787	S	2	0	2	0.00000
SRR6145059	Nanohaloarchaea archaeon	2594798	S	2	0	2	0.00000
SRR6145059	Mycoplasma hyopneumoniae	2099	S	2	0	2	0.00000
SRR6145059	Mycoplasma edwardii	53558	S	2	0	2	0.00000
SRR6145059	Mycoplasma columborale	171282	S	2	0	2	0.00000
SRR6145059	Mycoplasma bovoculi	45362	S	2	0	2	0.00000
SRR6145059	Mycoplasma bovis	28903	S	2	0	2	0.00000
SRR6145059	Mycoplasma agalactiae	2110	S	2	0	2	0.00000
SRR6145059	Mycobacterium virus Omega	205879	S	1	2	3	0.00000
SRR6145059	Mycobacterium phage Mulciber	1805459	S	1	2	3	0.00000
SRR6145059	Microcystis panniformis	513223	S	2	0	2	0.00000
SRR6145059	Methyloligella sp. GL2	2742204	S	60	2	62	0.00001
SRR6145059	Methanothrix soehngenii	2223	S	2	0	2	0.00000
SRR6145059	Methanothermococcus okinawensis	155863	S	2	0	2	0.00000
SRR6145059	Methanoregula boonei	358766	S	2	0	2	0.00000
SRR6145059	Methanolacinia petrolearia	54120	S	2	0	2	0.00000
SRR6145059	Methanohalobium evestigatum	2322	S	2	0	2	0.00000
SRR6145059	Methanococcoides burtonii	29291	S	2	0	2	0.00000
SRR6145059	Methanocaldococcus jannaschii	2190	S	2	0	2	0.00000
SRR6145059	Methanocaldococcus bathoardescens	1301915	S	2	0	2	0.00000
SRR6145059	Methanobrevibacter ruminantium	83816	S	2	0	2	0.00000
SRR6145059	Metallosphaera sedula	43687	S	2	0	2	0.00000
SRR6145059	Mesoplasma syrphidae	225999	S	2	0	2	0.00000
SRR6145059	Mesoplasma coleopterae	324078	S	2	0	2	0.00000
SRR6145059	Mesoplasma chauliocola	216427	S	2	0	2	0.00000
SRR6145059	Marinomonas mediterranea	119864	S	2	0	2	0.00000
SRR6145059	Marinobacter sp. BSs20148	490759	S	5	2	7	0.00000
SRR6145059	Marinobacter sp. Arc7-DN-1	2304594	S	36	2	38	0.00000
SRR6145059	Maribacter sp. 1_2014MBL_MicDiv	1644130	S	1	2	3	0.00000
SRR6145059	Lysobacter sp. HDW10	2714936	S	57	2	59	0.00001
SRR6145059	Listeria innocua	1642	S	2	0	2	0.00000
SRR6145059	Limnohabitans sp. 63ED37-2	1678128	S	60	2	62	0.00001
SRR6145059	Liberibacter crescens	1273132	S	2	0	2	0.00000
SRR6145059	Leucobacter sp. HDW9A	2714933	S	28	2	30	0.00000
SRR6145059	Leptospira weilii	28184	S	2	0	2	0.00000
SRR6145059	Leptospira mayottensis	1137606	S	2	0	2	0.00000
SRR6145059	Legionella waltersii	66969	S	2	0	2	0.00000
SRR6145059	Legionella hackeliae	449	S	2	0	2	0.00000
SRR6145059	Legionella clemsonensis	1867846	S	2	0	2	0.00000
SRR6145059	Legionella cherrii	28084	S	2	0	2	0.00000
SRR6145059	Leclercia sp. 29361	2714951	S	17	2	19	0.00000
SRR6145059	Lactobacillus rossiae	231049	S	2	0	2	0.00000
SRR6145059	Lactobacillus oligofermentans	293371	S	2	0	2	0.00000
SRR6145059	Lactobacillus jinshani	1720083	S	2	0	2	0.00000
SRR6145059	Lactobacillus hokkaidonensis	1193095	S	2	0	2	0.00000
SRR6145059	Lactobacillus futsaii	938155	S	2	0	2	0.00000
SRR6145059	Lactobacillus bombi	1303590	S	2	0	2	0.00000
SRR6145059	Lactobacillus alimentarius	1602	S	2	0	2	0.00000
SRR6145059	Lachnospiraceae bacterium GAM79	2109691	S	14	2	16	0.00000
SRR6145059	Kurthia sp. 11kri321	1750719	S	43	2	45	0.00001
SRR6145059	Kluyvera sp. PO2S7	2705459	S	33	2	35	0.00000
SRR6145059	Kangiella geojedonensis	914150	S	2	0	2	0.00000
SRR6145059	Intestinibaculum porci	2487118	S	2	0	2	0.00000
SRR6145059	Idiomarina piscisalsi	1096243	S	2	0	2	0.00000
SRR6145059	Hymenobacter sp. BT18	2724192	S	35	2	37	0.00000
SRR6145059	Hymenobacter sp. BRD128	2675878	S	49	2	51	0.00001
SRR6145059	Hydrogenobacter thermophilus	940	S	2	0	2	0.00000
SRR6145059	Herbaspirillum sp. meg3	2025949	S	75	2	77	0.00001
SRR6145059	Helicobacter suis	104628	S	2	0	2	0.00000
SRR6145059	Helicobacter sp. MIT 01-6242	222136	S	2	0	2	0.00000
SRR6145059	Helicobacter himalayensis	1591088	S	2	0	2	0.00000
SRR6145059	Helicobacter cholecystus	45498	S	2	0	2	0.00000
SRR6145059	Helicobacter bizzozeronii	56877	S	2	0	2	0.00000
SRR6145059	Halothece sp. PCC 7418	65093	S	2	0	2	0.00000
SRR6145059	Halomonas sp. N3-2A	2014541	S	14	2	16	0.00000
SRR6145059	Haloactinobacterium sp. HY164	2675754	S	159	2	161	0.00002
SRR6145059	Hahella sp. KA22	1628392	S	15	2	17	0.00000
SRR6145059	Gordonia virus Apricot	2734216	S	2	2	4	0.00000
SRR6145059	Gimesia sp. E7	2608982	S	1	2	3	0.00000
SRR6145059	Geoglobus ahangari	113653	S	2	0	2	0.00000
SRR6145059	Geobacter sp. M21	443144	S	17	2	19	0.00000
SRR6145059	Geobacillus sp. E263	391290	S	2	2	4	0.00000
SRR6145059	Gammapapillomavirus 9	1175851	S	2	0	2	0.00000
SRR6145059	Gammapapillomavirus 19	1513264	S	2	0	2	0.00000
SRR6145059	Flexistipes sinusarabici	2352	S	2	0	2	0.00000
SRR6145059	Flavobacterium sp. KBS0721	1179672	S	43	2	45	0.00001
SRR6145059	Flavobacterium sp. HYN0086	2249356	S	20	2	22	0.00000
SRR6145059	Fischerella sp. NIES-3754	1752063	S	10	2	12	0.00000
SRR6145059	Escherichia virus ID52	1910968	S	3	2	5	0.00000
SRR6145059	Erythrobacter sp. KY5	2011159	S	68	2	70	0.00001
SRR6145059	Erwinia sp. QL-Z3	2547962	S	1	2	3	0.00000
SRR6145059	Entomoplasma luminosum	214888	S	2	0	2	0.00000
SRR6145059	Enterococcus sp. FDAARGOS_375	2060307	S	6	2	8	0.00000
SRR6145059	Enterobacter sp. R4-368	1166130	S	5	2	7	0.00000
SRR6145059	Elusimicrobium minutum	423605	S	2	0	2	0.00000
SRR6145059	Ehrlichia canis	944	S	2	0	2	0.00000
SRR6145059	Dysgonomonas sp. HDW5B	2714927	S	7	2	9	0.00000
SRR6145059	Dyokappapapillomavirus 4	2169879	S	2	0	2	0.00000
SRR6145059	Dokdonia sp. MED134	313590	S	3	2	5	0.00000
SRR6145059	Diaminobutyricimonas sp. LJ205	2683590	S	59	2	61	0.00001
SRR6145059	Desulfurobacterium thermolithotrophum	64160	S	2	0	2	0.00000
SRR6145059	Desulfotomaculum reducens	59610	S	2	0	2	0.00000
SRR6145059	Desulfosporosinus meridiei	79209	S	2	0	2	0.00000
SRR6145059	Desulfobacterium autotrophicum	2296	S	2	0	2	0.00000
SRR6145059	Dehalogenimonas formicexedens	1839801	S	2	0	2	0.00000
SRR6145059	Dehalobacter restrictus	55583	S	2	0	2	0.00000
SRR6145059	Cyanobium sp. NIES-981	1851505	S	24	2	26	0.00000
SRR6145059	Coriobacteriaceae bacterium 68-1-3	1531429	S	11	2	13	0.00000
SRR6145059	Conexivisphaera calidus	1874277	S	2	0	2	0.00000
SRR6145059	Chromobacterium sp. IIBBL 112-1	2202141	S	2	8	10	0.00000
SRR6145059	Chlorobium chlorochromatii	337090	S	2	0	2	0.00000
SRR6145059	Chlamydia trachomatis	813	S	2	0	2	0.00000
SRR6145059	Chlamydia felis	83556	S	2	0	2	0.00000
SRR6145059	Chlamydia caviae	83557	S	2	0	2	0.00000
SRR6145059	Chitinophaga sp. MD30	2033437	S	63	2	65	0.00001
SRR6145059	Cellulosilyticum lentocellum	29360	S	1	1	2	0.00000
SRR6145059	Capnocytophaga sp. H2931	1945657	S	1	2	3	0.00000
SRR6145059	Candidatus Thioglobus sp. NP1	2508687	S	2	0	2	0.00000
SRR6145059	Candidatus Sodalis pierantonius	1486991	S	10	2	12	0.00000
SRR6145059	Candidatus Nitrosopumilus sp. SW	2508726	S	2	0	2	0.00000
SRR6145059	Candidatus Coxiella mudrowiae	2054173	S	4	2	6	0.00000
SRR6145059	Candidatus Arthromitus sp. SFB-rat-Yit	1041504	S	2	0	2	0.00000
SRR6145059	Campylobacter ornithocola	1848766	S	2	0	2	0.00000
SRR6145059	Campylobacter lanienae	75658	S	2	0	2	0.00000
SRR6145059	Campylobacter cuniculorum	374106	S	2	0	2	0.00000
SRR6145059	Campylobacter armoricus	2505970	S	2	0	2	0.00000
SRR6145059	Caldicellulosiruptor lactoaceticus	52766	S	1	1	2	0.00000
SRR6145059	Caldicellulosiruptor kronotskyensis	413889	S	2	0	2	0.00000
SRR6145059	Caldicellulosiruptor hydrothermalis	413888	S	2	0	2	0.00000
SRR6145059	Caldanaerobacter subterraneus	911092	S	2	0	2	0.00000
SRR6145059	Brucella sp. 2280	2592625	S	2	2	4	0.00000
SRR6145059	Brazilian marseillevirus	1813599	S	2	0	2	0.00000
SRR6145059	Borreliella garinii	29519	S	2	0	2	0.00000
SRR6145059	Borreliella afzelii	29518	S	2	0	2	0.00000
SRR6145059	Borrelia mayonii	1674146	S	2	0	2	0.00000
SRR6145059	Bombella sp. KACC 21507	2697033	S	2	0	2	0.00000
SRR6145059	Blattabacterium sp. (Cryptocercus kyebangensis)	298656	S	2	0	2	0.00000
SRR6145059	Betapapillomavirus 4	334208	S	2	0	2	0.00000
SRR6145059	Bartonella sp. 1-1C	515256	S	2	2	4	0.00000
SRR6145059	Bartonella grahamii	33045	S	2	0	2	0.00000
SRR6145059	Bartonella clarridgeiae	56426	S	2	0	2	0.00000
SRR6145059	Bacillus sp. L13 (2020)	2728853	S	2	0	2	0.00000
SRR6145059	Bacillus sp. Cs-700	2589818	S	3	2	5	0.00000
SRR6145059	Bacillus sp. BS98	2608254	S	1	2	3	0.00000
SRR6145059	Bacillus cytotoxicus	580165	S	2	0	2	0.00000
SRR6145059	Bacillus beveridgei	632773	S	2	0	2	0.00000
SRR6145059	Bacillus albus	2026189	S	2	0	2	0.00000
SRR6145059	Athalassotoga saccharophila	1441386	S	2	0	2	0.00000
SRR6145059	Aster yellows witches'-broom phytoplasma	229545	S	2	3	5	0.00000
SRR6145059	Arthrobacter sp. ERGS1:01	1704044	S	83	2	85	0.00001
SRR6145059	Arcobacter sp. L	944547	S	2	2	4	0.00000
SRR6145059	Anoxybacillus gonensis	198467	S	1	1	2	0.00000
SRR6145059	Anaplasma platys	949	S	2	0	2	0.00000
SRR6145059	Anaplasma marginale	770	S	1	1	2	0.00000
SRR6145059	Anaplasma centrale	769	S	1	1	2	0.00000
SRR6145059	Anabaena sp. WA102	1647413	S	3	2	5	0.00000
SRR6145059	Allofrancisella frigidaquae	1085644	S	2	0	2	0.00000
SRR6145059	Alkaliphilus metalliredigens	208226	S	2	0	2	0.00000
SRR6145059	Aliivibrio salmonicida	40269	S	2	0	2	0.00000
SRR6145059	Agarilytica rhodophyticola	1737490	S	2	0	2	0.00000
SRR6145059	Aeropyrum camini	229980	S	2	0	2	0.00000
SRR6145059	Aeromonas sp. CU5	2033033	S	14	2	16	0.00000
SRR6145059	Aeromonas phage AS-zj	2024208	S	1	2	3	0.00000
SRR6145059	Aerococcus sanguinicola	119206	S	2	0	2	0.00000
SRR6145059	Acinetobacter virus WCHABP5	2560274	S	1	2	3	0.00000
SRR6145059	Acinetobacter sp. dk386	2662362	S	42	2	44	0.00001
SRR6145059	Acinetobacter sp. LoGeW2-3	1808001	S	50	2	52	0.00001
SRR6145059	Acinetobacter sp. 185	2715163	S	50	2	52	0.00001
SRR6145059	Acidilobus saccharovorans	242703	S	2	0	2	0.00000
SRR6145059	Acidianus manzaensis	282676	S	2	0	2	0.00000
SRR6145059	Acidianus ambivalens	2283	S	2	0	2	0.00000
SRR6145059	Acetomicrobium mobile	97477	S	2	0	2	0.00000
SRR6145059	endosymbiont of Euscepes postfasciatus	650377	S	1	0	1	0.00000
SRR6145059	bacterium 2013Arg42i	1561003	S	1	0	1	0.00000
SRR6145059	Yersinia similis	367190	S	1	0	1	0.00000
SRR6145059	Yellowstone lake phycodnavirus 3	1586715	S	1	0	1	0.00000
SRR6145059	Xylella virus Prado	1985736	S	1	1	2	0.00000
SRR6145059	Weissella ceti	759620	S	1	0	1	0.00000
SRR6145059	Votkovvirus S28C10	2733968	S	1	0	1	0.00000
SRR6145059	Vibrio sp. HBUAS61001	2479546	S	47	1	48	0.00001
SRR6145059	Vibrio phage eugene 12A10	573172	S	1	0	1	0.00000
SRR6145059	Vibrio phage douglas 12A4	573171	S	1	0	1	0.00000
SRR6145059	Vibrio jasicida	766224	S	1	0	1	0.00000
SRR6145059	Vibrio crassostreae	246167	S	1	0	1	0.00000
SRR6145059	Ureaplasma parvum	134821	S	1	0	1	0.00000
SRR6145059	Treponema primitia	88058	S	1	0	1	0.00000
SRR6145059	Tokyovirus A1	1826170	S	1	0	1	0.00000
SRR6145059	Thiomicrorhabdus indica	2267253	S	1	0	1	0.00000
SRR6145059	Thioalkalivibrio sp. K90mix	396595	S	29	1	30	0.00000
SRR6145059	Thermosynechococcus sp. CL-1	2583530	S	6	1	7	0.00000
SRR6145059	Thermosipho sp. 1070	1437364	S	1	1	2	0.00000
SRR6145059	Thermoproteus tenax virus 1	10479	S	1	0	1	0.00000
SRR6145059	Thermofilum uzonense	1550241	S	1	0	1	0.00000
SRR6145059	Thermodesulfovibrio yellowstonii	28262	S	1	0	1	0.00000
SRR6145059	Thermodesulfobacterium geofontis	1295609	S	1	0	1	0.00000
SRR6145059	Thermocrinis minervae	381751	S	1	0	1	0.00000
SRR6145059	Thermococcus thioreducens	277988	S	1	0	1	0.00000
SRR6145059	Thermococcus sibiricus	172049	S	1	0	1	0.00000
SRR6145059	Thermococcus piezophilus	1712654	S	1	0	1	0.00000
SRR6145059	Thermococcus paralvinellae	582419	S	1	0	1	0.00000
SRR6145059	Thermococcus pacificus	71998	S	1	0	1	0.00000
SRR6145059	Thermococcus litoralis	2265	S	1	0	1	0.00000
SRR6145059	Thermococcus kodakarensis	311400	S	1	0	1	0.00000
SRR6145059	Thermococcus eurythermalis	1505907	S	1	0	1	0.00000
SRR6145059	Thermococcus chitonophagus	54262	S	1	0	1	0.00000
SRR6145059	Thermococcus barophilus	55802	S	1	0	1	0.00000
SRR6145059	Thermoanaerobacterium xylanolyticum	29329	S	1	0	1	0.00000
SRR6145059	Thermaerobacter sp. PB12/4term	2293838	S	34	1	35	0.00000
SRR6145059	Synechococcus sp. WH 8020	32052	S	1	0	1	0.00000
SRR6145059	Synechococcus sp. PCC 7002	32049	S	1	0	1	0.00000
SRR6145059	Synechococcus sp. PCC 11901	2579791	S	1	0	1	0.00000
SRR6145059	Synechococcus sp. CB0101	232348	S	21	1	22	0.00000
SRR6145059	Swingsia samuiensis	1293412	S	1	0	1	0.00000
SRR6145059	Sulfurovum lithotrophicum	206403	S	1	0	1	0.00000
SRR6145059	Sulfurospirillum halorespirans	194424	S	1	0	1	0.00000
SRR6145059	Sulfurospirillum barnesii	44674	S	1	0	1	0.00000
SRR6145059	Sulfurihydrogenibium azorense	309806	S	1	0	1	0.00000
SRR6145059	Sulfuriferula sp. AH1	1985873	S	28	1	29	0.00000
SRR6145059	Sulfolobus acidocaldarius	2285	S	1	0	1	0.00000
SRR6145059	Sulfodiicoccus acidiphilus	1670455	S	1	0	1	0.00000
SRR6145059	Sulfitobacter sp. BSw21498	664426	S	20	1	21	0.00000
SRR6145059	Streptomyces phage SF3	1690818	S	1	1	2	0.00000
SRR6145059	Streptococcus virus Cp7	1982585	S	1	1	2	0.00000
SRR6145059	Streptococcus virus 7201	112023	S	2	1	3	0.00000
SRR6145059	Streptococcus sp. CNU G3	2698804	S	1	1	2	0.00000
SRR6145059	Streptococcus sp. CNU 77-61	2684658	S	1	2	3	0.00000
SRR6145059	Streptococcus phage EJ-1	12402	S	6	1	7	0.00000
SRR6145059	Stappia sp. ES.058	1881061	S	68	1	69	0.00001
SRR6145059	Staphylothermus marinus	2280	S	1	0	1	0.00000
SRR6145059	Staphylococcus virus Andhra	2732591	S	16	1	17	0.00000
SRR6145059	Spiroplasma syrphidicola	216945	S	1	0	1	0.00000
SRR6145059	Spiroplasma diminutum	216936	S	1	0	1	0.00000
SRR6145059	Spiroplasma corruscae	216934	S	1	0	1	0.00000
SRR6145059	Spiroplasma chrysopicola	216933	S	1	0	1	0.00000
SRR6145059	Spider shaspivirus	2509384	S	1	0	1	0.00000
SRR6145059	Sphingorhabdus sp. IMCC1753	2509719	S	261	1	262	0.00003
SRR6145059	Sphingomonas sp. HDW15A	2714942	S	90	1	91	0.00001
SRR6145059	Sphingomonas sp. AE3	2594473	S	91	1	92	0.00001
SRR6145059	Sphingobium sp. SCG-1	2072936	S	115	1	116	0.00001
SRR6145059	Sphingobacterium sp. dk4302	2662364	S	66	1	67	0.00001
SRR6145059	Sphingobacterium sp. DR205	2713573	S	81	1	82	0.00001
SRR6145059	Sindbis virus	11034	S	1	0	1	0.00000
SRR6145059	Shigella virus Sf13	2560756	S	1	1	2	0.00000
SRR6145059	Shewanella sp. Pdp11	2059264	S	4	1	5	0.00000
SRR6145059	Shewanella piezotolerans	404011	S	1	0	1	0.00000
SRR6145059	Serratia sp. MYb239	2033438	S	1	1	2	0.00000
SRR6145059	Serratia sp. FGI94	671990	S	3	1	4	0.00000
SRR6145059	Serratia sp. 3ACOL1	2448483	S	2	1	3	0.00000
SRR6145059	Salicibibacter kimchii	2099786	S	1	0	1	0.00000
SRR6145059	Saccharolobus solfataricus	2287	S	1	0	1	0.00000
SRR6145059	Runella sp. SP2	2268026	S	36	1	37	0.00000
SRR6145059	Runella sp. HYN0085	2259595	S	18	1	19	0.00000
SRR6145059	Ruminococcaceae bacterium CPB6	1572656	S	1	1	2	0.00000
SRR6145059	Rufibacter sp. DG31D	1379910	S	16	1	17	0.00000
SRR6145059	Ruania sp. HY168	2603206	S	112	1	113	0.00001
SRR6145059	Roseovarius sp. MME-070	2494550	S	64	1	65	0.00001
SRR6145059	Roseimicrobium sp. ORNL1	2711231	S	147	1	148	0.00002
SRR6145059	Roseiflexus sp. RS-1	357808	S	18	1	19	0.00000
SRR6145059	Rickettsia raoultii	369822	S	1	0	1	0.00000
SRR6145059	Rickettsia prowazekii	782	S	1	0	1	0.00000
SRR6145059	Rickettsia helvetica	35789	S	1	0	1	0.00000
SRR6145059	Rickettsia asiatica	238800	S	1	0	1	0.00000
SRR6145059	Rheinheimera sp. LHK132	2498451	S	270	1	271	0.00003
SRR6145059	Rheinheimera sp. D18	2545632	S	15	1	16	0.00000
SRR6145059	Raineyella sp. CBA3103	2662261	S	148	1	149	0.00002
SRR6145059	Raccoonpox virus	10256	S	1	0	1	0.00000
SRR6145059	Pyrodictium delaneyi	1273541	S	1	0	1	0.00000
SRR6145059	Pyrococcus yayanosii	1008460	S	1	0	1	0.00000
SRR6145059	Pusillimonas sp. ye3	2028345	S	18	1	19	0.00000
SRR6145059	Pusillimonas sp. T7-7	1007105	S	23	1	24	0.00000
SRR6145059	Psychrobacter sp. AntiMn-1	1720344	S	62	1	63	0.00001
SRR6145059	Pseudorhodobacter sp. S12M18	2500533	S	48	1	49	0.00001
SRR6145059	Pseudomonas virus Pf1 ERZ-2017	2175295	S	1	0	1	0.00000
SRR6145059	Pseudomonas sp. gcc21	2726989	S	18	1	19	0.00000
SRR6145059	Pseudomonas sp. LBUM920	2126069	S	1	1	2	0.00000
SRR6145059	Pseudomonas sp. LAB-08	143813	S	13	1	14	0.00000
SRR6145059	Pseudomonas sp. K2W31S-8	2320867	S	75	1	76	0.00001
SRR6145059	Pseudomonas sp. HLS-6	2049589	S	28	1	29	0.00000
SRR6145059	Pseudomonas sp. GR 6-02	1659194	S	1	2	3	0.00000
SRR6145059	Pseudomonas sp. ADAK18	2730848	S	23	1	24	0.00000
SRR6145059	Pseudomonas sp. ACM7	2052956	S	13	1	14	0.00000
SRR6145059	Pseudomonas sp. 7SR1	1881017	S	24	1	25	0.00000
SRR6145059	Pseudodesulfovibrio sp. SRB007	2678688	S	28	1	29	0.00000
SRR6145059	Pseudoalteromonas sp. Xi13	2490635	S	1	1	2	0.00000
SRR6145059	Pseudoalteromonas sp. 1_2015MBL_MicDiv	1720343	S	1	1	2	0.00000
SRR6145059	Pseudoalteromonas marina	267375	S	1	0	1	0.00000
SRR6145059	Pseudenhygromyxa sp. WMMC2535	2712867	S	118	1	119	0.00001
SRR6145059	Proteus phage VB_PmiS-Isfahan	1969841	S	13	1	14	0.00000
SRR6145059	Prochlorococcus sp. MIT 0801	1501269	S	1	0	1	0.00000
SRR6145059	Pontibacter sp. BT326	2694929	S	18	1	19	0.00000
SRR6145059	Pontibacter sp. BT214	2694930	S	14	1	15	0.00000
SRR6145059	Polaribacter sp. KT25b	1855336	S	17	1	18	0.00000
SRR6145059	Planococcus versutus	1302659	S	1	0	1	0.00000
SRR6145059	Planococcus sp. MB-3u-03	2058136	S	7	1	8	0.00000
SRR6145059	Planctomycetes bacterium V202	2527965	S	4	1	5	0.00000
SRR6145059	Planctomycetes bacterium Pan161	2527971	S	5	1	6	0.00000
SRR6145059	Planctomyces sp. SH-PL14	1632864	S	108	1	109	0.00001
SRR6145059	Photorhabdus asymbiotica	291112	S	1	0	1	0.00000
SRR6145059	Peptoclostridium acidaminophilum	1731	S	1	0	1	0.00000
SRR6145059	Pedobacter sp. eg	2201271	S	25	1	26	0.00000
SRR6145059	Pedobacter sp. HDW13	2714940	S	26	1	27	0.00000
SRR6145059	Paraglaciecola mesophila	197222	S	1	0	1	0.00000
SRR6145059	Pantoea sp. At-9b	592316	S	44	1	45	0.00001
SRR6145059	Pandoravirus macleodensis	2107707	S	1	0	1	0.00000
SRR6145059	Paenibacillus xylanexedens	528191	S	1	0	1	0.00000
SRR6145059	Paenibacillus brasilensis	128574	S	1	0	1	0.00000
SRR6145059	Opitutaceae bacterium TAV5	794903	S	79	1	80	0.00001
SRR6145059	Oenococcus kitaharae	336988	S	1	0	1	0.00000
SRR6145059	Obodhiang ephemerovirus	1972592	S	1	0	1	0.00000
SRR6145059	Nitrosopumilus piranensis	1582439	S	1	0	1	0.00000
SRR6145059	Nitrosopumilus adriaticus	1580092	S	1	0	1	0.00000
SRR6145059	Nitrosomonadales bacterium skT11	2715678	S	30	1	31	0.00000
SRR6145059	Nitrosomonadales bacterium Swamp67	2732487	S	52	1	53	0.00001
SRR6145059	Neisseria sp. KEM232	655307	S	93	1	94	0.00001
SRR6145059	Mycoplasma sp. Phocoena C-264-GEN	754517	S	1	0	1	0.00000
SRR6145059	Mycoplasma putrefaciens	2123	S	1	0	1	0.00000
SRR6145059	Mycoplasma pulmonis	2107	S	1	0	1	0.00000
SRR6145059	Mycoplasma phocicerebrale	142649	S	1	0	1	0.00000
SRR6145059	Mycoplasma ovipneumoniae	29562	S	1	0	1	0.00000
SRR6145059	Mycoplasma neurolyticum	2120	S	1	0	1	0.00000
SRR6145059	Mycoplasma nasistruthionis	353852	S	1	0	1	0.00000
SRR6145059	Mycoplasma maculosum	114885	S	1	0	1	0.00000
SRR6145059	Mycoplasma haemofelis	29501	S	1	0	1	0.00000
SRR6145059	Mycoplasma haemocanis	136241	S	1	0	1	0.00000
SRR6145059	Mycoplasma gallisepticum	2096	S	1	0	1	0.00000
SRR6145059	Mycoplasma flocculare	2128	S	1	0	1	0.00000
SRR6145059	Mycoplasma dispar	86660	S	1	0	1	0.00000
SRR6145059	Mycoplasma conjunctivae	45361	S	1	0	1	0.00000
SRR6145059	Mycoplasma bovigenitalium	2112	S	1	0	1	0.00000
SRR6145059	Mycoplasma anatis	171279	S	1	0	1	0.00000
SRR6145059	Mycoplasma alkalescens	45363	S	1	0	1	0.00000
SRR6145059	Mycobacterium virus Redrock	2003504	S	1	1	2	0.00000
SRR6145059	Mycobacterium virus Fishburne	1983739	S	1	1	2	0.00000
SRR6145059	Mycobacterium virus Cooper	1983117	S	2	1	3	0.00000
SRR6145059	Mycobacterium virus Babsiella	1089115	S	2	1	3	0.00000
SRR6145059	Mycobacterium virus Acadian	1982901	S	1	1	2	0.00000
SRR6145059	Mycobacterium phage Validus	1414747	S	1	1	2	0.00000
SRR6145059	Mycetocola sp. 449	2079792	S	48	1	49	0.00001
SRR6145059	Murine roseolovirus	1940555	S	1	0	1	0.00000
SRR6145059	Muricauda sp. 501str8	2698672	S	9	1	10	0.00000
SRR6145059	Mupapillomavirus 2	334204	S	1	0	1	0.00000
SRR6145059	Mollivirus sibericum	1678078	S	1	0	1	0.00000
SRR6145059	Methylophilus sp. TWE2	1662285	S	10	1	11	0.00000
SRR6145059	Methylomicrobium sp. wino1	2049332	S	9	1	10	0.00000
SRR6145059	Methylococcus sp. IM1	2681310	S	22	1	23	0.00000
SRR6145059	Methanothermobacter marburgensis	145263	S	1	0	1	0.00000
SRR6145059	Methanosarcina sp. MTP4	1434100	S	5	1	6	0.00000
SRR6145059	Methanosarcina sp. Kolksee	1434099	S	2	1	3	0.00000
SRR6145059	Methanosarcina flavescens	1715806	S	1	0	1	0.00000
SRR6145059	Methanomethylovorans hollandica	101192	S	1	0	1	0.00000
SRR6145059	Methanolinea tarda	263906	S	1	0	1	0.00000
SRR6145059	Methanocorpusculum labreanum	83984	S	1	0	1	0.00000
SRR6145059	Methanocaldococcus vulcanius	73913	S	1	0	1	0.00000
SRR6145059	Methanobacterium formicicum	2162	S	1	0	1	0.00000
SRR6145059	Metallosphaera cuprina	1006005	S	1	0	1	0.00000
SRR6145059	Marinomonas primoryensis	178399	S	1	0	1	0.00000
SRR6145059	Marinobacter sp. NP-4(2019)	2488665	S	19	1	20	0.00000
SRR6145059	Marinilactibacillus sp. 15R	1911586	S	32	1	33	0.00000
SRR6145059	Maribius sp. THAF1	2587842	S	72	1	73	0.00001
SRR6145059	Marco hapavirus	1972620	S	1	0	1	0.00000
SRR6145059	Lymphocystis disease virus Sa	1898060	S	1	0	1	0.00000
SRR6145059	Lymphocystis disease virus 1	36363	S	1	0	1	0.00000
SRR6145059	Lymantria dispar multiple nucleopolyhedrovirus	10449	S	1	0	1	0.00000
SRR6145059	Litoreibacter sp. LN3S51	2599296	S	62	1	63	0.00001
SRR6145059	Leucobacter sp. HDW9B	2714934	S	54	1	55	0.00001
SRR6145059	Lelliottia sp. WB101	2153385	S	16	1	17	0.00000
SRR6145059	Lactococcus phage P078	1476886	S	1	1	2	0.00000
SRR6145059	Lactobacillus sanfranciscensis	1625	S	1	0	1	0.00000
SRR6145059	Lactobacillus phage LpeD	2041210	S	1	1	2	0.00000
SRR6145059	Lactobacillus nenjiangensis	1296540	S	1	0	1	0.00000
SRR6145059	Lactobacillus koreensis	637971	S	1	0	1	0.00000
SRR6145059	Lactobacillus helsingborgensis	1218494	S	1	0	1	0.00000
SRR6145059	Lactobacillus coryniformis	1610	S	1	0	1	0.00000
SRR6145059	Lactobacillus buchneri	1581	S	1	0	1	0.00000
SRR6145059	Lactobacillus amylophilus	1603	S	1	0	1	0.00000
SRR6145059	Labrenzia sp. VG12	2021862	S	42	1	43	0.00001
SRR6145059	Klebsiella phage KPN N137	2024238	S	1	0	1	0.00000
SRR6145059	Jeongeupia sp. USM3	1906741	S	68	1	69	0.00001
SRR6145059	Janthinobacterium sp. 17J80-10	2497863	S	47	1	48	0.00001
SRR6145059	Invertebrate iridescent virus 9	345195	S	1	0	1	0.00000
SRR6145059	Hyphomicrobium sp. MC1	717785	S	48	1	49	0.00001
SRR6145059	Hyperthermus butylicus	54248	S	1	0	1	0.00000
SRR6145059	Hymenobacter sp. TS19	2735321	S	30	1	31	0.00000
SRR6145059	Huangpi Tick Virus 2	1608048	S	1	0	1	0.00000
SRR6145059	Hoeflea sp. IMCC20628	1620421	S	29	1	30	0.00000
SRR6145059	Hippea maritima	84405	S	1	0	1	0.00000
SRR6145059	Helicobacter typhlonius	76936	S	1	0	1	0.00000
SRR6145059	Helicobacter pullorum	35818	S	1	0	1	0.00000
SRR6145059	Helicobacter mustelae	217	S	1	0	1	0.00000
SRR6145059	Helicobacter canadensis	123841	S	1	0	1	0.00000
SRR6145059	Helicobacter acinonychis	212	S	1	0	1	0.00000
SRR6145059	Hardy-Zuckerman feline sarcoma virus	39746	S	1	0	1	0.00000
SRR6145059	Halovirus HHTV-2	1273751	S	1	0	1	0.00000
SRR6145059	Halorubrum virus HRPV2	1987102	S	1	1	2	0.00000
SRR6145059	Halorubrum sp. PV6	634157	S	25	1	26	0.00000
SRR6145059	Halorubrum sp. BOL3-1	2497325	S	24	1	25	0.00000
SRR6145059	Halomonas sp. GT	1971364	S	22	1	23	0.00000
SRR6145059	Halomonas sp. GFAJ-1	1118153	S	63	1	64	0.00001
SRR6145059	Halomonas sp. 1513	1883416	S	51	1	52	0.00001
SRR6145059	Halomicrobium sp. LC1Hm	2610902	S	24	1	25	0.00000
SRR6145059	Halieaceae bacterium IMCC3088	2518989	S	24	1	25	0.00000
SRR6145059	Gordonia virus Zirinka	2170042	S	4	1	5	0.00000
SRR6145059	Gordonia virus Kenna	2734201	S	1	1	2	0.00000
SRR6145059	Gordonia virus Brandonk123	2560488	S	2	1	3	0.00000
SRR6145059	Gordonia phage Blueberry	1838062	S	4	1	5	0.00000
SRR6145059	Gordonia phage Adgers	2079413	S	1	1	2	0.00000
SRR6145059	Glossina hytrovirus	1285594	S	1	0	1	0.00000
SRR6145059	Geobacillus sp. WCH70	471223	S	1	1	2	0.00000
SRR6145059	Geobacillus sp. JS12	1813182	S	1	1	2	0.00000
SRR6145059	Geminocystis sp. NIES-3709	1617448	S	9	1	10	0.00000
SRR6145059	Gammapapillomavirus 27	2169902	S	1	0	1	0.00000
SRR6145059	Gammapapillomavirus 23	1961680	S	1	0	1	0.00000
SRR6145059	Gammapapillomavirus 13	1513258	S	1	0	1	0.00000
SRR6145059	Gammapapillomavirus 11	1513256	S	1	0	1	0.00000
SRR6145059	Fowlpox virus	10261	S	1	0	1	0.00000
SRR6145059	Flavihumibacter sp. SB-02	2676868	S	29	1	30	0.00000
SRR6145059	Fervidobacterium islandicum	2423	S	1	0	1	0.00000
SRR6145059	Fervidicoccus fontis	683846	S	1	0	1	0.00000
SRR6145059	Exiguobacterium sp. N4-1P	2051906	S	41	1	42	0.00000
SRR6145059	Eubacterium callanderi	53442	S	1	0	1	0.00000
SRR6145059	Escherichia virus CC31	1913656	S	1	1	2	0.00000
SRR6145059	Eptesipox virus	1329402	S	1	0	1	0.00000
SRR6145059	Entomoplasma melaleucae	81459	S	1	0	1	0.00000
SRR6145059	Enterococcus sp. M190262	2582830	S	2	1	3	0.00000
SRR6145059	Emiliania huxleyi virus 86	181082	S	1	0	1	0.00000
SRR6145059	Eggerthella sp. YY7918	502558	S	10	1	11	0.00000
SRR6145059	Ectothiorhodospiraceae bacterium 2226	2740164	S	39	1	40	0.00000
SRR6145059	Dyella sp. M7H15-1	2501295	S	27	1	28	0.00000
SRR6145059	Dokdonia donghaensis	326320	S	1	0	1	0.00000
SRR6145059	Dickeya sp. DW 0440	1225785	S	1	15	16	0.00000
SRR6145059	Desulfuromonas sp. DDH964	1823759	S	25	1	26	0.00000
SRR6145059	Dechloromonas sp. HYN0024	2231055	S	27	1	28	0.00000
SRR6145059	DPANN group archaeon LC1Nh	2565781	S	1	0	1	0.00000
SRR6145059	Cronobacter sp. JZ38	1906275	S	1	1	2	0.00000
SRR6145059	Colwellia sp. Arc7-D	2161872	S	6	1	7	0.00000
SRR6145059	Colwellia sp. Arc7-635	2497879	S	6	1	7	0.00000
SRR6145059	Clostridiaceae bacterium 14S0207	2082193	S	8	1	9	0.00000
SRR6145059	Citrobacter sp. NMI7904_11	2653932	S	6	1	7	0.00000
SRR6145059	Chryseobacterium sp. T16E-39	2015076	S	74	1	75	0.00001
SRR6145059	Chrysanthemum stem necrosis orthotospovirus	2560382	S	1	0	1	0.00000
SRR6145059	Chlamydia muridarum	83560	S	1	0	1	0.00000
SRR6145059	Chlamydia abortus	83555	S	1	0	1	0.00000
SRR6145059	Cellulosilyticum sp. WCF-2	2497860	S	1	1	2	0.00000
SRR6145059	Caulobacter virus Swift	1211644	S	1	1	2	0.00000
SRR6145059	Carrot thin leaf virus	114922	S	1	0	1	0.00000
SRR6145059	Carnobacterium sp. 17-4	208596	S	9	1	10	0.00000
SRR6145059	Carboxydocella thermautotrophica	178899	S	1	0	1	0.00000
SRR6145059	Candidatus Saccharimonas aalborgensis	1332188	S	28	1	29	0.00000
SRR6145059	Candidatus Pelagibacter sp. IMCC9063	1002672	S	1	0	1	0.00000
SRR6145059	Candidatus Pelagibacter giovannonii	2563896	S	4	1	5	0.00000
SRR6145059	Candidatus Frankia datiscae	2716812	S	75	1	76	0.00001
SRR6145059	Candidatus Arthromitus sp. SFB-mouse-NL	1508644	S	1	7	8	0.00000
SRR6145059	Campylobacter sp. RM8964	1660074	S	1	1	2	0.00000
SRR6145059	Campylobacter sp. NCTC 13003	1660064	S	1	0	1	0.00000
SRR6145059	Campylobacter hepaticus	1813019	S	1	0	1	0.00000
SRR6145059	Caldivirga maquilingensis	76887	S	1	0	1	0.00000
SRR6145059	Caldicellulosiruptor saccharolyticus	44001	S	1	0	1	0.00000
SRR6145059	Caldicellulosiruptor bescii	31899	S	1	0	1	0.00000
SRR6145059	Bubaline alphaherpesvirus 1	202910	S	1	1	2	0.00000
SRR6145059	Brucella sp. 141012304	1885919	S	1	1	2	0.00000
SRR6145059	Bradymonadales bacterium V1718	2600177	S	9	1	10	0.00000
SRR6145059	Borreliella bissettii	64897	S	1	0	1	0.00000
SRR6145059	Borreliella bavariensis	664662	S	1	0	1	0.00000
SRR6145059	Borrelia hermsii	140	S	1	0	1	0.00000
SRR6145059	Borrelia coriaceae	144	S	1	0	1	0.00000
SRR6145059	Bordetella sp. H567	1697043	S	59	1	60	0.00001
SRR6145059	Bordetella genomosp. 8	1416806	S	56	1	57	0.00001
SRR6145059	Bole Tick Virus 3	1608042	S	1	0	1	0.00000
SRR6145059	Blautia sp. N6H1-15	1912897	S	13	1	14	0.00000
SRR6145059	Blattabacterium sp. (Periplaneta americana)	367488	S	1	0	1	0.00000
SRR6145059	Blattabacterium sp. (Blatta orientalis)	367806	S	1	0	1	0.00000
SRR6145059	Blattabacterium sp. (Blaberus giganteus)	1186051	S	1	0	1	0.00000
SRR6145059	Betapapillomavirus 5	334209	S	1	0	1	0.00000
SRR6145059	Bartonella sp. WD16.2	1933904	S	3	1	4	0.00000
SRR6145059	Bartonella bovis	155194	S	1	0	1	0.00000
SRR6145059	Bartonella ancashensis	1318743	S	1	0	1	0.00000
SRR6145059	Bacillus virus Stills	1921713	S	1	1	2	0.00000
SRR6145059	Bacillus sp. JAS24-2	2217832	S	1	1	2	0.00000
SRR6145059	Bacillus sp. HBCD-sjtu	2053832	S	1	1	2	0.00000
SRR6145059	Bacillus sp. BD59S	2499213	S	2	1	3	0.00000
SRR6145059	Bacillus phage SalinJah	1837830	S	1	1	2	0.00000
SRR6145059	Azoarcus sp. SY39	2067960	S	41	1	42	0.00000
SRR6145059	Auritidibacter sp. NML130574	2170745	S	96	1	97	0.00001
SRR6145059	Arthrobacter virus Judy	2734225	S	1	1	2	0.00000
SRR6145059	Arcobacter aquimarinus	1315211	S	1	0	1	0.00000
SRR6145059	Archaeoglobus sulfaticallidus	1316941	S	1	0	1	0.00000
SRR6145059	Arcanobacterium sp. 2701	2722751	S	6	1	7	0.00000
SRR6145059	Arachidicoccus sp. B3-10	2545455	S	62	1	63	0.00001
SRR6145059	Aquicella siphonis	254247	S	1	0	1	0.00000
SRR6145059	Aquicella lusitana	254246	S	1	0	1	0.00000
SRR6145059	Apis mellifera filamentous virus	1100043	S	1	0	1	0.00000
SRR6145059	Apibacter sp. B3706	2656760	S	1	1	2	0.00000
SRR6145059	Anaerotignum propionicum	28446	S	1	0	1	0.00000
SRR6145059	Anaeromyxobacter sp. Fw109-5	404589	S	97	1	98	0.00001
SRR6145059	Aminobacterium colombiense	81468	S	1	0	1	0.00000
SRR6145059	Alphapapillomavirus 9	337041	S	1	0	1	0.00000
SRR6145059	Alphapapillomavirus 4	337043	S	1	0	1	0.00000
SRR6145059	Alcanivorax sp. NBRC 101098	1113728	S	1	6	7	0.00000
SRR6145059	Agrotis segetum nucleopolyhedrovirus A	1962501	S	1	0	1	0.00000
SRR6145059	Actinobacteria bacterium IMCC25003	1848255	S	4	1	5	0.00000
SRR6145059	Actinobacteria bacterium IMCC19121	1848754	S	3	1	4	0.00000
SRR6145059	Actinobacillus equuli	718	S	1	0	1	0.00000
SRR6145059	Acinetobacter sp. TGL-Y2	1407071	S	79	1	80	0.00001
SRR6145059	Acinetobacter sp. 323-1	2715164	S	54	1	55	0.00001
SRR6145059	Achromobacter virus Axp3	2169962	S	2	1	3	0.00000
SRR6145059	uncultured Termite group 1 bacterium	167965	S	1	0	1	0.00000
SRR6145059	secondary endosymbiont of Trabutina mannipara	1835721	S	1	0	1	0.00000
SRR6145059	secondary endosymbiont of Heteropsylla cubana	134287	S	1	0	1	0.00000
SRR6145059	secondary endosymbiont of Ctenarytaina eucalypti	1199245	S	3	0	3	0.00000
SRR6145059	methanogenic archaeon ISO4-H5	1495144	S	7	0	7	0.00000
SRR6145059	gamma proteobacterium SS-5	947516	S	25	0	25	0.00000
SRR6145059	gamma proteobacterium HdN1	83406	S	3	0	3	0.00000
SRR6145059	endosymbiont of unidentified scaly snail isolate Monju	1248727	S	27	0	27	0.00000
SRR6145059	endosymbiont of Acanthamoeba sp. UWC8	86106	S	2	0	2	0.00000
SRR6145059	cyanobacterium endosymbiont of Rhopalodia gibberula	1763363	S	1	0	1	0.00000
SRR6145059	cyanobacterium endosymbiont of Epithemia turgida	718217	S	2	0	2	0.00000
SRR6145059	blood disease bacterium A2-HR MARDI	1944648	S	2	3	5	0.00000
SRR6145059	beta proteobacterium CB	543913	S	1	0	1	0.00000
SRR6145059	alpha proteobacterium HIMB59	744985	S	4	0	4	0.00000
SRR6145059	alpha proteobacterium HIMB5	859653	S	11	0	11	0.00000
SRR6145059	Yersinia virus phiR201	2732036	S	1	0	1	0.00000
SRR6145059	Yersinia virus Yen9-04	2560849	S	1	0	1	0.00000
SRR6145059	Yersinia virus Phi80-18	2733375	S	1	0	1	0.00000
SRR6145059	Xylella virus Sano	2560848	S	2	0	2	0.00000
SRR6145059	Xylella virus Salvo	2560847	S	10	0	10	0.00000
SRR6145059	Wolbachia endosymbiont of Trichogramma pretiosum	125593	S	1	0	1	0.00000
SRR6145059	Wolbachia endosymbiont of Diaphorina citri	116598	S	2	1	3	0.00000
SRR6145059	Wolbachia endosymbiont of Culex quinquefasciatus	263437	S	1	2	3	0.00000
SRR6145059	Wolbachia endosymbiont of Ctenocephalides felis	212123	S	3	0	3	0.00000
SRR6145059	Wolbachia endosymbiont of Cimex lectularius	246273	S	2	0	2	0.00000
SRR6145059	Wolbachia endosymbiont of Chrysomya megacephala	1335053	S	1	3	4	0.00000
SRR6145059	Wolbachia endosymbiont of Brugia malayi	80849	S	2	2	4	0.00000
SRR6145059	Winogradskyella sp. RHA_55	1249933	S	12	0	12	0.00000
SRR6145059	Winogradskyella sp. PG-2	754409	S	9	0	9	0.00000
SRR6145059	Winogradskyella sp. PC-19	754417	S	5	0	5	0.00000
SRR6145059	Winogradskyella sp. J14-2	1936080	S	11	0	11	0.00000
SRR6145059	Weissella sp. HDW19	2714949	S	1	0	1	0.00000
SRR6145059	Vitreoscilla sp. C1	96942	S	8	0	8	0.00000
SRR6145059	Virgibacillus sp. SK37	403957	S	2	0	2	0.00000
SRR6145059	Virgibacillus sp. MSP4-1	2700081	S	3	0	3	0.00000
SRR6145059	Virgibacillus sp. Bac332	2419842	S	9	0	9	0.00000
SRR6145059	Virgibacillus sp. Bac330	2419841	S	1	0	1	0.00000
SRR6145059	Virgibacillus sp. 6R	1911587	S	7	0	7	0.00000
SRR6145059	Vibrio sp. ZWAL4003	2711221	S	3	0	3	0.00000
SRR6145059	Vibrio sp. THAF190c	2587865	S	3	0	3	0.00000
SRR6145059	Vibrio sp. THAF100	2587862	S	3	0	3	0.00000
SRR6145059	Vibrio sp. SM1977	2662262	S	2	0	2	0.00000
SRR6145059	Vibrio sp. HDW18	2714948	S	3	0	3	0.00000
SRR6145059	Vibrio phage JA-1	1283071	S	1	0	1	0.00000
SRR6145059	Verrucomicrobium sp. GAS474	1882831	S	41	0	41	0.00000
SRR6145059	Verrucomicrobia bacterium S94	2488809	S	8	0	8	0.00000
SRR6145059	Vampirococcus sp. LiM	1930593	S	4	0	4	0.00000
SRR6145059	Vagococcus sp. MN-17	2571750	S	6	0	6	0.00000
SRR6145059	Vagococcus sp. HDW17B	2714947	S	9	0	9	0.00000
SRR6145059	Vagococcus sp. HDW17A	2714946	S	6	0	6	0.00000
SRR6145059	Vagococcus sp. CF-49	2562451	S	4	0	4	0.00000
SRR6145059	Turicibacter sp. H121	1712675	S	3	0	3	0.00000
SRR6145059	Tsukamurella virus TIN2	1982570	S	7	0	7	0.00000
SRR6145059	Tsukamurella phage TPA4	1647476	S	5	0	5	0.00000
SRR6145059	Tsukamurella phage TPA2	981330	S	1	0	1	0.00000
SRR6145059	Tropheryma whipplei	2039	S	6	-6	0	0.00000
SRR6145059	Tissierellia sp. JN-28	2507161	S	16	0	16	0.00000
SRR6145059	Thiomicrorhabdus sp. aks77	2675054	S	5	0	5	0.00000
SRR6145059	Thiomicrorhabdus sp. G2	2739063	S	4	0	4	0.00000
SRR6145059	Thiomicrorhabdus sp. G1	2580412	S	6	0	6	0.00000
SRR6145059	Thiomicrorhabdus sp. AkT22	2675053	S	6	0	6	0.00000
SRR6145059	Thermus virus P74-26	466052	S	1	0	1	0.00000
SRR6145059	Thermus sp. CCB_US3_UF1	1111069	S	4	0	4	0.00000
SRR6145059	Thermotoga sp. RQ7	126738	S	1	0	1	0.00000
SRR6145059	Thermoplasmatales archaeon BRNA1	1054217	S	1	0	1	0.00000
SRR6145059	Thermococcus sp. SY113	2598455	S	2	0	2	0.00000
SRR6145059	Thermococcus sp. P6	122420	S	2	0	2	0.00000
SRR6145059	Thermococcus sp. IOH1	2586643	S	2	0	2	0.00000
SRR6145059	Thermococcus sp. EXT12c	2016361	S	1	0	1	0.00000
SRR6145059	Thermococcus sp. AM4	246969	S	3	0	3	0.00000
SRR6145059	Thermoclostridium stercorarium	1510	S	4	-4	0	0.00000
SRR6145059	Thermoanaerobacterium sp. RBIITD	1550240	S	7	0	7	0.00000
SRR6145059	Thermoanaerobacterales bacterium SK-G1	2316383	S	3	0	3	0.00000
SRR6145059	Thermaerobacter sp. FW80	2546351	S	32	0	32	0.00000
SRR6145059	Thalassotalea sp. PS06	2594005	S	4	0	4	0.00000
SRR6145059	Thalassococcus sp. S3	2017482	S	44	0	44	0.00001
SRR6145059	Terasakiella sp. SH-1	2560057	S	6	0	6	0.00000
SRR6145059	Tenericutes bacterium MZ-XQ	1911683	S	2	0	2	0.00000
SRR6145059	Tenericutes bacterium MO-XQ	1911684	S	6	0	6	0.00000
SRR6145059	Tenacibaculum sp. SZ-18	754423	S	14	0	14	0.00000
SRR6145059	Tatumella sp. TA1	2487345	S	7	0	7	0.00000
SRR6145059	Tannerella sp. oral taxon HOT-286	712710	S	276	1	277	0.00003
SRR6145059	Tamlana sp. UJ94	2069432	S	6	0	6	0.00000
SRR6145059	Synechococcus sp. SynAce01	1916956	S	11	0	11	0.00000
SRR6145059	Synechococcus sp. RSCCF101	2511069	S	23	0	23	0.00000
SRR6145059	Synechococcus sp. RCC307	316278	S	8	0	8	0.00000
SRR6145059	Synechococcus sp. NIES-970	1827144	S	4	0	4	0.00000
SRR6145059	Synechococcus sp. KORDI-52	585425	S	5	0	5	0.00000
SRR6145059	Synechococcus sp. KORDI-49	585423	S	7	0	7	0.00000
SRR6145059	Synechococcus sp. KORDI-100	1280380	S	7	0	7	0.00000
SRR6145059	Synechococcus sp. JA-3-3Ab	321327	S	4	0	4	0.00000
SRR6145059	Synechococcus sp. JA-2-3B'a(2-13)	321332	S	4	0	4	0.00000
SRR6145059	Synechococcus sp. CC9605	110662	S	12	0	12	0.00000
SRR6145059	Synechococcus sp. CC9311	64471	S	1	0	1	0.00000
SRR6145059	Synechococcus phage S-RSM4	555387	S	1	0	1	0.00000
SRR6145059	Synechococcus phage S-PM2	238854	S	2	0	2	0.00000
SRR6145059	Synechococcus phage S-CAM9	1883369	S	2	0	2	0.00000
SRR6145059	Swingsia sp. F3b2	2558361	S	8	0	8	0.00000
SRR6145059	Sulfurovum sp. NBC37-1	387093	S	1	0	1	0.00000
SRR6145059	Sulfurimonas sp. NW10	2509341	S	4	0	4	0.00000
SRR6145059	Sulfurimonas sp. GYSZ_1	2590022	S	7	0	7	0.00000
SRR6145059	Sulfurihydrogenibium sp. YO3AOP1	436114	S	3	0	3	0.00000
SRR6145059	Sulfolobus sp. S-194	2512240	S	3	0	3	0.00000
SRR6145059	Sulfolobus sp. A20	1891280	S	4	0	4	0.00000
SRR6145059	Sulfitobacter sp. SK012	1389005	S	21	0	21	0.00000
SRR6145059	Sulfitobacter sp. SK011	1389004	S	18	0	18	0.00000
SRR6145059	Sulfitobacter sp. JL08	2070369	S	40	0	40	0.00000
SRR6145059	Streptomyces virus phiHau3	1982895	S	1	0	1	0.00000
SRR6145059	Streptomyces virus Scap1	2560792	S	1	0	1	0.00000
SRR6145059	Streptomyces virus Picard	2734264	S	2	0	2	0.00000
SRR6145059	Streptomyces virus Ididsumtinwong	2734220	S	1	0	1	0.00000
SRR6145059	Streptomyces virus Darolandstone	2734266	S	2	0	2	0.00000
SRR6145059	Streptomyces virus Bing	2560785	S	3	0	3	0.00000
SRR6145059	Streptomyces virus BillNye	2560486	S	1	0	1	0.00000
SRR6145059	Streptomyces phage phiSAJS1	1755682	S	1	0	1	0.00000
SRR6145059	Streptomyces phage Comrade	2301714	S	1	0	1	0.00000
SRR6145059	Streptococcus virus Sfi21	64186	S	1	0	1	0.00000
SRR6145059	Streptococcus sp. oral taxon 431	712633	S	741	56	797	0.00009
SRR6145059	Streptococcus sp. oral taxon 064	712624	S	199	262	461	0.00005
SRR6145059	Streptococcus sp. Z15	2173853	S	3	0	3	0.00000
SRR6145059	Streptococcus phage YMC-2011	1051631	S	3	0	3	0.00000
SRR6145059	Streptococcus phage SM1	157924	S	3	0	3	0.00000
SRR6145059	Streptococcus phage PH15	537874	S	4	0	4	0.00000
SRR6145059	Streptococcus phage 5093	646413	S	1	0	1	0.00000
SRR6145059	Streptococcus constellatus	76860	S	10	-10	0	0.00000
SRR6145059	Stenotrophomonas virus Smp131	2734074	S	1	0	1	0.00000
SRR6145059	Stenotrophomonas virus DLP5	2560782	S	1	0	1	0.00000
SRR6145059	Stenotrophomonas phage YB07	2555548	S	1	0	1	0.00000
SRR6145059	Stenotrophomonas phage Mendera	2650877	S	1	0	1	0.00000
SRR6145059	Staphylococcus virus Twort	55510	S	2	0	2	0.00000
SRR6145059	Staphylococcus virus SEP9	1922247	S	5	0	5	0.00000
SRR6145059	Staphylococcus phage vB_SscM-1	1868844	S	2	0	2	0.00000
SRR6145059	Stanieria sp. NIES-3757	1807358	S	7	0	7	0.00000
SRR6145059	Sporosarcina sp. PTS2304	2283194	S	7	0	7	0.00000
SRR6145059	Spongiibacter sp. IMCC21906	1620392	S	17	0	17	0.00000
SRR6145059	Spiroplasma sp. TIUS-1	216963	S	3	0	3	0.00000
SRR6145059	Spiroplasma sp. BIUS-1	216964	S	2	0	2	0.00000
SRR6145059	Spiribacter sp. 2438	2666185	S	13	0	13	0.00000
SRR6145059	Sphingorhabdus sp. JK6	2725558	S	40	0	40	0.00000
SRR6145059	Sphingopyxis sp. LPB0140	1913578	S	21	0	21	0.00000
SRR6145059	Sphingomonas virus Scott	2733954	S	2	0	2	0.00000
SRR6145059	Sphingomonas sp. YZ-8	2319844	S	120	0	120	0.00001
SRR6145059	Sphingobium virus Lacusarx	2560778	S	1	0	1	0.00000
SRR6145059	Sphingobacterium sp. ML3W	1538644	S	32	0	32	0.00000
SRR6145059	Sphingobacteriaceae bacterium GW460-11-11-14-LB5	1986952	S	18	0	18	0.00000
SRR6145059	Solibacillus sp. R5-41	2048654	S	7	0	7	0.00000
SRR6145059	Sodalis endosymbiont of Henestaris halophilus	1929246	S	4	0	4	0.00000
SRR6145059	Sinorhizobium virus N3	1980947	S	1	0	1	0.00000
SRR6145059	Simian adenovirus B	1165908	S	1	0	1	0.00000
SRR6145059	Silvanigrellales bacterium RF1110005	2493639	S	6	0	6	0.00000
SRR6145059	Shigella virus AG3	1987994	S	2	0	2	0.00000
SRR6145059	Shewanella sp. YLB-06	2593655	S	4	0	4	0.00000
SRR6145059	Shewanella sp. WE21	2029986	S	5	0	5	0.00000
SRR6145059	Shewanella sp. M2	2487742	S	5	0	5	0.00000
SRR6145059	Shewanella sp. Arc9-LZ	2698686	S	3	0	3	0.00000
SRR6145059	Shayang ascaridia galli virus 2	1923460	S	1	0	1	0.00000
SRR6145059	Serratia virus SM9-3Y	2732711	S	1	0	1	0.00000
SRR6145059	Serratia phage Eta	1282995	S	2	0	2	0.00000
SRR6145059	Seonamhaeicola sp. S2-3	1936081	S	15	0	15	0.00000
SRR6145059	Selenomonas sp. oral taxon 920	1884263	S	61	1	62	0.00001
SRR6145059	Selenomonas sp. oral taxon 478	712538	S	17	12	29	0.00000
SRR6145059	Selenomonas sp. oral taxon 136	713030	S	28	19	47	0.00001
SRR6145059	Selenomonas sp. oral taxon 126	712528	S	77	1	78	0.00001
SRR6145059	Sediminicola sp. YIK13	1453352	S	12	0	12	0.00000
SRR6145059	Salmonella virus S126	2732028	S	1	0	1	0.00000
SRR6145059	Salinisphaera sp. LB1	2183911	S	45	0	45	0.00001
SRR6145059	Salinimonas sp. KX18D6	2572577	S	7	0	7	0.00000
SRR6145059	Salinibacterium sp. UTAS2018	2508880	S	35	0	35	0.00000
SRR6145059	Salinarchaeum sp. Harcht-Bsk1	1333523	S	22	0	22	0.00000
SRR6145059	Salegentibacter sp. T436	1729720	S	11	0	11	0.00000
SRR6145059	Salarchaeum sp. JOR-1	2599399	S	17	0	17	0.00000
SRR6145059	Ruminococcus sp. JE7A12	2564099	S	3	0	3	0.00000
SRR6145059	Romboutsia sp. CE17	2724150	S	13	0	13	0.00000
SRR6145059	Rickettsiales endosymbiont of Stachyamoeba lipophora	2486578	S	3	0	3	0.00000
SRR6145059	Rickettsiales bacterium Ac37b	1528098	S	8	0	8	0.00000
SRR6145059	Rickettsia slovaca	35794	S	1	-1	0	0.00000
SRR6145059	Rickettsia endosymbiont of Ixodes scapularis	444612	S	5	1	6	0.00000
SRR6145059	Rickettsia endosymbiont of Bemisia tabaci	337479	S	20	1	21	0.00000
SRR6145059	Rhodoferax sp. Gr-4	2527691	S	24	0	24	0.00000
SRR6145059	Rhodocytophaga sp. 172606-1	2704465	S	26	0	26	0.00000
SRR6145059	Rhodococcus phage REQ3	1109714	S	2	0	2	0.00000
SRR6145059	Rhodococcus phage Jace	2182360	S	1	0	1	0.00000
SRR6145059	Rhodococcus phage E3	1007869	S	3	0	3	0.00000
SRR6145059	Rhodobacteraceae bacterium BAR1	2171755	S	51	0	51	0.00001
SRR6145059	Rhizobium virus RHEph01	2733939	S	1	0	1	0.00000
SRR6145059	Rhizobium phage vB_RleS_L338C	1414737	S	1	0	1	0.00000
SRR6145059	Rhizobium phage vB_RleM_PPF1	1498228	S	1	0	1	0.00000
SRR6145059	Rhizobium phage RR1-A	929833	S	1	0	1	0.00000
SRR6145059	Ralstonia virus phiAp1	1932865	S	1	0	1	0.00000
SRR6145059	Ralstonia virus RsoP1EGY	2733919	S	2	0	2	0.00000
SRR6145059	Ralstonia virus RSL1	1980923	S	1	0	1	0.00000
SRR6145059	Ralstonia virus RSJ2	2733594	S	1	0	1	0.00000
SRR6145059	Ralstonia virus RSB2	2733927	S	1	0	1	0.00000
SRR6145059	Ralstonia phage RSP15	1785960	S	1	0	1	0.00000
SRR6145059	Rahnella sp. ERMR1:05	1805933	S	19	0	19	0.00000
SRR6145059	Pusillimonas sp. DMV24BSW_D	2716226	S	17	0	17	0.00000
SRR6145059	Psychroserpens sp. NJDZ02	2570561	S	3	0	3	0.00000
SRR6145059	Psychromonas sp. CNPT3	314282	S	7	0	7	0.00000
SRR6145059	Psychrobacter sp. P11G3	1699623	S	20	0	20	0.00000
SRR6145059	Psychrobacter sp. P11F6	1699621	S	62	0	62	0.00001
SRR6145059	Psychrobacter sp. G	571800	S	15	0	15	0.00000
SRR6145059	Psychrobacter sp. DAB_AL43B	1028416	S	19	0	19	0.00000
SRR6145059	Psittacine aviadenovirus B	2169709	S	1	0	1	0.00000
SRR6145059	Pseudovibrio sp. FO-BEG1	911045	S	19	0	19	0.00000
SRR6145059	Pseudomonas virus nickie	2560688	S	2	0	2	0.00000
SRR6145059	Pseudomonas virus SM1	2560683	S	3	0	3	0.00000
SRR6145059	Pseudomonas virus PaMx74	1982358	S	1	0	1	0.00000
SRR6145059	Pseudomonas virus PaBG	2734089	S	3	0	3	0.00000
SRR6145059	Pseudomonas virus Noxifer	2560671	S	2	0	2	0.00000
SRR6145059	Pseudomonas virus NP1	1982240	S	1	0	1	0.00000
SRR6145059	Pseudomonas virus LUZ7	1982596	S	1	0	1	0.00000
SRR6145059	Pseudomonas virus KPP25	1982591	S	2	0	2	0.00000
SRR6145059	Pseudomonas virus EL	1984787	S	29	0	29	0.00000
SRR6145059	Pseudomonas syringae group genomosp. 3	251701	S	42	7	49	0.00001
SRR6145059	Pseudomonas sp. S-6-2	1931241	S	25	0	25	0.00000
SRR6145059	Pseudomonas sp. OIL-1	2706126	S	22	0	22	0.00000
SRR6145059	Pseudomonas sp. M30-35	1981174	S	18	0	18	0.00000
SRR6145059	Pseudomonas sp. DG56-2	2320270	S	23	0	23	0.00000
SRR6145059	Pseudomonas sp. CC6-YY-74	1930532	S	43	0	43	0.00001
SRR6145059	Pseudomonas sp. C27(2019)	2604941	S	9	0	9	0.00000
SRR6145059	Pseudomonas phage phi-2	693582	S	1	0	1	0.00000
SRR6145059	Pseudomonas phage PaP2	270673	S	1	0	1	0.00000
SRR6145059	Pseudomonas phage PaMx42	1175662	S	20	0	20	0.00000
SRR6145059	Pseudomonas phage Lu11	1161927	S	3	0	3	0.00000
SRR6145059	Pseudodesulfovibrio sp. zrk46	2725288	S	5	0	5	0.00000
SRR6145059	Pseudoalteromonas sp. THAF3	2587843	S	1	0	1	0.00000
SRR6145059	Pseudoalteromonas sp. R3	1709477	S	11	0	11	0.00000
SRR6145059	Pseudoalteromonas sp. NC201	1514074	S	1	0	1	0.00000
SRR6145059	Pseudoalteromonas sp. DL-6	1390185	S	8	0	8	0.00000
SRR6145059	Pseudoalteromonas sp. A25	116092	S	2	0	2	0.00000
SRR6145059	Pseudoalteromonas sp. 16-SW-7	2583375	S	2	0	2	0.00000
SRR6145059	Pseudoalteromonas sp. 13-15	1761891	S	1	0	1	0.00000
SRR6145059	Pseudoalteromonas phage pYD6-A	754052	S	1	0	1	0.00000
SRR6145059	Pseudanabaena sp. ABRG5-3	685565	S	13	0	13	0.00000
SRR6145059	Providencia virus PR1	2560652	S	1	0	1	0.00000
SRR6145059	Proteus sp. ZN5	2697019	S	2	0	2	0.00000
SRR6145059	Proteus sp. CD3	1921565	S	1	0	1	0.00000
SRR6145059	Prosthecochloris sp. HL-130-GSB	1974213	S	6	0	6	0.00000
SRR6145059	Prosthecochloris sp. GSB1	281093	S	8	0	8	0.00000
SRR6145059	Prolixibacteraceae bacterium WC007	2681766	S	48	0	48	0.00001
SRR6145059	Prochlorococcus phage P-SSM4	268747	S	1	0	1	0.00000
SRR6145059	Prochlorococcus phage P-SSM2	268746	S	1	0	1	0.00000
SRR6145059	Prochlorococcus phage P-HM2	445696	S	1	0	1	0.00000
SRR6145059	Prevotella sp. oral taxon 299	652716	S	273	13	286	0.00003
SRR6145059	Pradoshia sp. D12	2651284	S	3	0	3	0.00000
SRR6145059	Porcine type-C oncovirus	369960	S	4	0	4	0.00000
SRR6145059	Pontibacillus sp. HMF3514	2692425	S	5	0	5	0.00000
SRR6145059	Polynucleobacter sp. MWH-UH21B	1743174	S	12	0	12	0.00000
SRR6145059	Polynucleobacter sp. LimPoW16	1743162	S	4	0	4	0.00000
SRR6145059	Polaribacter sp. SA4-12	1312072	S	5	0	5	0.00000
SRR6145059	Polaribacter sp. SA4-10	754397	S	14	0	14	0.00000
SRR6145059	Polaribacter sp. MED152	313598	S	8	0	8	0.00000
SRR6145059	Polaribacter sp. L3A8	2686361	S	11	0	11	0.00000
SRR6145059	Polaribacter sp. Hel1_33_78	1336804	S	9	0	9	0.00000
SRR6145059	Polaribacter sp. ALD11	2058137	S	6	0	6	0.00000
SRR6145059	Planococcus sp. Y42	2213202	S	6	0	6	0.00000
SRR6145059	Planctomycetes bacterium V22	2528027	S	10	0	10	0.00000
SRR6145059	Planctomycetes bacterium V144	2527964	S	3	0	3	0.00000
SRR6145059	Planctomycetes bacterium TBK1r	2527963	S	22	0	22	0.00000
SRR6145059	Planctomycetes bacterium SV_7m_r	2528025	S	7	0	7	0.00000
SRR6145059	Planctomycetes bacterium SRT547	2596890	S	12	0	12	0.00000
SRR6145059	Planctomycetes bacterium Q31a	2527968	S	16	0	16	0.00000
SRR6145059	Planctomycetes bacterium Poly30	2528018	S	53	0	53	0.00001
SRR6145059	Planctomycetes bacterium Pla85_3_4	2528010	S	32	0	32	0.00000
SRR6145059	Planctomycetes bacterium Pla175	2528009	S	72	0	72	0.00001
SRR6145059	Planctomycetes bacterium Pla163	2528008	S	64	0	64	0.00001
SRR6145059	Planctomycetes bacterium Pla110	2528007	S	6	0	6	0.00000
SRR6145059	Planctomycetes bacterium Pan44	2527983	S	29	0	29	0.00000
SRR6145059	Planctomycetes bacterium Pan265	2527982	S	26	0	26	0.00000
SRR6145059	Planctomycetes bacterium Pan241w	2527973	S	7	0	7	0.00000
SRR6145059	Planctomycetes bacterium Pan216	2527975	S	21	0	21	0.00000
SRR6145059	Planctomycetes bacterium Pan189	2527980	S	14	0	14	0.00000
SRR6145059	Planctomycetes bacterium Pan181	2527972	S	14	0	14	0.00000
SRR6145059	Planctomycetes bacterium MalM25	2527998	S	48	0	48	0.00001
SRR6145059	Planctomycetes bacterium Mal48	2527994	S	10	0	10	0.00000
SRR6145059	Planctomycetes bacterium Mal4	2528026	S	29	0	29	0.00000
SRR6145059	Planctomycetes bacterium KS4	2528020	S	7	0	7	0.00000
SRR6145059	Planctomycetes bacterium K23_9	1930275	S	6	0	6	0.00000
SRR6145059	Planctomycetes bacterium K22_7	1930273	S	12	0	12	0.00000
SRR6145059	Planctomycetes bacterium HG15A2	1930276	S	9	0	9	0.00000
SRR6145059	Planctomycetes bacterium FF011L	1930274	S	5	0	5	0.00000
SRR6145059	Planctomycetes bacterium Enr17	2527976	S	7	0	7	0.00000
SRR6145059	Planctomycetes bacterium Enr13	2527979	S	20	0	20	0.00000
SRR6145059	Planctomycetes bacterium ElP	2527974	S	140	0	140	0.00002
SRR6145059	Planctomycetes bacterium ETA_A8	2528021	S	33	0	33	0.00000
SRR6145059	Planctomycetes bacterium ETA_A1	2528023	S	217	0	217	0.00003
SRR6145059	Planctomycetales bacterium 10988	2603660	S	10	0	10	0.00000
SRR6145059	Pirellula sp. SH-Sr6A	1632865	S	98	0	98	0.00001
SRR6145059	Phycisphaerae bacterium RAS2	2528035	S	24	0	24	0.00000
SRR6145059	Phaeocystis globosa virus	251749	S	2	0	2	0.00000
SRR6145059	Peptostreptococcaceae bacterium oral taxon 929	2081703	S	863	37	900	0.00011
SRR6145059	Peptoniphilus sp. ING2-D1G	1912856	S	15	0	15	0.00000
SRR6145059	Peptococcaceae bacterium DCMF	1761012	S	12	0	12	0.00000
SRR6145059	Pelosinus sp. UFO1	484770	S	1	0	1	0.00000
SRR6145059	Pelobacter sp. SFB93	1842532	S	6	0	6	0.00000
SRR6145059	Pelistega sp. NLN63	2652177	S	5	0	5	0.00000
SRR6145059	Pelagibacter phage HTVC008M	1283076	S	2	0	2	0.00000
SRR6145059	Pedobacter sp. G11	2482728	S	20	0	20	0.00000
SRR6145059	Pedobacter sp. CJ43	2605747	S	22	0	22	0.00000
SRR6145059	Pectobacterium virus phiTE	1980961	S	1	0	1	0.00000
SRR6145059	Pasteurellaceae bacterium RH1A	1823760	S	2	0	2	0.00000
SRR6145059	Pasteurellaceae bacterium Orientalotternb1	1524976	S	1	0	1	0.00000
SRR6145059	Paramecium bursaria Chlorella virus A1	381899	S	1	0	1	0.00000
SRR6145059	Paraliobacillus sp. X-1125	2213194	S	5	0	5	0.00000
SRR6145059	Paraglaciecola sp. L3A3	2686358	S	6	0	6	0.00000
SRR6145059	Paraglaciecola sp. L1A13	2686359	S	3	0	3	0.00000
SRR6145059	Parageobacillus genomosp. 1	1295642	S	7	0	7	0.00000
SRR6145059	Paracoccus virus Shpa	2560625	S	1	0	1	0.00000
SRR6145059	Pantoea virus Limelight	1985729	S	1	0	1	0.00000
SRR6145059	Pantoea sp. CCBC3-3-1	2490851	S	13	0	13	0.00000
SRR6145059	Pantoea sp. 201603H	2479547	S	13	0	13	0.00000
SRR6145059	Panine betaherpesvirus 2	188763	S	1	0	1	0.00000
SRR6145059	Paenisporosarcina sp. K2R23-3	2320858	S	6	0	6	0.00000
SRR6145059	Paenibacillus sp. RUD330	2023772	S	19	0	19	0.00000
SRR6145059	Paenibacillus sp. JDR-2	324057	S	4	0	4	0.00000
SRR6145059	Paenibacillus sp. IHB B 3084	867076	S	1	0	1	0.00000
SRR6145059	Paenibacillus sp. HB172198	2565926	S	5	0	5	0.00000
SRR6145059	Paenibacillus sp. DCT19	2211212	S	8	0	8	0.00000
SRR6145059	Paenibacillus sp. CAA11	1532905	S	8	0	8	0.00000
SRR6145059	Paenibacillus sp. BIHB4019	1870819	S	7	0	7	0.00000
SRR6145059	Paenibacillus sp. 37	2607911	S	2	0	2	0.00000
SRR6145059	Paenibacillus sp. 32O-W	1695218	S	23	0	23	0.00000
SRR6145059	Paenibacillus sp. 14171R-81	2704463	S	23	0	23	0.00000
SRR6145059	Paenibacillus sp. 12200R-189	2704462	S	27	0	27	0.00000
SRR6145059	Paenibacillus larvae	1464	S	4	-4	0	0.00000
SRR6145059	Paenibacillaceae bacterium GAS479	1882832	S	1	0	1	0.00000
SRR6145059	Oxynema sp. AP17	2064643	S	11	0	11	0.00000
SRR6145059	Ottowia sp. oral taxon 894	1658672	S	229	4	233	0.00003
SRR6145059	Oscillatoriales cyanobacterium JSC-12	864702	S	7	0	7	0.00000
SRR6145059	Only Syngen Nebraska virus 5	1917232	S	1	0	1	0.00000
SRR6145059	Olsenella sp. oral taxon 807	712411	S	170	4	174	0.00002
SRR6145059	Olleya sp. Bg11-27	2058135	S	7	0	7	0.00000
SRR6145059	Oceanospirillales bacterium S2-4-1H	2683272	S	6	0	6	0.00000
SRR6145059	Oceanobacillus sp. 160	2052660	S	3	0	3	0.00000
SRR6145059	Oceanispirochaeta sp. K2	2518645	S	4	0	4	0.00000
SRR6145059	Oceanimonas sp. GK1	511062	S	25	0	25	0.00000
SRR6145059	Oceanihabitans sp. IOP_32	2529032	S	11	0	11	0.00000
SRR6145059	Nostocales cyanobacterium HT-58-2	1940762	S	20	0	20	0.00000
SRR6145059	Nostoc sp. NIES-4103	2005458	S	11	0	11	0.00000
SRR6145059	Nostoc sp. CENA543	1869241	S	11	0	11	0.00000
SRR6145059	Nonlabens sp. SY33080	2719911	S	2	0	2	0.00000
SRR6145059	Nonlabens sp. MJ115	2496866	S	4	0	4	0.00000
SRR6145059	Nonlabens sp. MB-3u-79	2058134	S	7	0	7	0.00000
SRR6145059	Nonlabens sp. Hel1_33_55	1336802	S	5	0	5	0.00000
SRR6145059	Nonlabens sp. Ci31	2608253	S	8	0	8	0.00000
SRR6145059	Nitrospira sp. KM1	1936990	S	9	0	9	0.00000
SRR6145059	Nitrosomonas sp. Is79A3	261292	S	5	0	5	0.00000
SRR6145059	Nitrosomonas sp. AL212	153948	S	3	0	3	0.00000
SRR6145059	Nitrincola sp. KXZD1103	2614693	S	15	0	15	0.00000
SRR6145059	Nitratiruptor sp. SB155-2	387092	S	2	0	2	0.00000
SRR6145059	Nissabacter sp. SGAir0207	2126321	S	30	0	30	0.00000
SRR6145059	Nesterenkonia sp. NBAIMH1	2600320	S	109	0	109	0.00001
SRR6145059	Neokomagataea sp. Ha5	2558360	S	19	0	19	0.00000
SRR6145059	Neisseria sp. oral taxon 014	641148	S	448	39	487	0.00006
SRR6145059	Neisseria sp. 10022	1853276	S	12	0	12	0.00000
SRR6145059	Nautilia sp. PV-1	2579250	S	5	0	5	0.00000
SRR6145059	Nakamurella sp. s14-144	1902245	S	27	0	27	0.00000
SRR6145059	Myxococcus virus Mx8	2560611	S	1	0	1	0.00000
SRR6145059	Myroides sp. CJ210	2572594	S	7	0	7	0.00000
SRR6145059	Mycoplasma sp. OR1901	2742195	S	3	0	3	0.00000
SRR6145059	Mycoplasma sp. NEAQ87857	2683967	S	1	0	1	0.00000
SRR6145059	Mycoplasma sp. C264-NAS	2726117	S	3	0	3	0.00000
SRR6145059	Mycoplasma sp. 1654_15	2725994	S	2	0	2	0.00000
SRR6145059	Mycoplasma sp. (ex Biomphalaria glabrata)	1749074	S	3	0	3	0.00000
SRR6145059	Mycobacterium virus Vincenzo	1983110	S	3	0	3	0.00000
SRR6145059	Mycobacterium virus Tortellini	2560608	S	2	0	2	0.00000
SRR6145059	Mycobacterium virus Sbash	2169812	S	1	0	1	0.00000
SRR6145059	Mycobacterium virus Patience	1982360	S	1	0	1	0.00000
SRR6145059	Mycobacterium virus Macncheese	1195070	S	2	0	2	0.00000
SRR6145059	Mycobacterium virus Larva	1056831	S	1	0	1	0.00000
SRR6145059	Mycobacterium virus Halo	373407	S	1	0	1	0.00000
SRR6145059	Mycobacterium virus Godines	1982904	S	1	0	1	0.00000
SRR6145059	Mycobacterium virus Gaia	1982148	S	1	0	1	0.00000
SRR6145059	Mycobacterium virus Crimd	861045	S	1	0	1	0.00000
SRR6145059	Mycobacterium virus Angelica	861044	S	1	0	1	0.00000
SRR6145059	Mycobacterium virus 32HC	2170239	S	1	0	1	0.00000
SRR6145059	Mycobacterium phage Sneeze	1873887	S	4	0	4	0.00000
SRR6145059	Mycobacterium phage Phlei	1690684	S	1	0	1	0.00000
SRR6145059	Mycobacterium phage Myrna	546805	S	1	0	1	0.00000
SRR6145059	Mycobacterium phage MOOREtheMARYer	1647309	S	2	0	2	0.00000
SRR6145059	Mycobacterium phage KayaCho	1340830	S	1	0	1	0.00000
SRR6145059	Mycobacterium phage Jolie2	1458831	S	1	0	1	0.00000
SRR6145059	Mycobacterium phage Jolie1	1463812	S	1	0	1	0.00000
SRR6145059	Mycobacterium phage EagleEye	1429759	S	1	0	1	0.00000
SRR6145059	Mycobacterium phage Dori	1089121	S	1	0	1	0.00000
SRR6145059	Mycobacterium phage DS6A	45764	S	1	0	1	0.00000
SRR6145059	Mycobacterium phage Cambiare	1647305	S	1	0	1	0.00000
SRR6145059	Mycobacterium phage Adler	1327959	S	1	0	1	0.00000
SRR6145059	Muriicola sp. MMS17-SY002	2507538	S	7	0	7	0.00000
SRR6145059	Murid betaherpesvirus 1	10366	S	1	0	1	0.00000
SRR6145059	Muribaculum sp. TLL-A4	2530390	S	3	0	3	0.00000
SRR6145059	Mucilaginibacter sp. HYN0043	2305508	S	27	0	27	0.00000
SRR6145059	Mucilaginibacter sp. F39-2	2728022	S	24	0	24	0.00000
SRR6145059	Mucilaginibacter sp. 14171R-50	2703789	S	10	0	10	0.00000
SRR6145059	Moumouvirus	985782	S	1	0	1	0.00000
SRR6145059	Moraxellaceae bacterium HYN0046	2283318	S	24	0	24	0.00000
SRR6145059	Molluscum contagiosum virus	10279	S	3	0	3	0.00000
SRR6145059	Microvirga sp. 17 mud 1-3	2082949	S	160	24	184	0.00002
SRR6145059	Microcystis sp. MC19	1967666	S	2	0	2	0.00000
SRR6145059	Microbulbifer sp. THAF38	2587856	S	5	0	5	0.00000
SRR6145059	Microbulbifer sp. SH-1	2681547	S	21	0	21	0.00000
SRR6145059	Microbulbifer sp. GL-2	2591606	S	6	0	6	0.00000
SRR6145059	Microbulbifer sp. ALW1	1516059	S	14	0	14	0.00000
SRR6145059	Microbulbifer sp. A4B17	359370	S	10	0	10	0.00000
SRR6145059	Microbacterium virus Zeta1847	2734292	S	3	0	3	0.00000
SRR6145059	Microbacterium virus Krampus	2734242	S	2	0	2	0.00000
SRR6145059	Microbacterium virus Goodman	2734238	S	1	0	1	0.00000
SRR6145059	Microbacterium virus Eleri	2560589	S	1	0	1	0.00000
SRR6145059	Microbacterium virus Dismas	2560588	S	4	0	4	0.00000
SRR6145059	Microbacterium virus Appa	2734215	S	2	0	2	0.00000
SRR6145059	Microbacterium phage Araxxi	2590948	S	1	0	1	0.00000
SRR6145059	Methyloversatilis sp. RAC08	1842540	S	55	0	55	0.00001
SRR6145059	Methylomonas sp. LW13	107637	S	16	0	16	0.00000
SRR6145059	Methylomonas sp. GJ1	2608981	S	18	0	18	0.00000
SRR6145059	Methanothermobacter sp. KEPCO-1	2603820	S	1	0	1	0.00000
SRR6145059	Methanosphaera sp. BMS	1789762	S	3	0	3	0.00000
SRR6145059	Methanosarcina thermophila	2210	S	2	-2	0	0.00000
SRR6145059	Methanopyrus sp. SNP6	1937005	S	1	0	1	0.00000
SRR6145059	Methanopyrus sp. KOL6	1937004	S	2	0	2	0.00000
SRR6145059	Methanomassiliicoccaceae archaeon DOK	1535962	S	5	0	5	0.00000
SRR6145059	Methanofervidicoccus sp. A16	2607662	S	3	0	3	0.00000
SRR6145059	Methanocaldococcus sp. FS406-22	644281	S	4	0	4	0.00000
SRR6145059	Methanobrevibacter sp. YE315	1609968	S	1	0	1	0.00000
SRR6145059	Methanobrevibacter sp. AbM4	224719	S	2	0	2	0.00000
SRR6145059	Methanobacterium sp. MB1	1379702	S	1	0	1	0.00000
SRR6145059	Methanobacterium phage psiM2	77048	S	1	0	1	0.00000
SRR6145059	Mesorhizobium virus Lo5R7ANS	2733941	S	1	0	1	0.00000
SRR6145059	Melanoplus sanguinipes entomopoxvirus	83191	S	1	0	1	0.00000
SRR6145059	Marinomonas sp. MWYL1	400668	S	3	0	3	0.00000
SRR6145059	Marinomonas sp. FW-1	2071621	S	7	0	7	0.00000
SRR6145059	Marinobacterium sp. LSUCC0821	2668067	S	3	0	3	0.00000
SRR6145059	Marinobacter sp. es.042	1761794	S	1	0	1	0.00000
SRR6145059	Marinobacter sp. LV10R510-11A	1415568	S	14	0	14	0.00000
SRR6145059	Marinobacter sp. JH2	2547598	S	10	0	10	0.00000
SRR6145059	Mariniflexile sp. TRM1-10	2027857	S	14	0	14	0.00000
SRR6145059	Maribacter sp. T28	1836467	S	7	0	7	0.00000
SRR6145059	Maribacter sp. MJ134	2496865	S	10	0	10	0.00000
SRR6145059	Maribacter sp. HTCC2170	313603	S	8	0	8	0.00000
SRR6145059	Mannheimia sp. ZY170218	2679994	S	7	0	7	0.00000
SRR6145059	Mannheimia sp. USDA-ARS-USMARC-1261	1432056	S	2	0	2	0.00000
SRR6145059	Magnetospira sp. QH-2	1288970	S	26	0	26	0.00000
SRR6145059	Lysinibacillus sp. YS11	2072025	S	11	0	11	0.00000
SRR6145059	Lysinibacillus sp. SGAir0095	2070463	S	16	0	16	0.00000
SRR6145059	Lysinibacillus sp. 2017	2169540	S	4	0	4	0.00000
SRR6145059	Luteolibacter sp. G-1-1-1	2728835	S	52	0	52	0.00001
SRR6145059	Listeria sp. PSOL-1	1844999	S	1	0	1	0.00000
SRR6145059	Limnohabitans sp. 103DPR2	1678129	S	17	0	17	0.00000
SRR6145059	Limnobacter sp. SAORIC-580	2732163	S	31	0	31	0.00000
SRR6145059	Lettuce mosaic virus	12202	S	1	0	1	0.00000
SRR6145059	Leptotrichia sp. oral taxon 847	1785996	S	22	3	25	0.00000
SRR6145059	Leptotrichia sp. oral taxon 498	712368	S	81	16	97	0.00001
SRR6145059	Leptotrichia sp. oral taxon 212	712357	S	261	8	269	0.00003
SRR6145059	Leptospirillum sp. Group II 'CF-1'	1660083	S	1	0	1	0.00000
SRR6145059	Leptospira borgpetersenii	174	S	4	-4	0	0.00000
SRR6145059	Leptospira biflexa	172	S	6	-6	0	0.00000
SRR6145059	Leptolyngbya sp. NIES-3755	1752064	S	20	0	20	0.00000
SRR6145059	Lentilitoribacter sp. Alg239-R112	2305987	S	7	0	7	0.00000
SRR6145059	Legionella sp. TUM19329	2708020	S	4	0	4	0.00000
SRR6145059	Legionella endosymbiont of Polyplax serrata	2005262	S	2	0	2	0.00000
SRR6145059	Leeuwenhoekiella sp. ZYFB001	2719912	S	7	0	7	0.00000
SRR6145059	Lactococcus virus CB13	665883	S	1	0	1	0.00000
SRR6145059	Lactococcus sp. 1JSPR-7	2419773	S	6	0	6	0.00000
SRR6145059	Lactococcus phage WRP3	1560313	S	1	0	1	0.00000
SRR6145059	Lactococcus phage 949	881953	S	1	0	1	0.00000
SRR6145059	Lactococcus phage 340	1262533	S	1	0	1	0.00000
SRR6145059	Lactobacillus sp. wkB8	1545702	S	2	0	2	0.00000
SRR6145059	Lactobacillus sp. CBA3606	2099789	S	3	0	3	0.00000
SRR6145059	Lactobacillus sp. CBA3605	2099788	S	2	0	2	0.00000
SRR6145059	Lactobacillus sp. BHWM-4	2419772	S	1	0	1	0.00000
SRR6145059	Lactobacillus phage LfeSau	1567453	S	1	0	1	0.00000
SRR6145059	Lactobacillus phage LfeInf	1567484	S	2	0	2	0.00000
SRR6145059	Lactobacillus kefiranofaciens	267818	S	5	-5	0	0.00000
SRR6145059	Lacinutrix sp. Bg11-31	2057808	S	10	0	10	0.00000
SRR6145059	Lacinutrix sp. 5H-3-7-4	983544	S	5	0	5	0.00000
SRR6145059	Lachnospiraceae bacterium oral taxon 500	712991	S	53	3	56	0.00001
SRR6145059	Lachnospiraceae bacterium KM106-2	2093742	S	4	0	4	0.00000
SRR6145059	Lachnospiraceae bacterium KGMB03038	2594789	S	5	0	5	0.00000
SRR6145059	Lachnospiraceae bacterium Choco86	2109690	S	10	0	10	0.00000
SRR6145059	Lachnoclostridium sp. YL32	1834196	S	1	0	1	0.00000
SRR6145059	Labrenzia sp. THAF82	2587861	S	16	0	16	0.00000
SRR6145059	Labrenzia sp. PHM005	2590016	S	18	0	18	0.00000
SRR6145059	Kushneria sp. YCWA18	657387	S	16	0	16	0.00000
SRR6145059	Kordia sp. SMS9	2282170	S	15	0	15	0.00000
SRR6145059	Klebsiella virus PKP126	1981042	S	1	0	1	0.00000
SRR6145059	Klebsiella virus KP32	1985726	S	1	0	1	0.00000
SRR6145059	Klebsiella phage vB_Kpn_F48	2070028	S	2	0	2	0.00000
SRR6145059	Klebsiella phage Marfa	2587809	S	1	0	1	0.00000
SRR6145059	Klebsiella phage KNP2	1871716	S	1	0	1	0.00000
SRR6145059	Kiritimatiellaeota bacterium S-5007	2697043	S	10	0	10	0.00000
SRR6145059	Kineobactrum sp. M2	2708301	S	36	0	36	0.00000
SRR6145059	Jeotgalibaca sp. PTS2502	1903686	S	3	0	3	0.00000
SRR6145059	Janthinobacterium sp. B9-8	1236179	S	14	0	14	0.00000
SRR6145059	Jannaschia sp. CCS1	290400	S	54	0	54	0.00001
SRR6145059	Izhakiella sp. KSNA2	2579935	S	22	0	22	0.00000
SRR6145059	Iodobacter sp. H11R3	2496266	S	8	0	8	0.00000
SRR6145059	Idiomarinaceae bacterium HL-53	1298881	S	4	0	4	0.00000
SRR6145059	Idiomarina sp. X4	2055892	S	3	0	3	0.00000
SRR6145059	Idiomarina sp. OT37-5b	2100422	S	3	0	3	0.00000
SRR6145059	Idiomarina loihiensis	135577	S	11	-11	0	0.00000
SRR6145059	Hyphomonas sp. Mor2	1906738	S	30	0	30	0.00000
SRR6145059	Hyphantria cunea nucleopolyhedrovirus	28288	S	1	0	1	0.00000
SRR6145059	Hydrogenophaga sp. PAMC20947	2565558	S	57	0	57	0.00001
SRR6145059	Hydrogenobacter sp. T-8	1632019	S	4	0	4	0.00000
SRR6145059	Hungateiclostridium thermocellum	1515	S	2	-2	0	0.00000
SRR6145059	Human polyomavirus 5	1891726	S	8	0	8	0.00000
SRR6145059	Human polyomavirus 11	1891745	S	9	0	9	0.00000
SRR6145059	Human gammaherpesvirus 4	10376	S	2	0	2	0.00000
SRR6145059	Human betaherpesvirus 7	10372	S	3	0	3	0.00000
SRR6145059	Human betaherpesvirus 5	10359	S	1	0	1	0.00000
SRR6145059	Human alphaherpesvirus 1	10298	S	2	0	2	0.00000
SRR6145059	Highlands J virus	11024	S	1	0	1	0.00000
SRR6145059	Heterocapsa circularisquama DNA virus 01	650121	S	1	0	1	0.00000
SRR6145059	Helicoverpa armigera nucleopolyhedrovirus	51313	S	1	0	1	0.00000
SRR6145059	Halothiobacillus sp. LS2	1860122	S	16	0	16	0.00000
SRR6145059	Halorussus sp. ZS-3	2650975	S	17	0	17	0.00000
SRR6145059	Halorussus sp. RC-68	2505977	S	43	0	43	0.00001
SRR6145059	Halorientalis sp. IM1011	1932360	S	34	0	34	0.00000
SRR6145059	Halorhabdus sp. CBA1104	1380432	S	10	0	10	0.00000
SRR6145059	Haloprofundus sp. MHR1	2572921	S	26	0	26	0.00000
SRR6145059	Halomonas sp. Y2R2	2562282	S	24	0	24	0.00000
SRR6145059	Halomonas sp. BC-M4-5	2497861	S	65	0	65	0.00001
SRR6145059	Halocella sp. SP3-1	2382161	S	9	0	9	0.00000
SRR6145059	Halobacteriovorax sp. BALOs_7	2109558	S	8	0	8	0.00000
SRR6145059	Haloarculaceae archaeon HArcel1	1679096	S	31	0	31	0.00000
SRR6145059	Haloarcula sp. JP-L23	2716717	S	21	0	21	0.00000
SRR6145059	Haloarcula hispanica	51589	S	2	-2	0	0.00000
SRR6145059	Haliotid herpesvirus 1	1513231	S	1	0	1	0.00000
SRR6145059	Haemophilus sp. oral taxon 036	712310	S	146	34	180	0.00002
SRR6145059	Granulicella sp. WH15	2602070	S	25	0	25	0.00000
SRR6145059	Gramella sp. MAR_2010_147	1250205	S	6	0	6	0.00000
SRR6145059	Gramella sp. MAR_2010_102	1250231	S	13	0	13	0.00000
SRR6145059	Gracilibacillus sp. SCU50	2663022	S	2	0	2	0.00000
SRR6145059	Gordonia virus Yvonnetastic	2560514	S	1	0	1	0.00000
SRR6145059	Gordonia virus Yeezy	2169731	S	1	0	1	0.00000
SRR6145059	Gordonia virus Wizard	2170254	S	1	0	1	0.00000
SRR6145059	Gordonia virus Vivi2	2560512	S	1	0	1	0.00000
SRR6145059	Gordonia virus Twister6	2170253	S	1	0	1	0.00000
SRR6145059	Gordonia virus Sour	2560509	S	1	0	1	0.00000
SRR6145059	Gordonia virus Schnabeltier	2734276	S	1	0	1	0.00000
SRR6145059	Gordonia virus Ruthy	2734272	S	2	0	2	0.00000
SRR6145059	Gordonia virus Orchid	2560508	S	2	0	2	0.00000
SRR6145059	Gordonia virus Nymphadora	2560507	S	2	0	2	0.00000
SRR6145059	Gordonia virus Nyceirae	2560506	S	1	0	1	0.00000
SRR6145059	Gordonia virus Mahdia	2560505	S	2	0	2	0.00000
SRR6145059	Gordonia virus Lucky10	2734247	S	12	0	12	0.00000
SRR6145059	Gordonia virus Lennon	2560504	S	1	0	1	0.00000
SRR6145059	Gordonia virus Hedwig	2560502	S	7	0	7	0.00000
SRR6145059	Gordonia virus Gsput1	2560500	S	1	0	1	0.00000
SRR6145059	Gordonia virus GTE2	2560497	S	1	0	1	0.00000
SRR6145059	Gordonia virus GMA6	2560495	S	1	0	1	0.00000
SRR6145059	Gordonia virus GAL1	2560493	S	15	0	15	0.00000
SRR6145059	Gordonia virus Eyre	2560492	S	2	0	2	0.00000
SRR6145059	Gordonia virus ClubL	1982559	S	1	0	1	0.00000
SRR6145059	Gordonia virus BrutonGaster	2734263	S	1	0	1	0.00000
SRR6145059	Gordonia virus Britbrat	2560489	S	12	0	12	0.00000
SRR6145059	Gordonia virus Bowser	2560487	S	3	0	3	0.00000
SRR6145059	Gordonia virus BaxterFox	2169730	S	3	0	3	0.00000
SRR6145059	Gordonia phage Rickmore	2507854	S	1	0	1	0.00000
SRR6145059	Gordonia phage Phinally	1821560	S	63	0	63	0.00001
SRR6145059	Gordonia phage GTE8	1647475	S	2	0	2	0.00000
SRR6145059	Gordonia phage GTE6	1647474	S	12	0	12	0.00000
SRR6145059	Gordonia phage GRU1	1109710	S	1	0	1	0.00000
SRR6145059	Gordonia phage GMA4	1647471	S	1	0	1	0.00000
SRR6145059	Gordonia phage GMA1	1647470	S	1	0	1	0.00000
SRR6145059	Gordonia phage Fairfaxidum	2572526	S	1	0	1	0.00000
SRR6145059	Gordonia phage Duffington	2507858	S	1	0	1	0.00000
SRR6145059	Gordonia phage Daredevil	2283286	S	1	0	1	0.00000
SRR6145059	Goose picornavirus 1	2079465	S	1	0	1	0.00000
SRR6145059	Glaesserella sp. 15-184	2030797	S	6	0	6	0.00000
SRR6145059	Glaciecola sp. THG-3.7	2489595	S	13	0	13	0.00000
SRR6145059	Glaciecola sp. 4H-3-7+YE-5	983545	S	3	0	3	0.00000
SRR6145059	Gilvibacter sp. SZ-19	754429	S	7	0	7	0.00000
SRR6145059	Gillisia sp. Hel1_33_143	1336796	S	6	0	6	0.00000
SRR6145059	Geobacter sp. FeAm09	2597769	S	22	0	22	0.00000
SRR6145059	Geobacillus virus E3	1572712	S	2	0	2	0.00000
SRR6145059	Geobacillus genomosp. 3	1921421	S	8	0	8	0.00000
SRR6145059	Gemmatimonas sp. TET16	2732249	S	28	0	28	0.00000
SRR6145059	Geminocystis sp. NIES-3708	1615909	S	7	0	7	0.00000
SRR6145059	Gemella sp. oral taxon 928	1785995	S	3	6	9	0.00000
SRR6145059	Gammaproteobacteria bacterium ESL0073	2070539	S	2	0	2	0.00000
SRR6145059	Gammaproteobacteria bacterium DM2	2169539	S	13	0	13	0.00000
SRR6145059	Fusobacterium sp. oral taxon 203	671211	S	41	18	59	0.00001
SRR6145059	Francisella sp. FSC1006	1547445	S	4	0	4	0.00000
SRR6145059	Formosa sp. L2A11	2686363	S	6	0	6	0.00000
SRR6145059	Formosa sp. Hel3_A1_48	1336795	S	4	0	4	0.00000
SRR6145059	Formosa sp. Hel1_33_131	1336794	S	9	0	9	0.00000
SRR6145059	Formosa sp. Hel1_31_208	1798225	S	15	0	15	0.00000
SRR6145059	Fluoribacter dumoffii	463	S	4	-4	0	0.00000
SRR6145059	Flintibacter sp. KGMB00164	2610895	S	12	0	12	0.00000
SRR6145059	Flavobacterium sp. XS-5	2602769	S	26	0	26	0.00000
SRR6145059	Flavobacterium sp. Sr18	935222	S	19	0	19	0.00000
SRR6145059	Flavobacterium sp. M31R6	2739062	S	14	0	14	0.00000
SRR6145059	Flavobacterium sp. CJ74	2294119	S	41	0	41	0.00000
SRR6145059	Flavobacteriaceae bacterium UJ101	1150389	S	7	0	7	0.00000
SRR6145059	Flavobacteriaceae bacterium MAR_2010_188	1250295	S	8	0	8	0.00000
SRR6145059	Flavobacteriaceae bacterium F202Z8	2583587	S	10	0	10	0.00000
SRR6145059	Flavobacteriaceae bacterium 3519-10	531844	S	55	0	55	0.00001
SRR6145059	Flavobacteriaceae bacterium 10Alg115	2584122	S	10	0	10	0.00000
SRR6145059	Flaviflexus sp. H23T48	2496867	S	46	0	46	0.00001
SRR6145059	Flammeovirgaceae bacterium 311	1257021	S	18	0	18	0.00000
SRR6145059	Flammeovirga sp. MY04	1191459	S	11	0	11	0.00000
SRR6145059	Fischerella sp. NIES-4106	2005456	S	18	0	18	0.00000
SRR6145059	Fibrella sp. ES10-3-2-2	1834519	S	13	0	13	0.00000
SRR6145059	Ferrimonas sp. S7	2724191	S	6	0	6	0.00000
SRR6145059	Faecalibacterium virus Brigit	2734096	S	2	0	2	0.00000
SRR6145059	Euzebya sp. DY32-46	1608957	S	95	0	95	0.00001
SRR6145059	Euproctis pseudoconspersa nucleopolyhedrovirus	307467	S	1	0	1	0.00000
SRR6145059	Escherichia virus Talmos	1910969	S	7	0	7	0.00000
SRR6145059	Escherichia virus SSL2009a	624134	S	1	0	1	0.00000
SRR6145059	Escherichia virus RB16	329381	S	1	0	1	0.00000
SRR6145059	Escherichia virus PBECO4	2560463	S	1	0	1	0.00000
SRR6145059	Escherichia virus NC29	1945586	S	3	0	3	0.00000
SRR6145059	Escherichia virus NC28	1945585	S	2	0	2	0.00000
SRR6145059	Escherichia virus ID62	1945588	S	1	0	1	0.00000
SRR6145059	Escherichia virus G4	1986034	S	5	0	5	0.00000
SRR6145059	Escherichia virus ECML-117	2734154	S	1	0	1	0.00000
SRR6145059	Escherichia virus EC1UPM	1920760	S	1	0	1	0.00000
SRR6145059	Escherichia sp. E4742	2044467	S	3	0	3	0.00000
SRR6145059	Escherichia phage Lw1	1307804	S	1	0	1	0.00000
SRR6145059	Escherichia phage Gluttony	1883202	S	1	0	1	0.00000
SRR6145059	Erysipelotrichaceae bacterium GAM147	2109692	S	3	0	3	0.00000
SRR6145059	Erysipelothrix sp. HDW6C	2714930	S	4	0	4	0.00000
SRR6145059	Erysipelothrix sp. HDW6B	2714929	S	3	0	3	0.00000
SRR6145059	Erysipelothrix sp. 15TAL0474	2485784	S	3	0	3	0.00000
SRR6145059	Erwiniaceae bacterium PD-1	2740817	S	13	0	13	0.00000
SRR6145059	Erwinia virus Yoloswag	2734158	S	1	0	1	0.00000
SRR6145059	Erwinia virus Wellington	2734153	S	1	0	1	0.00000
SRR6145059	Erwinia virus M7	1985307	S	1	0	1	0.00000
SRR6145059	Erwinia virus Ea214	1965384	S	2	0	2	0.00000
SRR6145059	Erwinia sp. J780	2681984	S	11	0	11	0.00000
SRR6145059	Erwinia phage pEp_SNUABM_01	2601643	S	2	0	2	0.00000
SRR6145059	Equid alphaherpesvirus 3	80341	S	1	0	1	0.00000
SRR6145059	Epinotia aporema granulovirus	166056	S	2	0	2	0.00000
SRR6145059	Enterococcus phage EF62phi	977801	S	1	0	1	0.00000
SRR6145059	Enterobacteriaceae endosymbiont of Plateumaris sericea	2675797	S	1	0	1	0.00000
SRR6145059	Enterobacteriaceae endosymbiont of Plateumaris pusilla	2675795	S	1	0	1	0.00000
SRR6145059	Enterobacteriaceae endosymbiont of Plateumaris consimilis	2675794	S	2	0	2	0.00000
SRR6145059	Enterobacteriaceae endosymbiont of Donacia tomentosa	2675787	S	2	0	2	0.00000
SRR6145059	Enterobacteriaceae endosymbiont of Donacia thalassina	2675786	S	1	0	1	0.00000
SRR6145059	Enterobacteriaceae endosymbiont of Donacia semicuprea	2675783	S	1	0	1	0.00000
SRR6145059	Enterobacteriaceae endosymbiont of Donacia provostii	2675781	S	2	0	2	0.00000
SRR6145059	Enterobacteriaceae endosymbiont of Donacia piscatrix	2675780	S	1	0	1	0.00000
SRR6145059	Enterobacteriaceae endosymbiont of Donacia crassipes	2675776	S	2	0	2	0.00000
SRR6145059	Enterobacteriaceae endosymbiont of Donacia clavipes	2675775	S	1	0	1	0.00000
SRR6145059	Enterobacteriaceae endosymbiont of Donacia cinerea	2675774	S	2	0	2	0.00000
SRR6145059	Enterobacteriaceae endosymbiont of Donacia cincticornis	2675773	S	1	0	1	0.00000
SRR6145059	Enterobacteriaceae endosymbiont of Donacia bicoloricornis	2675772	S	2	0	2	0.00000
SRR6145059	Enterobacteriaceae bacterium strain FGI 57	693444	S	17	0	17	0.00000
SRR6145059	Enterobacteria phage phi92	948870	S	1	0	1	0.00000
SRR6145059	Enterobacter virus Eap3	1985336	S	1	0	1	0.00000
SRR6145059	Enterobacter sp. SA187	1914861	S	18	0	18	0.00000
SRR6145059	Enterobacter sp. 638	399742	S	14	0	14	0.00000
SRR6145059	Enterobacter phage phiEap-2	1701257	S	4	0	4	0.00000
SRR6145059	Enterobacter phage EcP1	942016	S	1	0	1	0.00000
SRR6145059	Enterobacter cloacae complex sp. ECNIH7	1915310	S	20	61	81	0.00001
SRR6145059	Emcibacter sp. MEBiC09520	2582913	S	27	0	27	0.00000
SRR6145059	Elizabethkingia sp. JS20170427COW	2583851	S	25	0	25	0.00000
SRR6145059	Ehrlichia chaffeensis	945	S	3	-3	0	0.00000
SRR6145059	Eggerthellaceae bacterium zg-1050	2734634	S	9	0	9	0.00000
SRR6145059	Edaphobacter sp. 12200R-103	2703788	S	10	0	10	0.00000
SRR6145059	Ectothiorhodospiraceae bacterium BW-2	947515	S	5	0	5	0.00000
SRR6145059	Echinicola sp. LN3S3	2591634	S	6	0	6	0.00000
SRR6145059	Dysgonomonas sp. HDW5A	2714926	S	1	0	1	0.00000
SRR6145059	Draconibacterium sp. M1	2706887	S	8	0	8	0.00000
SRR6145059	Dokdonia sp. PRO95	1239415	S	3	0	3	0.00000
SRR6145059	Dokdonia sp. Dokd-P16	2173169	S	5	0	5	0.00000
SRR6145059	Dinoroseobacter virus D5C	2560407	S	1	0	1	0.00000
SRR6145059	Dietzia sp. oral taxon 368	712270	S	6564	882	7446	0.00089
SRR6145059	Dickeya virus AD1	2734080	S	4	0	4	0.00000
SRR6145059	Dickeya phage vB_DsoP_JA10	2283033	S	1	0	1	0.00000
SRR6145059	Dickeya paradisiaca	69223	S	11	-11	0	0.00000
SRR6145059	Desulfovibrio sp. IOR2	2583823	S	16	0	16	0.00000
SRR6145059	Delftia phage RG-2014	1563661	S	1	0	1	0.00000
SRR6145059	Deinococcus sp. S14-83	2489213	S	91	0	91	0.00001
SRR6145059	Deefgea sp. D17	2739061	S	8	0	8	0.00000
SRR6145059	Cyprinid herpesvirus 3	180230	S	4	0	4	0.00000
SRR6145059	Cycloclasticus sp. P1	385025	S	2	0	2	0.00000
SRR6145059	Curvibacter sp. AEP1-3	1844971	S	51	0	51	0.00001
SRR6145059	Cronobacter virus CR9	1914899	S	3	0	3	0.00000
SRR6145059	Cronobacter phage vB_CsaM_GAP32	1141136	S	1	0	1	0.00000
SRR6145059	Cronobacter phage S13	1327935	S	1	0	1	0.00000
SRR6145059	Cronobacter phage CR5	1195085	S	4	0	4	0.00000
SRR6145059	Crassaminicella sp. SY095	2599308	S	6	0	6	0.00000
SRR6145059	Coxiella endosymbiont of Amblyomma sculptum	2487929	S	1	2	3	0.00000
SRR6145059	Corynebacterium sp. sy039	2599641	S	35	0	35	0.00000
SRR6145059	Corynebacteriaceae bacterium 'ARUP UnID 227'	1164002	S	103	115	218	0.00003
SRR6145059	Colwellia sp. MT41	58049	S	4	0	4	0.00000
SRR6145059	Colwellia sp. 20A7	2689569	S	8	0	8	0.00000
SRR6145059	Cohnella sp. MFER-1	2728023	S	4	0	4	0.00000
SRR6145059	Cohaesibacter sp. ES.047	1798205	S	18	0	18	0.00000
SRR6145059	Cobetia sp. L2A1	2686360	S	17	0	17	0.00000
SRR6145059	Clostridium sp. SY8519	1042156	S	5	0	5	0.00000
SRR6145059	Clostridium sp. JN500901	2068654	S	10	0	10	0.00000
SRR6145059	Clostridium sp. JN-9	2507159	S	4	0	4	0.00000
SRR6145059	Clostridium sp. JN-1	2483110	S	9	0	9	0.00000
SRR6145059	Clostridium sp. DL-VIII	641107	S	14	0	14	0.00000
SRR6145059	Clostridium sp. CT4	2320868	S	13	0	13	0.00000
SRR6145059	Clostridium sp. BNL1100	755731	S	9	0	9	0.00000
SRR6145059	Clostridium sp. AWRP	2212991	S	5	0	5	0.00000
SRR6145059	Citrus endogenous pararetrovirus	1435008	S	2	0	2	0.00000
SRR6145059	Citrobacter freundii complex sp. CFNIH9	2077149	S	8	32	40	0.00000
SRR6145059	Citrobacter freundii complex sp. CFNIH3	2077147	S	1	2	3	0.00000
SRR6145059	Citrobacter freundii complex sp. CFNIH2	2066049	S	9	8	17	0.00000
SRR6145059	Chryseobacterium sp. IHB B 17019	1721091	S	150	3	153	0.00002
SRR6145059	Chryseobacterium sp. H3001	2487073	S	86	0	86	0.00001
SRR6145059	Chromatiaceae bacterium No.7	2699430	S	10	0	10	0.00000
SRR6145059	Chromatiaceae bacterium 2141T.STBD.0c.01a	1978339	S	25	0	25	0.00000
SRR6145059	Christensenella sp. Marseille-P3954	2086585	S	5	0	5	0.00000
SRR6145059	Choristoneura fumiferana granulovirus	56947	S	3	0	3	0.00000
SRR6145059	Chondrocystis sp. NIES-4102	2005460	S	6	0	6	0.00000
SRR6145059	Chloroflexus aurantiacus	1108	S	12	-12	0	0.00000
SRR6145059	Chlamydia sp. S15-834C	1967783	S	1	0	1	0.00000
SRR6145059	Chlamydia sp. 2742-308	1806891	S	2	0	2	0.00000
SRR6145059	Chitinophaga sp. XS-30	2604421	S	21	0	21	0.00000
SRR6145059	Chitinimonas sp. R3-44	2594795	S	31	0	31	0.00000
SRR6145059	Centovirus	1911443	S	1	0	1	0.00000
SRR6145059	Cellvibrio sp. PSBB006	1987723	S	23	0	23	0.00000
SRR6145059	Cellulophaga virus ST	1918720	S	1	0	1	0.00000
SRR6145059	Cellulophaga sp. L1A9	2686362	S	2	0	2	0.00000
SRR6145059	Cedecea sp. FDAARGOS_727	2545798	S	10	0	10	0.00000
SRR6145059	Caviid betaherpesvirus 2	33706	S	1	0	1	0.00000
SRR6145059	Caulobacteraceae bacterium OTSz_A_272	1759059	S	28	0	28	0.00000
SRR6145059	Caulobacteraceae bacterium 0127_4	2686094	S	51	0	51	0.00001
SRR6145059	Caulobacter virus Sansa	2734274	S	1	0	1	0.00000
SRR6145059	Caulobacter virus Rogue	1211643	S	3	0	3	0.00000
SRR6145059	Caulobacter virus Lullwater	2733932	S	1	0	1	0.00000
SRR6145059	Caulobacter virus CcrPW	2734195	S	3	0	3	0.00000
SRR6145059	Caulobacter virus CcrColossus	2734194	S	3	0	3	0.00000
SRR6145059	Caulobacter virus CcrBL9	2734192	S	1	0	1	0.00000
SRR6145059	Caulobacter virus CcrBL10	2734196	S	1	0	1	0.00000
SRR6145059	Catenovulum sp. CCB-QB4	2172099	S	8	0	8	0.00000
SRR6145059	Carnobacterium sp. CP1	1564681	S	10	0	10	0.00000
SRR6145059	Cardinium endosymbiont of Sogatella furcifera	650378	S	3	0	3	0.00000
SRR6145059	Cardinium endosymbiont of Encarsia pergandiella	249402	S	1	0	1	0.00000
SRR6145059	Caproiciproducens sp. NJN-50	2507162	S	11	0	11	0.00000
SRR6145059	Capnocytophaga sp. oral taxon 878	1316596	S	31	2	33	0.00000
SRR6145059	Capnocytophaga sp. oral taxon 864	1316593	S	32	21	53	0.00001
SRR6145059	Capnocytophaga sp. oral taxon 323	1705617	S	42	32	74	0.00001
SRR6145059	Candidatus Walczuchella monophlebidarum	1415657	S	2	0	2	0.00000
SRR6145059	Candidatus Vesicomyosocius okutanii	412965	S	1	0	1	0.00000
SRR6145059	Candidatus Uzinura diaspidicola	670956	S	1	0	1	0.00000
SRR6145059	Candidatus Thioglobus singularis	1427364	S	3	0	3	0.00000
SRR6145059	Candidatus Thioglobus autotrophicus	1705394	S	2	0	2	0.00000
SRR6145059	Candidatus Thiodictyon syntrophicum	1166950	S	48	0	48	0.00001
SRR6145059	Candidatus Tachikawaea gelatinosa	1410383	S	1	0	1	0.00000
SRR6145059	Candidatus Syntrophocurvum alkaliphilum	2293317	S	1	0	1	0.00000
SRR6145059	Candidatus Symbiobacter mobilis	1436290	S	16	0	16	0.00000
SRR6145059	Candidatus Sulcia muelleri	336810	S	8	0	8	0.00000
SRR6145059	Candidatus Solibacter usitatus	332163	S	52	0	52	0.00001
SRR6145059	Candidatus Sneabacter namystus	2601646	S	6	0	6	0.00000
SRR6145059	Candidatus Ruthia endofausta	2738852	S	4	0	4	0.00000
SRR6145059	Candidatus Riesia pediculicola	401619	S	1	0	1	0.00000
SRR6145059	Candidatus Rhodoluna planktonica	535712	S	8	0	8	0.00000
SRR6145059	Candidatus Reidiella endopervernicosa	2738883	S	10	0	10	0.00000
SRR6145059	Candidatus Purcelliella pentastirinorum	472834	S	2	0	2	0.00000
SRR6145059	Candidatus Puniceispirillum marinum	767892	S	4	0	4	0.00000
SRR6145059	Candidatus Pseudomonas adelgestsugas	1302376	S	3	0	3	0.00000
SRR6145059	Candidatus Protochlamydia naegleriophila	389348	S	4	0	4	0.00000
SRR6145059	Candidatus Protochlamydia amoebophila	362787	S	5	0	5	0.00000
SRR6145059	Candidatus Promineofilum breve	1806508	S	57	0	57	0.00001
SRR6145059	Candidatus Prometheoarchaeum syntrophicum	2594042	S	5	0	5	0.00000
SRR6145059	Candidatus Profftella armatura	669502	S	2	0	2	0.00000
SRR6145059	Candidatus Portiera aleyrodidarum	91844	S	4	0	4	0.00000
SRR6145059	Candidatus Planktophila versatilis	1884905	S	9	0	9	0.00000
SRR6145059	Candidatus Planktophila vernalis	1884907	S	2	0	2	0.00000
SRR6145059	Candidatus Planktophila sulfonica	1884904	S	2	0	2	0.00000
SRR6145059	Candidatus Planktophila limnetica	573600	S	10	0	10	0.00000
SRR6145059	Candidatus Planktophila lacus	1884913	S	7	0	7	0.00000
SRR6145059	Candidatus Planktophila dulcis	1884914	S	13	0	13	0.00000
SRR6145059	Candidatus Phytoplasma ziziphi	135727	S	1	0	1	0.00000
SRR6145059	Candidatus Phytoplasma australiense	59748	S	3	0	3	0.00000
SRR6145059	Candidatus Phycorickettsia trachydisci	2115978	S	2	0	2	0.00000
SRR6145059	Candidatus Phaeomarinobacter ectocarpi	1458461	S	22	0	22	0.00000
SRR6145059	Candidatus Pelagibacter ubique	198252	S	1	0	1	0.00000
SRR6145059	Candidatus Paracaedibacter acanthamoebae	91604	S	4	0	4	0.00000
SRR6145059	Candidatus Pantoea carbekii	1235990	S	7	0	7	0.00000
SRR6145059	Candidatus Nucleicultrix amoebiphila	1509244	S	5	0	5	0.00000
SRR6145059	Candidatus Nitrospira inopinata	1715989	S	20	0	20	0.00000
SRR6145059	Candidatus Nitrosotalea okcheonensis	1903276	S	1	0	1	0.00000
SRR6145059	Candidatus Nitrosotalea devanaterra	1078905	S	1	0	1	0.00000
SRR6145059	Candidatus Nitrososphaera gargensis	497727	S	2	0	2	0.00000
SRR6145059	Candidatus Nitrososphaera evergladensis	1459637	S	3	0	3	0.00000
SRR6145059	Candidatus Nitrosopumilus sediminis	1229909	S	1	0	1	0.00000
SRR6145059	Candidatus Nitrosopumilus koreensis	1510466	S	1	0	1	0.00000
SRR6145059	Candidatus Nitrosopelagicus brevis	1410606	S	2	0	2	0.00000
SRR6145059	Candidatus Nitrosomarinus catalina	1898749	S	3	0	3	0.00000
SRR6145059	Candidatus Nitrosoglobus terrae	1630141	S	6	0	6	0.00000
SRR6145059	Candidatus Nitrosocosmicus franklandus	1798806	S	2	0	2	0.00000
SRR6145059	Candidatus Nitrosocosmicus exaquare	1826872	S	3	0	3	0.00000
SRR6145059	Candidatus Nesciobacter abundans	2601668	S	3	0	3	0.00000
SRR6145059	Candidatus Nardonella dryophthoridicola	1971485	S	2	0	2	0.00000
SRR6145059	Candidatus Nanopelagicus limnes	1884634	S	1	0	1	0.00000
SRR6145059	Candidatus Nanopelagicus hibericus	1884915	S	8	0	8	0.00000
SRR6145059	Candidatus Nanopelagicus abundans	1884916	S	1	0	1	0.00000
SRR6145059	Candidatus Mikella endobia	1778264	S	1	0	1	0.00000
SRR6145059	Candidatus Midichloria mitochondrii	234827	S	1	0	1	0.00000
SRR6145059	Candidatus Methylospira mobilis	1808979	S	19	0	19	0.00000
SRR6145059	Candidatus Methylopumilus universalis	2588536	S	5	0	5	0.00000
SRR6145059	Candidatus Methylopumilus rimovensis	2588535	S	2	0	2	0.00000
SRR6145059	Candidatus Methylopumilus planktonicus	1581557	S	2	0	2	0.00000
SRR6145059	Candidatus Methanoplasma termitum	1577791	S	3	0	3	0.00000
SRR6145059	Candidatus Methanomethylophilus alvus	1291540	S	1	0	1	0.00000
SRR6145059	Candidatus Methanomassiliicoccus intestinalis	1406512	S	2	0	2	0.00000
SRR6145059	Candidatus Mancarchaeum acidiphilum	1920749	S	4	0	4	0.00000
SRR6145059	Candidatus Liberibacter solanacearum	556287	S	1	0	1	0.00000
SRR6145059	Candidatus Liberibacter americanus	309868	S	1	0	1	0.00000
SRR6145059	Candidatus Liberibacter africanus	34020	S	2	0	2	0.00000
SRR6145059	Candidatus Kuenenia stuttgartiensis	174633	S	5	0	5	0.00000
SRR6145059	Candidatus Koribacter versatilis	658062	S	19	0	19	0.00000
SRR6145059	Candidatus Korarchaeum cryptofilum	498846	S	2	0	2	0.00000
SRR6145059	Candidatus Kinetoplastibacterium sorsogonicusi	1576550	S	7	0	7	0.00000
SRR6145059	Candidatus Kinetoplastibacterium oncopeltii	994696	S	1	0	1	0.00000
SRR6145059	Candidatus Kinetoplastibacterium galatii	994695	S	3	0	3	0.00000
SRR6145059	Candidatus Kinetoplastibacterium desouzaii	994692	S	1	0	1	0.00000
SRR6145059	Candidatus Ishikawaella capsulata	168169	S	2	0	2	0.00000
SRR6145059	Candidatus Hodgkinia cicadicola	573658	S	2	0	2	0.00000
SRR6145059	Candidatus Hoaglandella endobia	1778263	S	2	0	2	0.00000
SRR6145059	Candidatus Hamiltonella defensa	138072	S	5	0	5	0.00000
SRR6145059	Candidatus Fukatsuia symbiotica	1878942	S	3	0	3	0.00000
SRR6145059	Candidatus Fonsibacter ubiquis	1925548	S	6	0	6	0.00000
SRR6145059	Candidatus Fokinia solitaria	1802984	S	2	0	2	0.00000
SRR6145059	Candidatus Filomicrobium marinum	1608628	S	20	0	20	0.00000
SRR6145059	Candidatus Erwinia haradaeae	1922217	S	13	0	13	0.00000
SRR6145059	Candidatus Enterovibrio luxaltus	1927128	S	1	0	1	0.00000
SRR6145059	Candidatus Endomicrobium trichonymphae	1408204	S	1	0	1	0.00000
SRR6145059	Candidatus Endolissoclinum faulkneri	1263979	S	7	0	7	0.00000
SRR6145059	Candidatus Doolittlea endobia	1778262	S	1	0	1	0.00000
SRR6145059	Candidatus Desulfovibrio trichonymphae	1725232	S	5	0	5	0.00000
SRR6145059	Candidatus Desulforudis audaxviator	471827	S	13	0	13	0.00000
SRR6145059	Candidatus Desulfofervidus auxilii	1621989	S	1	0	1	0.00000
SRR6145059	Candidatus Deianiraea vastatrix	2163644	S	1	0	1	0.00000
SRR6145059	Candidatus Cytomitobacter primus	2066024	S	1	0	1	0.00000
SRR6145059	Candidatus Cytomitobacter indipagum	2601575	S	7	0	7	0.00000
SRR6145059	Candidatus Cyclonatronum proteinivorum	1457365	S	9	0	9	0.00000
SRR6145059	Candidatus Cloacimonas acidaminovorans	456827	S	1	0	1	0.00000
SRR6145059	Candidatus Carsonella ruddii	114186	S	2	0	2	0.00000
SRR6145059	Candidatus Borrelia tachyglossi	1964448	S	2	0	2	0.00000
SRR6145059	Candidatus Blochmannia vafer	251535	S	3	0	3	0.00000
SRR6145059	Candidatus Bipolaricaulis anaerobius	2026885	S	14	0	14	0.00000
SRR6145059	Candidatus Baumannia cicadellinicola	186490	S	4	0	4	0.00000
SRR6145059	Candidatus Babela massiliensis	673862	S	6	0	6	0.00000
SRR6145059	Candidatus Azobacteroides pseudotrichonymphae	511435	S	10	0	10	0.00000
SRR6145059	Candidatus Atelocyanobacterium thalassa	713887	S	4	0	4	0.00000
SRR6145059	Candidatus Arsenophonus lipoptenae	634113	S	4	0	4	0.00000
SRR6145059	Candidatus Amoebophilus asiaticus	281120	S	3	0	3	0.00000
SRR6145059	Candidatus Accumulibacter phosphatis	327160	S	62	0	62	0.00001
SRR6145059	Campylobacter sp. RM6914	1032243	S	3	0	3	0.00000
SRR6145059	Campylobacter sp. RM6137	1660073	S	2	0	2	0.00000
SRR6145059	Campylobacter sp. RM16704	1500960	S	1	0	1	0.00000
SRR6145059	Campylobacter sp. RM16192	1660080	S	4	0	4	0.00000
SRR6145059	Campylobacter fetus	196	S	3	-3	0	0.00000
SRR6145059	Calothrix sp. NIES-3974	2005462	S	10	0	10	0.00000
SRR6145059	Caloramator sp. E03	2576307	S	5	0	5	0.00000
SRR6145059	Cafeteria roenbergensis virus	1513235	S	1	0	1	0.00000
SRR6145059	Buttiauxella sp. 3AFRM03	2479367	S	12	0	12	0.00000
SRR6145059	Burkholderiales bacterium YL45	1834205	S	4	0	4	0.00000
SRR6145059	Burkholderiales bacterium GJ-E10	1469502	S	38	0	38	0.00000
SRR6145059	Burkholderia virus Bcepmigl	1195073	S	1	0	1	0.00000
SRR6145059	Burkholderia virus BcepNazgul	2560360	S	1	0	1	0.00000
SRR6145059	Burkholderia virus AH2	2560359	S	1	0	1	0.00000
SRR6145059	Burkholderia phage KS9	335797	S	1	0	1	0.00000
SRR6145059	Brochothrix virus A9	2560358	S	1	0	1	0.00000
SRR6145059	Brochothrix phage NF5	764561	S	1	0	1	0.00000
SRR6145059	Brochothrix phage BL3	764562	S	1	0	1	0.00000
SRR6145059	Boseongicola sp. CCM32	2552942	S	49	0	49	0.00001
SRR6145059	Borreliella valaisiana	62088	S	1	-1	0	0.00000
SRR6145059	Bordetella virus PHB04	2734129	S	3	0	3	0.00000
SRR6145059	Bordetella sp. HZ20	2163011	S	11	0	11	0.00000
SRR6145059	Bokeloh bat lyssavirus	1072176	S	1	0	1	0.00000
SRR6145059	Blueberry scorch virus	31722	S	1	0	1	0.00000
SRR6145059	Blochmannia endosymbiont of Camponotus nipponensis	2681986	S	2	0	2	0.00000
SRR6145059	Bifidobacterium asteroides	1684	S	17	-17	0	0.00000
SRR6145059	Betaproteobacteria bacterium GR16-43	1904640	S	74	0	74	0.00001
SRR6145059	Bathymodiolus thermophilus thioautotrophic gill symbiont	2360	S	2	0	2	0.00000
SRR6145059	Bathymodiolus septemdierum thioautotrophic gill symbiont	113267	S	5	0	5	0.00000
SRR6145059	Bathycoccus sp. RCC1105 virus BpV	933845	S	3	0	3	0.00000
SRR6145059	Bacteroides sp. CBA7301	2715212	S	11	0	11	0.00000
SRR6145059	Bacteroides phage B40-8	99179	S	1	0	1	0.00000
SRR6145059	Bacteroidales bacterium CF	1400053	S	3	0	3	0.00000
SRR6145059	Bacteroidales bacterium 38-H	2590900	S	11	0	11	0.00000
SRR6145059	Bacillus virus Shbh1	2560337	S	1	0	1	0.00000
SRR6145059	Bacillus virus Moonbeam	2560334	S	1	0	1	0.00000
SRR6145059	Bacillus virus G	1084719	S	1	0	1	0.00000
SRR6145059	Bacillus virus Bigbertha	1918006	S	1	0	1	0.00000
SRR6145059	Bacillus virus BM15	1985178	S	1	0	1	0.00000
SRR6145059	Bacillus sp. ms-22	2683680	S	1	0	1	0.00000
SRR6145059	Bacillus sp. Y1	352858	S	11	0	11	0.00000
SRR6145059	Bacillus sp. X1(2014)	1565991	S	8	0	8	0.00000
SRR6145059	Bacillus sp. WP8	756828	S	2	0	2	0.00000
SRR6145059	Bacillus sp. THAF10	2587848	S	6	0	6	0.00000
SRR6145059	Bacillus sp. SPB7	2715209	S	3	0	3	0.00000
SRR6145059	Bacillus sp. SB49	1071080	S	6	0	6	0.00000
SRR6145059	Bacillus sp. S3	486398	S	10	0	10	0.00000
SRR6145059	Bacillus sp. OxB-1	98228	S	7	0	7	0.00000
SRR6145059	Bacillus sp. NSP9.1	1071078	S	5	0	5	0.00000
SRR6145059	Bacillus sp. KH172YL63	2709784	S	9	0	9	0.00000
SRR6145059	Bacillus sp. FJAT-45348	2011012	S	8	0	8	0.00000
SRR6145059	Bacillus sp. FJAT-42376	2014076	S	9	0	9	0.00000
SRR6145059	Bacillus sp. FJAT-25496	1742359	S	10	0	10	0.00000
SRR6145059	Bacillus sp. FJAT-22090	1581038	S	8	0	8	0.00000
SRR6145059	Bacillus sp. FJAT-18017	1705566	S	7	0	7	0.00000
SRR6145059	Bacillus sp. DSL-17	2567941	S	8	0	8	0.00000
SRR6145059	Bacillus sp. 1NLA3E	666686	S	4	0	4	0.00000
SRR6145059	Bacillus phage Wes44	2283012	S	1	0	1	0.00000
SRR6145059	Bacillaceae bacterium TKL69	2594883	S	7	0	7	0.00000
SRR6145059	Azotobacter vinelandii	354	S	68	-68	0	0.00000
SRR6145059	Azoarcus sp. M9-3-2	2016596	S	67	0	67	0.00001
SRR6145059	Azoarcus sp. KH32C	748247	S	58	0	58	0.00001
SRR6145059	Aureococcus anophagefferens virus	1474867	S	1	0	1	0.00000
SRR6145059	Aureitalea sp. RR4-38	2094025	S	3	0	3	0.00000
SRR6145059	Aurantimonas phage AmM-1	1503929	S	1	0	1	0.00000
SRR6145059	Aurantimicrobium sp. MWH-Mo1	1987356	S	21	0	21	0.00000
SRR6145059	Ateline alphaherpesvirus 1	35243	S	3	0	3	0.00000
SRR6145059	Astarnavirus	2560308	S	1	0	1	0.00000
SRR6145059	Artogeia rapae granulovirus	362830	S	1	0	1	0.00000
SRR6145059	Arthrobacter virus Trina	1984784	S	1	0	1	0.00000
SRR6145059	Arthrobacter virus Tank	1982567	S	1	0	1	0.00000
SRR6145059	Arthrobacter virus Galaxy	2560303	S	1	0	1	0.00000
SRR6145059	Arthrobacter virus Colucci	2560302	S	3	0	3	0.00000
SRR6145059	Arthobacter virus Yang	2734291	S	1	0	1	0.00000
SRR6145059	Arthobacter virus Sonali	2734279	S	1	0	1	0.00000
SRR6145059	Arsenophonus endosymbiont of Aleurodicus dispersus	235559	S	2	0	2	0.00000
SRR6145059	Arsenicicoccus sp. oral taxon 190	1658671	S	472	31	503	0.00006
SRR6145059	Armatimonadetes bacterium Uphvl-Ar2	2004468	S	11	0	11	0.00000
SRR6145059	Armatimonadetes bacterium Uphvl-Ar1	2004467	S	3	0	3	0.00000
SRR6145059	Archaeoglobus fulgidus	2234	S	1	-1	0	0.00000
SRR6145059	Arachidicoccus sp. KIS59-12	2341117	S	9	0	9	0.00000
SRR6145059	Arachidicoccus sp. BS20	1850526	S	21	0	21	0.00000
SRR6145059	Aquimarina sp. BL5	1714860	S	10	0	10	0.00000
SRR6145059	Aquimarina sp. AD10	1714849	S	10	0	10	0.00000
SRR6145059	Aquimarina sp. AD1	1714848	S	9	0	9	0.00000
SRR6145059	Aquiluna sp. 15G-AUS-rot	2499157	S	11	0	11	0.00000
SRR6145059	Aquaspirillum sp. LM1	1938604	S	46	0	46	0.00001
SRR6145059	Aquamicrobium virus P14	2560297	S	1	0	1	0.00000
SRR6145059	Apibacter sp. HY041	2500547	S	19	0	19	0.00000
SRR6145059	Aotine betaherpesvirus 1	50290	S	1	0	1	0.00000
SRR6145059	Anomala cuprea entomopoxvirus	62099	S	1	0	1	0.00000
SRR6145059	Aneurinibacillus sp. XH2	1450761	S	3	0	3	0.00000
SRR6145059	Anaerolineaceae bacterium oral taxon 439	1889813	S	23	0	23	0.00000
SRR6145059	Anaerocolumna sp. CBA3638	2696063	S	9	0	9	0.00000
SRR6145059	Amycolatopsis mediterranei	33910	S	239	-239	0	0.00000
SRR6145059	Aminipila sp. CBA3637	2697030	S	3	0	3	0.00000
SRR6145059	Alteromonas sp. RKMC-009	2267264	S	8	0	8	0.00000
SRR6145059	Alteromonas sp. I4	2652380	S	11	0	11	0.00000
SRR6145059	Alteromonas sp. BL110	1714845	S	5	0	5	0.00000
SRR6145059	Alteromonas sp. 76-1	2358187	S	2	0	2	0.00000
SRR6145059	Altererythrobacter sp. ZODW24	2185142	S	66	0	66	0.00001
SRR6145059	Alloprevotella sp. E39	2133944	S	15	0	15	0.00000
SRR6145059	Alistipes sp. dk3624	2662363	S	13	0	13	0.00000
SRR6145059	Algibacter sp. L3A6	2686366	S	5	0	5	0.00000
SRR6145059	Algibacter sp. L1A34	2686365	S	8	0	8	0.00000
SRR6145059	Alcaligenaceae bacterium SJ-26	2593958	S	45	0	45	0.00001
SRR6145059	Agrobacterium virus Atuph07	2560286	S	1	0	1	0.00000
SRR6145059	Aeromonas virus AhSzq1	2733998	S	1	0	1	0.00000
SRR6145059	Aeromonas virus Aes12	1921530	S	1	0	1	0.00000
SRR6145059	Aeromonas phage PX29	926067	S	1	0	1	0.00000
SRR6145059	Aequorivita sp. H23M31	2494375	S	4	0	4	0.00000
SRR6145059	Adoxophyes orana nucleopolyhedrovirus	542343	S	1	0	1	0.00000
SRR6145059	Actinomyces sp. oral taxon 897	2081702	S	499	16	515	0.00006
SRR6145059	Actinomyces sp. oral taxon 848	649739	S	224	0	224	0.00003
SRR6145059	Actinomyces sp. oral taxon 414	712122	S	1607	85	1692	0.00020
SRR6145059	Actinomyces sp. oral taxon 171	706438	S	2208	290	2498	0.00030
SRR6145059	Actinobaculum sp. 313	2495645	S	20	0	20	0.00000
SRR6145059	Actinobacteria bacterium IMCC26256	1650658	S	1	0	1	0.00000
SRR6145059	Actinobacteria bacterium IMCC26103	1848756	S	4	0	4	0.00000
SRR6145059	Actinobacteria bacterium IMCC26077	1848755	S	7	0	7	0.00000
SRR6145059	Acinetobacter virus Petty	2733321	S	1	0	1	0.00000
SRR6145059	Acinetobacter virus ME3	2560269	S	23	0	23	0.00000
SRR6145059	Acinetobacter virus AP22	1915209	S	1	0	1	0.00000
SRR6145059	Acinetobacter virus AB1	1915208	S	1	0	1	0.00000
SRR6145059	Acinetobacter virus 133	279006	S	1	0	1	0.00000
SRR6145059	Acinetobacter sp. Marseille-Q1620	2714110	S	52	0	52	0.00001
SRR6145059	Acinetobacter phage vB_AbaM_Acibel004	1481186	S	1	0	1	0.00000
SRR6145059	Acinetobacter phage YMC13/03/R2096	1560342	S	1	0	1	0.00000
SRR6145059	Acinetobacter phage Presley	1406780	S	1	0	1	0.00000
SRR6145059	Acinetobacter phage Acj61	760732	S	1	0	1	0.00000
SRR6145059	Acidilobus sp. 7A	1577685	S	4	0	4	0.00000
SRR6145059	Acidiferrobacter sp. SPIII_3	1281578	S	20	0	20	0.00000
SRR6145059	Achromobacter virus 83-24	1982228	S	1	0	1	0.00000
SRR6145059	Achromobacter phage phiAxp-1	1610509	S	1	0	1	0.00000
SRR6145059	Acetobacterium sp. KB-1	2184575	S	2	0	2	0.00000
SRR6145059	Gordonia virus Vendetta	2049886	S	1	-1	0	0.00000
SRR6145059	Bacillus virus BCP78	1985182	S	1	-1	0	0.00000
SRR6145059	Candidatus Moranella endobia	1048758	S	2	-2	0	0.00000
SRR6145059	Candidatus Kinetoplastibacterium crithidii	33056	S	4	-4	0	0.00000
SRR6145059	Candidatus Kinetoplastibacterium blastocrithidii	233181	S	4	-4	0	0.00000
