sample	name	taxonomy_id	taxonomy_lvl	kraken_assigned_reads	added_reads	new_est_reads	fraction_total_reads
SRR9696284	Candidatus Nanopelagicales	2039638	O	1	0	1	0.00000
SRR9696284	Primates	9443	O	9859824	3340	9863164	0.99515
SRR9696284	Enterobacterales	91347	O	169	15175	15344	0.00155
SRR9696284	Propionibacteriales	85009	O	10693	154	10847	0.00109
SRR9696284	Corynebacteriales	85007	O	10599	104	10703	0.00108
SRR9696284	Bacillales	1385	O	3929	322	4251	0.00043
SRR9696284	Micrococcales	85006	O	2613	90	2703	0.00027
SRR9696284	Lactobacillales	186826	O	683	14	697	0.00007
SRR9696284	Tissierellales	1737405	O	414	69	483	0.00005
SRR9696284	Caudovirales	28883	O	533	9	542	0.00005
SRR9696284	Pseudomonadales	72274	O	367	16	383	0.00004
SRR9696284	Rhizobiales	356	O	165	5	170	0.00002
SRR9696284	Clostridiales	186802	O	146	7	153	0.00002
SRR9696284	Burkholderiales	80840	O	200	17	217	0.00002
SRR9696284	Xanthomonadales	135614	O	93	4	97	0.00001
SRR9696284	Streptomycetales	85011	O	141	1	142	0.00001
SRR9696284	Sphingomonadales	204457	O	63	2	65	0.00001
SRR9696284	Rhodospirillales	204441	O	101	6	107	0.00001
SRR9696284	Rhodobacterales	204455	O	129	-1	128	0.00001
SRR9696284	Pseudonocardiales	85010	O	57	-2	55	0.00001
SRR9696284	Pasteurellales	135625	O	124	9	133	0.00001
SRR9696284	Flavobacteriales	200644	O	67	0	67	0.00001
SRR9696284	Bacteroidales	171549	O	68	-1	67	0.00001
SRR9696284	Actinomycetales	2037	O	84	1	85	0.00001
SRR9696284	Vibrionales	135623	O	12	0	12	0.00000
SRR9696284	Verrucomicrobiales	48461	O	3	0	3	0.00000
SRR9696284	Veillonellales	1843489	O	18	0	18	0.00000
SRR9696284	Tubulavirales	2732094	O	1	0	1	0.00000
SRR9696284	Thiotrichales	72273	O	4	-3	1	0.00000
SRR9696284	Thermotogales	2419	O	2	0	2	0.00000
SRR9696284	Thermomicrobiales	189776	O	1	0	1	0.00000
SRR9696284	Thermococcales	2258	O	1	0	1	0.00000
SRR9696284	Thermoanaerobacterales	68295	O	5	-2	3	0.00000
SRR9696284	Thermales	68933	O	6	0	6	0.00000
SRR9696284	Syntrophobacterales	213462	O	1	0	1	0.00000
SRR9696284	Synergistales	649776	O	2	1	3	0.00000
SRR9696284	Synechococcales	1890424	O	4	-1	3	0.00000
SRR9696284	Sulfolobales	2281	O	4	0	4	0.00000
SRR9696284	Streptosporangiales	85012	O	17	0	17	0.00000
SRR9696284	Spirochaetales	136	O	5	0	5	0.00000
SRR9696284	Sphingobacteriales	200666	O	8	0	8	0.00000
SRR9696284	Sphaerobacterales	85001	O	2	0	2	0.00000
SRR9696284	Solirubrobacterales	588673	O	2	0	2	0.00000
SRR9696284	Silvanigrellales	2024973	O	1	0	1	0.00000
SRR9696284	Selenomonadales	909929	O	5	0	5	0.00000
SRR9696284	Sedimentisphaerales	2483366	O	2	1	3	0.00000
SRR9696284	Saprospirales	1936988	O	1	0	1	0.00000
SRR9696284	Rubrobacterales	84996	O	3	0	3	0.00000
SRR9696284	Rickettsiales	766	O	3	0	3	0.00000
SRR9696284	Rhodocyclales	206389	O	4	3	7	0.00000
SRR9696284	Puniceicoccales	415001	O	1	0	1	0.00000
SRR9696284	Planctomycetales	112	O	1	7	8	0.00000
SRR9696284	Pirellulales	2691354	O	2	0	2	0.00000
SRR9696284	Petrotogales	1643947	O	2	-1	1	0.00000
SRR9696284	Pelagibacterales	54526	O	1	0	1	0.00000
SRR9696284	Parachlamydiales	1963360	O	1	0	1	0.00000
SRR9696284	Oscillatoriales	1150	O	6	-1	5	0.00000
SRR9696284	Opitutales	415000	O	2	0	2	0.00000
SRR9696284	Oceanospirillales	135619	O	22	0	22	0.00000
SRR9696284	Nostocales	1161	O	14	-1	13	0.00000
SRR9696284	Nitrospirales	189778	O	2	-2	0	0.00000
SRR9696284	Nitrosomonadales	32003	O	8	0	8	0.00000
SRR9696284	Neisseriales	206351	O	28	2	30	0.00000
SRR9696284	Natrialbales	1644060	O	8	0	8	0.00000
SRR9696284	Natranaerobiales	485256	O	1	0	1	0.00000
SRR9696284	Nakamurellales	1643684	O	4	0	4	0.00000
SRR9696284	Myxococcales	29	O	22	0	22	0.00000
SRR9696284	Mycoplasmatales	2085	O	9	0	9	0.00000
SRR9696284	Mononegavirales	11157	O	1	0	1	0.00000
SRR9696284	Micromonosporales	85008	O	42	0	42	0.00000
SRR9696284	Methylococcales	135618	O	5	0	5	0.00000
SRR9696284	Methanosarcinales	94695	O	2	0	2	0.00000
SRR9696284	Methanococcales	2182	O	2	0	2	0.00000
SRR9696284	Methanocellales	570264	O	1	0	1	0.00000
SRR9696284	Methanobacteriales	2158	O	1	0	1	0.00000
SRR9696284	Martellivirales	2732544	O	1	0	1	0.00000
SRR9696284	Marinilabiliales	1970189	O	2	0	2	0.00000
SRR9696284	Leptospirales	1643688	O	1	5	6	0.00000
SRR9696284	Legionellales	118969	O	2	2	4	0.00000
SRR9696284	Kineosporiales	622452	O	2	1	3	0.00000
SRR9696284	Jiangellales	1217098	O	5	0	5	0.00000
SRR9696284	Isosphaerales	2691356	O	4	0	4	0.00000
SRR9696284	Holosporales	1921002	O	2	0	2	0.00000
SRR9696284	Haloferacales	1644055	O	6	0	6	0.00000
SRR9696284	Halobacteriales	2235	O	3	0	3	0.00000
SRR9696284	Halanaerobiales	53433	O	3	0	3	0.00000
SRR9696284	Glycomycetales	85014	O	3	2	5	0.00000
SRR9696284	Geodermatophilales	1643682	O	22	0	22	0.00000
SRR9696284	Gemmatimonadales	219686	O	3	0	3	0.00000
SRR9696284	Gemmatales	2691355	O	7	0	7	0.00000
SRR9696284	Fusobacteriales	203491	O	40	0	40	0.00000
SRR9696284	Frankiales	85013	O	9	0	9	0.00000
SRR9696284	Erysipelotrichales	526525	O	5	-1	4	0.00000
SRR9696284	Entomoplasmatales	186328	O	8	0	8	0.00000
SRR9696284	Emcibacterales	2066490	O	1	0	1	0.00000
SRR9696284	Eggerthellales	1643822	O	5	0	5	0.00000
SRR9696284	Desulfuromonadales	69541	O	4	0	4	0.00000
SRR9696284	Desulfovibrionales	213115	O	4	0	4	0.00000
SRR9696284	Desulfobacterales	213118	O	4	0	4	0.00000
SRR9696284	Deinococcales	118964	O	2	0	2	0.00000
SRR9696284	Cytophagales	768507	O	21	0	21	0.00000
SRR9696284	Chthonomonadales	1077263	O	1	0	1	0.00000
SRR9696284	Chromatiales	135613	O	10	0	10	0.00000
SRR9696284	Chloroflexales	32064	O	1	1	2	0.00000
SRR9696284	Chlorobiales	191411	O	3	0	3	0.00000
SRR9696284	Chlamydiales	51291	O	1	0	1	0.00000
SRR9696284	Chitinophagales	1853229	O	9	0	9	0.00000
SRR9696284	Cellvibrionales	1706369	O	5	0	5	0.00000
SRR9696284	Caulobacterales	204458	O	16	4	20	0.00000
SRR9696284	Cardiobacteriales	135615	O	3	0	3	0.00000
SRR9696284	Campylobacterales	213849	O	30	0	30	0.00000
SRR9696284	Bryobacterales	332160	O	1	0	1	0.00000
SRR9696284	Bradymonadales	1779134	O	1	-1	0	0.00000
SRR9696284	Brachyspirales	1643686	O	2	0	2	0.00000
SRR9696284	Bifidobacteriales	85004	O	12	0	12	0.00000
SRR9696284	Bdellovibrionales	213481	O	1	0	1	0.00000
SRR9696284	Ardenticatenales	1382929	O	2	0	2	0.00000
SRR9696284	Archaeoglobales	2231	O	1	0	1	0.00000
SRR9696284	Aquificales	32069	O	1	0	1	0.00000
SRR9696284	Alteromonadales	135622	O	20	0	20	0.00000
SRR9696284	Aeromonadales	135624	O	11	1	12	0.00000
SRR9696284	Acidithiobacillales	225057	O	1	0	1	0.00000
SRR9696284	Acidimicrobiales	84993	O	6	0	6	0.00000
SRR9696284	Acidaminococcales	1843488	O	1	0	1	0.00000
SRR9696284	Acholeplasmatales	186329	O	1	0	1	0.00000
