sample	name	taxonomy_id	taxonomy_lvl	kraken_assigned_reads	added_reads	new_est_reads	fraction_total_reads
SRR9696284	Candidatus Planktophila	622681	G	1	3	4	0.00000
SRR9696284	Candidatus Tachikawaea	1682492	G	2	0	2	0.00000
SRR9696284	Candidatus Promineofilum	1988031	G	2	0	2	0.00000
SRR9696284	Candidatus Kinetoplastibacterium	33055	G	2	0	2	0.00000
SRR9696284	Candidatus Hamiltonella	568987	G	1	1	2	0.00000
SRR9696284	Candidatus Aquiluna	529881	G	2	0	2	0.00000
SRR9696284	Candidatus Sulcia	336809	G	1	0	1	0.00000
SRR9696284	Candidatus Solibacter	332162	G	1	0	1	0.00000
SRR9696284	Candidatus Riesia	401618	G	1	0	1	0.00000
SRR9696284	Candidatus Nucleicultrix	1509243	G	1	0	1	0.00000
SRR9696284	Candidatus Nardonella	204619	G	1	0	1	0.00000
SRR9696284	Candidatus Ishikawaella	409304	G	1	0	1	0.00000
SRR9696284	Candidatus Fonsibacter	2045213	G	1	0	1	0.00000
SRR9696284	Candidatus Evansia	1495768	G	1	0	1	0.00000
SRR9696284	Candidatus Cytomitobacter	2601574	G	1	0	1	0.00000
SRR9696284	Homo	9605	G	9859824	3340	9863164	0.99515
SRR9696284	Klebsiella	570	G	13	15162	15175	0.00153
SRR9696284	Cutibacterium	1912216	G	10521	179	10700	0.00108
SRR9696284	Corynebacterium	1716	G	10223	141	10364	0.00105
SRR9696284	Staphylococcus	1279	G	3754	322	4076	0.00041
SRR9696284	Micrococcus	1269	G	2128	132	2260	0.00023
SRR9696284	Streptococcus	1301	G	535	18	553	0.00006
SRR9696284	Pahexavirus	1982251	G	376	0	376	0.00004
SRR9696284	Pseudomonas	286	G	275	13	288	0.00003
SRR9696284	Peptoniphilus	162289	G	216	21	237	0.00002
SRR9696284	Streptomyces	1883	G	137	1	138	0.00001
SRR9696284	Rothia	32207	G	68	0	68	0.00001
SRR9696284	Roseomonas	125216	G	78	7	85	0.00001
SRR9696284	Rhodococcus	1827	G	56	3	59	0.00001
SRR9696284	Prevotella	838	G	57	0	57	0.00001
SRR9696284	Paracoccus	265	G	79	6	85	0.00001
SRR9696284	Nonanavirus	1921122	G	146	2	148	0.00001
SRR9696284	Nocardioides	1839	G	51	1	52	0.00001
SRR9696284	Mycolicibacterium	1866885	G	59	3	62	0.00001
SRR9696284	Mycobacterium	1763	G	46	7	53	0.00001
SRR9696284	Microbacterium	33882	G	51	1	52	0.00001
SRR9696284	Lawsonella	1847725	G	63	2	65	0.00001
SRR9696284	Lactobacillus	1578	G	58	2	60	0.00001
SRR9696284	Haemophilus	724	G	101	8	109	0.00001
SRR9696284	Finegoldia	150022	G	72	18	90	0.00001
SRR9696284	Clostridium	1485	G	66	1	67	0.00001
SRR9696284	Bacillus	1386	G	94	9	103	0.00001
SRR9696284	Anaerococcus	165779	G	106	18	124	0.00001
SRR9696284	Acinetobacter	469	G	60	6	66	0.00001
SRR9696284	Zobellella	347533	G	1	0	1	0.00000
SRR9696284	Zhongshania	1434050	G	2	0	2	0.00000
SRR9696284	Youhaiella	1827478	G	2	0	2	0.00000
SRR9696284	Yokenella	158876	G	1	0	1	0.00000
SRR9696284	Yangia	354203	G	1	0	1	0.00000
SRR9696284	Xylanimonas	186188	G	2	0	2	0.00000
SRR9696284	Xenorhabdus	626	G	3	0	3	0.00000
SRR9696284	Xanthomonas	338	G	45	3	48	0.00000
SRR9696284	Xanthobacter	279	G	1	0	1	0.00000
SRR9696284	Wolbachia	953	G	1	0	1	0.00000
SRR9696284	Winogradskyella	286104	G	1	0	1	0.00000
SRR9696284	Weeksella	1013	G	1	0	1	0.00000
SRR9696284	Virgibacillus	84406	G	1	0	1	0.00000
SRR9696284	Vibrio	662	G	10	0	10	0.00000
SRR9696284	Verrucomicrobium	2735	G	2	0	2	0.00000
SRR9696284	Velarivirus	1513308	G	1	1	2	0.00000
SRR9696284	Veillonella	29465	G	16	0	16	0.00000
SRR9696284	Variovorax	34072	G	10	1	11	0.00000
SRR9696284	Vagococcus	2737	G	3	0	3	0.00000
SRR9696284	Urechidicola	2700084	G	1	0	1	0.00000
SRR9696284	Turicibacter	191303	G	1	0	1	0.00000
SRR9696284	Tsukamurella	2060	G	2	0	2	0.00000
SRR9696284	Trueperella	1069494	G	4	0	4	0.00000
SRR9696284	Trichodesmium	1205	G	1	0	1	0.00000
SRR9696284	Treponema	157	G	4	0	4	0.00000
SRR9696284	Tomitella	741759	G	1	0	1	0.00000
SRR9696284	Tolypothrix	111782	G	3	1	4	0.00000
SRR9696284	Timquatrovirus	1623306	G	1	-1	0	0.00000
SRR9696284	Thioclava	285107	G	2	0	2	0.00000
SRR9696284	Thioalkalivibrio	106633	G	1	0	1	0.00000
SRR9696284	Thermus	270	G	6	0	6	0.00000
SRR9696284	Thermovirga	336260	G	1	1	2	0.00000
SRR9696284	Thermomonospora	2019	G	1	0	1	0.00000
SRR9696284	Thermomonas	141948	G	2	0	2	0.00000
SRR9696284	Thermomicrobium	499	G	1	0	1	0.00000
SRR9696284	Thermocrinis	75905	G	1	0	1	0.00000
SRR9696284	Thermococcus	2263	G	1	0	1	0.00000
SRR9696284	Thermobispora	147067	G	1	0	1	0.00000
SRR9696284	Thermobacillus	76632	G	1	1	2	0.00000
SRR9696284	Thermoanaerobacterium	28895	G	2	0	2	0.00000
SRR9696284	Thermoanaerobacter	1754	G	1	-1	0	0.00000
SRR9696284	Thermanaerovibrio	81461	G	1	0	1	0.00000
SRR9696284	Thauera	33057	G	1	0	1	0.00000
SRR9696284	Thalassospira	168934	G	2	1	3	0.00000
SRR9696284	Tetrasphaera	99479	G	2	0	2	0.00000
SRR9696284	Tetragenococcus	51668	G	1	0	1	0.00000
SRR9696284	Tessaracoccus	72763	G	10	0	10	0.00000
SRR9696284	Tenacibaculum	104267	G	1	0	1	0.00000
SRR9696284	Tatumella	82986	G	1	0	1	0.00000
SRR9696284	Tabrizicola	1443919	G	1	0	1	0.00000
SRR9696284	Syntrophomonas	862	G	1	0	1	0.00000
SRR9696284	Synechococcus	1129	G	1	-1	0	0.00000
SRR9696284	Sulfurospirillum	57665	G	3	0	3	0.00000
SRR9696284	Sulfurivermis	2034504	G	1	0	1	0.00000
SRR9696284	Sulfuritalea	1054211	G	1	0	1	0.00000
SRR9696284	Sulfurisphaera	69655	G	2	0	2	0.00000
SRR9696284	Sulfuriferula	1778653	G	1	0	1	0.00000
SRR9696284	Sulfolobus	2284	G	1	-1	0	0.00000
SRR9696284	Sulfitobacter	60136	G	1	0	1	0.00000
SRR9696284	Suicoccus	2689587	G	1	0	1	0.00000
SRR9696284	Streptosporangium	2000	G	1	0	1	0.00000
SRR9696284	Streptomonospora	104204	G	1	0	1	0.00000
SRR9696284	Streptobacillus	34104	G	1	0	1	0.00000
SRR9696284	Streptacidiphilus	228398	G	1	0	1	0.00000
SRR9696284	Stenotrophomonas	40323	G	24	1	25	0.00000
SRR9696284	Stappia	152161	G	2	0	2	0.00000
SRR9696284	Stackebrandtia	283810	G	3	2	5	0.00000
SRR9696284	Sporosarcina	1569	G	2	0	2	0.00000
SRR9696284	Sporolactobacillus	2077	G	2	0	2	0.00000
SRR9696284	Spirosoma	107	G	2	0	2	0.00000
SRR9696284	Spiroplasma	2132	G	4	0	4	0.00000
SRR9696284	Spirochaeta	146	G	1	0	1	0.00000
SRR9696284	Sphingorhabdus	1434046	G	2	0	2	0.00000
SRR9696284	Sphingopyxis	165697	G	4	0	4	0.00000
SRR9696284	Sphingomonas	13687	G	22	2	24	0.00000
SRR9696284	Sphingobium	165695	G	8	1	9	0.00000
SRR9696284	Sphingobacterium	28453	G	2	2	4	0.00000
SRR9696284	Sphaerospermopsis	752201	G	1	0	1	0.00000
SRR9696284	Sphaerobacter	2056	G	2	0	2	0.00000
SRR9696284	Sorangium	39643	G	3	0	3	0.00000
SRR9696284	Sodalis	84565	G	1	0	1	0.00000
SRR9696284	Skunavirus	1623305	G	4	7	11	0.00000
SRR9696284	Sinorhizobium	28105	G	5	0	5	0.00000
SRR9696284	Simplicispira	352450	G	1	0	1	0.00000
SRR9696284	Silvanigrella	2024975	G	1	0	1	0.00000
SRR9696284	Shewanella	22	G	9	1	10	0.00000
SRR9696284	Serratia	613	G	5	0	5	0.00000
SRR9696284	Serinicoccus	265976	G	9	0	9	0.00000
SRR9696284	Seonamhaeicola	1649495	G	1	0	1	0.00000
SRR9696284	Selenomonas	970	G	3	0	3	0.00000
SRR9696284	Segniliparus	286801	G	1	0	1	0.00000
SRR9696284	Schaalia	2529408	G	22	0	22	0.00000
SRR9696284	Scardovia	196081	G	2	0	2	0.00000
SRR9696284	Sandaracinus	1055688	G	1	0	1	0.00000
SRR9696284	Salmonella	590	G	2	36	38	0.00000
SRR9696284	Salinispora	168694	G	2	0	2	0.00000
SRR9696284	Salinigranum	1644057	G	1	0	1	0.00000
SRR9696284	Salinibacterium	235888	G	2	0	2	0.00000
SRR9696284	Saccharothrix	2071	G	5	0	5	0.00000
SRR9696284	Saccharopolyspora	1835	G	4	0	4	0.00000
SRR9696284	Rufibacter	1379908	G	1	0	1	0.00000
SRR9696284	Ruegeria	97050	G	2	0	2	0.00000
SRR9696284	Rubrobacter	42255	G	2	0	2	0.00000
SRR9696284	Rubrivivax	28067	G	2	0	2	0.00000
SRR9696284	Ruania	626119	G	1	0	1	0.00000
SRR9696284	Roseovarius	74030	G	2	0	2	0.00000
SRR9696284	Roseivivax	93682	G	1	-1	0	0.00000
SRR9696284	Roseiflexus	120961	G	1	1	2	0.00000
SRR9696284	Romboutsia	1501226	G	2	0	2	0.00000
SRR9696284	Rhodovulum	34008	G	1	0	1	0.00000
SRR9696284	Rhodopseudomonas	1073	G	4	0	4	0.00000
SRR9696284	Rhodoluna	529883	G	2	0	2	0.00000
SRR9696284	Rhodobacter	1060	G	3	0	3	0.00000
SRR9696284	Rhodobaca	119541	G	2	0	2	0.00000
SRR9696284	Rhizorhabdus	1649486	G	1	0	1	0.00000
SRR9696284	Rhizobium	379	G	27	10	37	0.00000
SRR9696284	Rhizobacter	212743	G	2	0	2	0.00000
SRR9696284	Rheinheimera	67575	G	3	0	3	0.00000
SRR9696284	Renibacterium	1645	G	2	0	2	0.00000
SRR9696284	Rathayibacter	33886	G	17	0	17	0.00000
SRR9696284	Ramlibacter	174951	G	2	0	2	0.00000
SRR9696284	Ralstonia	48736	G	37	8	45	0.00000
SRR9696284	Raineyella	1911549	G	1	0	1	0.00000
SRR9696284	Rahnella	34037	G	1	0	1	0.00000
SRR9696284	Pusillimonas	305976	G	2	0	2	0.00000
SRR9696284	Pulveribacter	2678886	G	1	0	1	0.00000
SRR9696284	Psychroserpens	49277	G	1	0	1	0.00000
SRR9696284	Psychromicrobium	2078575	G	2	0	2	0.00000
SRR9696284	Psychroflexus	83612	G	2	0	2	0.00000
SRR9696284	Psychrobacter	497	G	1	0	1	0.00000
SRR9696284	Pseudoxanthomonas	83618	G	2	0	2	0.00000
SRR9696284	Pseudorhodoplanes	1734920	G	1	0	1	0.00000
SRR9696284	Pseudorhodobacter	238783	G	2	0	2	0.00000
SRR9696284	Pseudopropionibacterium	1912217	G	7	0	7	0.00000
SRR9696284	Pseudonocardia	1847	G	14	0	14	0.00000
SRR9696284	Pseudolabrys	556257	G	1	0	1	0.00000
SRR9696284	Pseudoalteromonas	53246	G	2	0	2	0.00000
SRR9696284	Pseudarthrobacter	1742993	G	8	0	8	0.00000
SRR9696284	Pseudanabaena	1152	G	1	0	1	0.00000
SRR9696284	Pseudactinotalea	1926259	G	2	0	2	0.00000
SRR9696284	Providencia	586	G	2	0	2	0.00000
SRR9696284	Proteus	583	G	2	0	2	0.00000
SRR9696284	Protaetiibacter	2680004	G	1	0	1	0.00000
SRR9696284	Propionimicrobium	203133	G	6	0	6	0.00000
SRR9696284	Propioniciclava	1085622	G	2	0	2	0.00000
SRR9696284	Propionibacterium	1743	G	4	0	4	0.00000
SRR9696284	Prauserella	142577	G	6	0	6	0.00000
SRR9696284	Porphyromonas	836	G	1	0	1	0.00000
SRR9696284	Pontibacter	323449	G	3	0	3	0.00000
SRR9696284	Polynucleobacter	44013	G	2	0	2	0.00000
SRR9696284	Polaromonas	52972	G	2	0	2	0.00000
SRR9696284	Polaribacter	52959	G	5	0	5	0.00000
SRR9696284	Pluralibacter	1330546	G	1	0	1	0.00000
SRR9696284	Plantibacter	190323	G	1	0	1	0.00000
SRR9696284	Plantactinospora	673534	G	5	0	5	0.00000
SRR9696284	Planococcus	1372	G	2	0	2	0.00000
SRR9696284	Planctomyces	118	G	1	7	8	0.00000
SRR9696284	Pirellula	123	G	1	0	1	0.00000
SRR9696284	Pigmentiphaga	152267	G	1	0	1	0.00000
SRR9696284	Phytohabitans	907364	G	3	0	3	0.00000
SRR9696284	Phyllobacterium	28100	G	2	0	2	0.00000
SRR9696284	Phycicoccus	367298	G	9	0	9	0.00000
SRR9696284	Phreatobacter	1632780	G	4	0	4	0.00000
SRR9696284	Photorhabdus	29487	G	1	0	1	0.00000
SRR9696284	Photobacterium	657	G	2	0	2	0.00000
SRR9696284	Phietavirus	1623298	G	1	2	3	0.00000
SRR9696284	Phenylobacterium	20	G	1	0	1	0.00000
SRR9696284	Phaeobacter	302485	G	3	0	3	0.00000
SRR9696284	Petrocella	2603323	G	1	0	1	0.00000
SRR9696284	Peptacetobacter	2743582	G	2	0	2	0.00000
SRR9696284	Pelodictyon	1099	G	1	0	1	0.00000
SRR9696284	Pedobacter	84567	G	1	0	1	0.00000
SRR9696284	Pediococcus	1253	G	2	0	2	0.00000
SRR9696284	Pectobacterium	122277	G	2	-2	0	0.00000
SRR9696284	Pauljensenia	2740557	G	3	0	3	0.00000
SRR9696284	Paucibacter	318147	G	1	2	3	0.00000
SRR9696284	Pasteurella	745	G	9	3	12	0.00000
SRR9696284	Parvimonas	543311	G	7	3	10	0.00000
SRR9696284	Parashewanella	2547964	G	1	0	1	0.00000
SRR9696284	Paraoerskovia	665568	G	1	0	1	0.00000
SRR9696284	Parageobacillus	1906945	G	1	0	1	0.00000
SRR9696284	Paraclostridium	1849822	G	1	4	5	0.00000
SRR9696284	Paraburkholderia	1822464	G	5	0	5	0.00000
SRR9696284	Pantoea	53335	G	7	0	7	0.00000
SRR9696284	Pannonibacter	227873	G	1	0	1	0.00000
SRR9696284	Pandoraea	93217	G	3	0	3	0.00000
SRR9696284	Panacibacter	1874621	G	1	0	1	0.00000
SRR9696284	Paludisphaera	1763521	G	2	0	2	0.00000
SRR9696284	Paeniclostridium	1849828	G	2	0	2	0.00000
SRR9696284	Paenibacillus	44249	G	19	0	19	0.00000
SRR9696284	Oxalobacter	846	G	1	0	1	0.00000
SRR9696284	Oscillatoria	1158	G	3	0	3	0.00000
SRR9696284	Ornithinimicrobium	125287	G	17	2	19	0.00000
SRR9696284	Opitutus	178440	G	1	0	1	0.00000
SRR9696284	Oerskovia	162491	G	1	0	1	0.00000
SRR9696284	Ochrobactrum	528	G	6	0	6	0.00000
SRR9696284	Oceanobacillus	182709	G	2	0	2	0.00000
SRR9696284	Oceanisphaera	225143	G	1	0	1	0.00000
SRR9696284	Oceanihabitans	2045416	G	1	0	1	0.00000
SRR9696284	Obesumbacterium	82982	G	1	0	1	0.00000
SRR9696284	Novosphingobium	165696	G	5	0	5	0.00000
SRR9696284	Novibacillus	1677050	G	1	0	1	0.00000
SRR9696284	Nostoc	1177	G	3	-1	2	0.00000
SRR9696284	Nordella	169055	G	3	0	3	0.00000
SRR9696284	Nonomuraea	83681	G	4	0	4	0.00000
SRR9696284	Nonlabens	363408	G	2	0	2	0.00000
SRR9696284	Nocardiopsis	2013	G	4	0	4	0.00000
SRR9696284	Nocardia	1817	G	26	2	28	0.00000
SRR9696284	Niveispirillum	1543704	G	1	0	1	0.00000
SRR9696284	Nitrosococcus	1227	G	1	1	2	0.00000
SRR9696284	Nitrobacter	911	G	1	0	1	0.00000
SRR9696284	Nibricoccus	2576890	G	1	0	1	0.00000
SRR9696284	Niastella	354354	G	3	0	3	0.00000
SRR9696284	Niabella	379899	G	1	0	1	0.00000
SRR9696284	Nesterenkonia	57494	G	1	0	1	0.00000
SRR9696284	Neomicrococcus	1868332	G	3	0	3	0.00000
SRR9696284	Neochlamydia	112987	G	1	0	1	0.00000
SRR9696284	Neisseria	482	G	23	2	25	0.00000
SRR9696284	Natronococcus	29287	G	2	0	2	0.00000
SRR9696284	Natrinema	88723	G	1	1	2	0.00000
SRR9696284	Natranaerobius	375928	G	1	0	1	0.00000
SRR9696284	Nakamurella	53460	G	4	0	4	0.00000
SRR9696284	Myxococcus	32	G	3	0	3	0.00000
SRR9696284	Myroides	76831	G	3	0	3	0.00000
SRR9696284	Mycoplasma	2093	G	9	0	9	0.00000
SRR9696284	Mycolicibacter	1073531	G	9	0	9	0.00000
SRR9696284	Mycobacteroides	670516	G	9	0	9	0.00000
SRR9696284	Muriicola	762641	G	1	0	1	0.00000
SRR9696284	Mucilaginibacter	423349	G	3	0	3	0.00000
SRR9696284	Moritella	58050	G	1	0	1	0.00000
SRR9696284	Moraxella	475	G	27	0	27	0.00000
SRR9696284	Mogibacterium	86331	G	11	0	11	0.00000
SRR9696284	Modestobacter	88138	G	8	1	9	0.00000
SRR9696284	Mobiluncus	2050	G	1	0	1	0.00000
SRR9696284	Mobilicoccus	984996	G	1	0	1	0.00000
SRR9696284	Mitsuaria	65047	G	1	0	1	0.00000
SRR9696284	Miniimonas	947525	G	1	0	1	0.00000
SRR9696284	Minicystis	1649470	G	1	0	1	0.00000
SRR9696284	Microvirga	186650	G	2	0	2	0.00000
SRR9696284	Microterricola	518733	G	3	0	3	0.00000
SRR9696284	Micromonospora	1873	G	11	2	13	0.00000
SRR9696284	Microlunatus	29404	G	7	0	7	0.00000
SRR9696284	Microbulbifer	48073	G	1	0	1	0.00000
SRR9696284	Methyloversatilis	378210	G	1	0	1	0.00000
SRR9696284	Methylotenera	359407	G	1	0	1	0.00000
SRR9696284	Methylorubrum	2282523	G	2	0	2	0.00000
SRR9696284	Methylomonas	416	G	2	0	2	0.00000
SRR9696284	Methylomicrobium	39773	G	2	0	2	0.00000
SRR9696284	Methyloligella	1485594	G	1	0	1	0.00000
SRR9696284	Methylocystis	133	G	1	0	1	0.00000
SRR9696284	Methylocaldum	73778	G	1	0	1	0.00000
SRR9696284	Methylobacterium	407	G	16	0	16	0.00000
SRR9696284	Methylibium	316612	G	1	0	1	0.00000
SRR9696284	Methanosarcina	2207	G	1	0	1	0.00000
SRR9696284	Methanohalophilus	2175	G	1	0	1	0.00000
SRR9696284	Methanococcus	2184	G	1	0	1	0.00000
SRR9696284	Methanocella	570266	G	1	0	1	0.00000
SRR9696284	Methanocaldococcus	196118	G	1	0	1	0.00000
SRR9696284	Methanobacterium	2160	G	1	0	1	0.00000
SRR9696284	Metakosakonia	2055876	G	1	3	4	0.00000
SRR9696284	Mesorhizobium	68287	G	16	0	16	0.00000
SRR9696284	Mesoplasma	46239	G	4	0	4	0.00000
SRR9696284	Mesoflavibacter	444051	G	1	-1	0	0.00000
SRR9696284	Melittangium	44	G	2	0	2	0.00000
SRR9696284	Megamonas	158846	G	2	0	2	0.00000
SRR9696284	Massilistercora	2717089	G	2	0	2	0.00000
SRR9696284	Massilia	149698	G	11	0	11	0.00000
SRR9696284	Martelella	293088	G	1	0	1	0.00000
SRR9696284	Marmoricola	86795	G	10	0	10	0.00000
SRR9696284	Marisediminicola	1230698	G	2	0	2	0.00000
SRR9696284	Marinovum	367771	G	1	0	1	0.00000
SRR9696284	Marinobacter	2742	G	2	0	2	0.00000
SRR9696284	Marinitoga	160798	G	1	-1	0	0.00000
SRR9696284	Marinirhabdus	1862153	G	1	0	1	0.00000
SRR9696284	Marinilactibacillus	191769	G	2	0	2	0.00000
SRR9696284	Mannheimia	75984	G	2	0	2	0.00000
SRR9696284	Mameliella	1434019	G	1	0	1	0.00000
SRR9696284	Lysobacter	68	G	8	0	8	0.00000
SRR9696284	Lysinimonas	1434018	G	1	0	1	0.00000
SRR9696284	Lysinibacillus	400634	G	2	0	2	0.00000
SRR9696284	Luteolibacter	518753	G	1	0	1	0.00000
SRR9696284	Luteitalea	2004797	G	5	0	5	0.00000
SRR9696284	Luteipulveratus	745364	G	1	0	1	0.00000
SRR9696284	Luteimonas	83614	G	3	0	3	0.00000
SRR9696284	Luteimicrobium	754249	G	1	0	1	0.00000
SRR9696284	Luteibacter	242605	G	2	0	2	0.00000
SRR9696284	Lonsdalea	1082702	G	1	0	1	0.00000
SRR9696284	Litoricola	418700	G	1	0	1	0.00000
SRR9696284	Listeria	1637	G	3	0	3	0.00000
SRR9696284	Limihaloglobus	2690160	G	2	1	3	0.00000
SRR9696284	Leuconostoc	1243	G	13	1	14	0.00000
SRR9696284	Leucobacter	55968	G	5	0	5	0.00000
SRR9696284	Leptotrichia	32067	G	8	0	8	0.00000
SRR9696284	Leptospirillum	179	G	2	-2	0	0.00000
SRR9696284	Leptospira	171	G	1	0	1	0.00000
SRR9696284	Leptolyngbya	47251	G	1	0	1	0.00000
SRR9696284	Lentzea	165301	G	1	0	1	0.00000
SRR9696284	Lentibacillus	175304	G	1	1	2	0.00000
SRR9696284	Leisingera	191028	G	1	0	1	0.00000
SRR9696284	Leifsonia	110932	G	7	0	7	0.00000
SRR9696284	Legionella	445	G	2	1	3	0.00000
SRR9696284	Lautropia	47670	G	9	0	9	0.00000
SRR9696284	Lactococcus	1357	G	21	4	25	0.00000
SRR9696284	Lacrimispora	2719231	G	1	0	1	0.00000
SRR9696284	Lacipirellula	2691417	G	1	0	1	0.00000
SRR9696284	Lachnospira	28050	G	1	0	1	0.00000
SRR9696284	Lachnoclostridium	1506553	G	2	0	2	0.00000
SRR9696284	Lachnoanaerobaculum	1164882	G	2	0	2	0.00000
SRR9696284	Laceyella	292635	G	1	0	1	0.00000
SRR9696284	Labrenzia	478070	G	4	-4	0	0.00000
SRR9696284	Labilithrix	1524217	G	2	0	2	0.00000
SRR9696284	Kytococcus	57499	G	2	0	2	0.00000
SRR9696284	Kutzneria	43356	G	2	0	2	0.00000
SRR9696284	Kribbella	182639	G	3	0	3	0.00000
SRR9696284	Komagataeibacter	1434011	G	2	0	2	0.00000
SRR9696284	Kocuria	57493	G	25	0	25	0.00000
SRR9696284	Kitasatospora	2063	G	3	0	3	0.00000
SRR9696284	Kineococcus	33981	G	2	0	2	0.00000
SRR9696284	Kibdelosporangium	2029	G	1	0	1	0.00000
SRR9696284	Kangiella	261963	G	1	0	1	0.00000
SRR9696284	Jonesia	43673	G	2	0	2	0.00000
SRR9696284	Jiangella	281472	G	5	0	5	0.00000
SRR9696284	Jeotgalibaca	1470540	G	3	0	3	0.00000
SRR9696284	Jeongeupia	885864	G	1	4	5	0.00000
SRR9696284	Jatrophihabitans	1434010	G	1	1	2	0.00000
SRR9696284	Janthinobacterium	29580	G	3	0	3	0.00000
SRR9696284	Jannaschia	188905	G	1	0	1	0.00000
SRR9696284	Janibacter	53457	G	7	0	7	0.00000
SRR9696284	Isoptericola	254250	G	2	0	2	0.00000
SRR9696284	Intrasporangium	53357	G	1	0	1	0.00000
SRR9696284	Incheonvrus	1982243	G	1	1	2	0.00000
SRR9696284	Ilumatobacter	682522	G	3	0	3	0.00000
SRR9696284	Hyphomicrobium	81	G	1	-1	0	0.00000
SRR9696284	Hypericibacter	2705399	G	3	0	3	0.00000
SRR9696284	Hymenobacter	89966	G	10	0	10	0.00000
SRR9696284	Hylemonella	232523	G	1	0	1	0.00000
SRR9696284	Hydrogenovibrio	28884	G	1	0	1	0.00000
SRR9696284	Hydrogenophaga	47420	G	2	-1	1	0.00000
SRR9696284	Hydrocarboniclastica	2650549	G	1	0	1	0.00000
SRR9696284	Hungateiclostridium	2304692	G	3	-1	2	0.00000
SRR9696284	Humibacter	427753	G	2	1	3	0.00000
SRR9696284	Hoyosella	697025	G	1	0	1	0.00000
SRR9696284	Hoeflea	274591	G	1	0	1	0.00000
SRR9696284	Histophilus	214906	G	1	1	2	0.00000
SRR9696284	Herbiconiux	881616	G	1	0	1	0.00000
SRR9696284	Herbaspirillum	963	G	3	0	3	0.00000
SRR9696284	Helicobacter	209	G	5	0	5	0.00000
SRR9696284	Hathewaya	1769729	G	1	9	10	0.00000
SRR9696284	Halovulum	1844498	G	1	0	1	0.00000
SRR9696284	Haloterrigena	121871	G	2	0	2	0.00000
SRR9696284	Halorubrum	56688	G	2	0	2	0.00000
SRR9696284	Haloplanus	376170	G	1	0	1	0.00000
SRR9696284	Halomonas	2745	G	13	2	15	0.00000
SRR9696284	Haloferax	2251	G	2	0	2	0.00000
SRR9696284	Halocella	46466	G	1	0	1	0.00000
SRR9696284	Halobacterium	2239	G	3	0	3	0.00000
SRR9696284	Haloactinobacterium	1331737	G	2	0	2	0.00000
SRR9696284	Haliscomenobacter	2349	G	1	0	1	0.00000
SRR9696284	Halioglobus	1217416	G	1	0	1	0.00000
SRR9696284	Haliangium	162027	G	2	0	2	0.00000
SRR9696284	Halarcobacter	2321115	G	2	0	2	0.00000
SRR9696284	Halanaerobium	2330	G	2	0	2	0.00000
SRR9696284	Hahella	158481	G	1	0	1	0.00000
SRR9696284	Haematobacter	366614	G	1	0	1	0.00000
SRR9696284	Gryllotalpicola	1195526	G	1	0	1	0.00000
SRR9696284	Gramella	292691	G	1	0	1	0.00000
SRR9696284	Gottschalkia	1505664	G	2	0	2	0.00000
SRR9696284	Gordonibacter	644652	G	2	0	2	0.00000
SRR9696284	Gordonia	2053	G	26	2	28	0.00000
SRR9696284	Glutamicibacter	1742989	G	9	0	9	0.00000
SRR9696284	Gluconobacter	441	G	1	-1	0	0.00000
SRR9696284	Gluconacetobacter	89583	G	2	0	2	0.00000
SRR9696284	Glaesserella	2094023	G	2	0	2	0.00000
SRR9696284	Georgenia	154116	G	1	0	1	0.00000
SRR9696284	Geodermatophilus	1860	G	6	1	7	0.00000
SRR9696284	Geobacter	28231	G	3	0	3	0.00000
SRR9696284	Geobacillus	129337	G	2	0	2	0.00000
SRR9696284	Geoalkalibacter	392332	G	1	0	1	0.00000
SRR9696284	Gemmatimonas	173479	G	2	1	3	0.00000
SRR9696284	Gemmata	113	G	7	0	7	0.00000
SRR9696284	Gemella	1378	G	24	0	24	0.00000
SRR9696284	Gardnerella	2701	G	1	0	1	0.00000
SRR9696284	Fusobacterium	848	G	31	0	31	0.00000
SRR9696284	Friedmanniella	53387	G	10	0	10	0.00000
SRR9696284	Frederiksenia	1649317	G	1	0	1	0.00000
SRR9696284	Frankia	1854	G	7	0	7	0.00000
SRR9696284	Francisella	262	G	2	-2	0	0.00000
SRR9696284	Fluviicola	332102	G	1	0	1	0.00000
SRR9696284	Flavobacterium	237	G	2	2	4	0.00000
SRR9696284	Flavisolibacter	398041	G	1	0	1	0.00000
SRR9696284	Flaviflexus	1522056	G	4	0	4	0.00000
SRR9696284	Flammeovirga	59739	G	1	0	1	0.00000
SRR9696284	Filifactor	44259	G	1	0	1	0.00000
SRR9696284	Fictibacillus	1329200	G	1	0	1	0.00000
SRR9696284	Fervidobacterium	2422	G	2	0	2	0.00000
SRR9696284	Fastidiosipila	236752	G	3	0	3	0.00000
SRR9696284	Faecalibacterium	216851	G	4	0	4	0.00000
SRR9696284	Ezakiella	1582879	G	13	4	17	0.00000
SRR9696284	Ethanoligenens	253238	G	1	0	1	0.00000
SRR9696284	Escherichia	561	G	5	24	29	0.00000
SRR9696284	Erythrobacter	1041	G	6	0	6	0.00000
SRR9696284	Erysipelothrix	1647	G	1	0	1	0.00000
SRR9696284	Erwinia	551	G	40	1	41	0.00000
SRR9696284	Enterococcus	1350	G	9	0	9	0.00000
SRR9696284	Enterobacter	547	G	10	2	12	0.00000
SRR9696284	Ensifer	106591	G	1	0	1	0.00000
SRR9696284	Emcibacter	1602338	G	1	0	1	0.00000
SRR9696284	Elizabethkingia	308865	G	8	0	8	0.00000
SRR9696284	Ehrlichia	943	G	1	0	1	0.00000
SRR9696284	Dyella	231454	G	2	0	2	0.00000
SRR9696284	Dyadobacter	120831	G	1	0	1	0.00000
SRR9696284	Duncaniella	2518495	G	4	0	4	0.00000
SRR9696284	Duganella	75654	G	3	0	3	0.00000
SRR9696284	Draconibacterium	1471399	G	1	0	1	0.00000
SRR9696284	Dolosigranulum	29393	G	1	0	1	0.00000
SRR9696284	Dokdonia	326319	G	1	0	1	0.00000
SRR9696284	Dokdonella	323413	G	2	0	2	0.00000
SRR9696284	Dietzia	37914	G	13	3	16	0.00000
SRR9696284	Dickeya	204037	G	3	-2	1	0.00000
SRR9696284	Diaminobutyricimonas	1433997	G	2	0	2	0.00000
SRR9696284	Dialister	39948	G	2	0	2	0.00000
SRR9696284	Devriesea	472568	G	2	0	2	0.00000
SRR9696284	Devosia	46913	G	1	0	1	0.00000
SRR9696284	Desulfovibrio	872	G	3	0	3	0.00000
SRR9696284	Desulfotomaculum	1562	G	1	0	1	0.00000
SRR9696284	Desulfosarcina	2299	G	2	0	2	0.00000
SRR9696284	Desulfohalobium	45662	G	1	0	1	0.00000
SRR9696284	Desulfofarcimen	2282742	G	1	0	1	0.00000
SRR9696284	Desulfococcus	896	G	2	0	2	0.00000
SRR9696284	Desulfobacca	60892	G	1	0	1	0.00000
SRR9696284	Dermatophilus	1862	G	1	0	1	0.00000
SRR9696284	Dermacoccus	57495	G	3	0	3	0.00000
SRR9696284	Dermabacter	36739	G	7	1	8	0.00000
SRR9696284	Denitrobacterium	79603	G	1	0	1	0.00000
SRR9696284	Delftia	80865	G	2	0	2	0.00000
SRR9696284	Deinococcus	1298	G	2	0	2	0.00000
SRR9696284	Defluviitoga	1511648	G	1	0	1	0.00000
SRR9696284	Defluviimonas	1097466	G	3	0	3	0.00000
SRR9696284	Cytorhabdovirus	11305	G	1	0	1	0.00000
SRR9696284	Curtobacterium	2034	G	12	0	12	0.00000
SRR9696284	Cupriavidus	106589	G	10	0	10	0.00000
SRR9696284	Cryobacterium	69578	G	2	0	2	0.00000
SRR9696284	Croceicoccus	1295327	G	3	3	6	0.00000
SRR9696284	Crinalium	241421	G	1	0	1	0.00000
SRR9696284	Crenobacter	1654931	G	1	0	1	0.00000
SRR9696284	Crassaminicella	1848399	G	4	2	6	0.00000
SRR9696284	Corallococcus	83461	G	6	0	6	0.00000
SRR9696284	Coraliomargarita	442430	G	1	0	1	0.00000
SRR9696284	Conexivisphaera	2613912	G	1	0	1	0.00000
SRR9696284	Conexibacter	191494	G	2	0	2	0.00000
SRR9696284	Comamonas	283	G	6	1	7	0.00000
SRR9696284	Cnuibacter	1759331	G	1	1	2	0.00000
SRR9696284	Clostridioides	1870884	G	3	6	9	0.00000
SRR9696284	Cloacibacterium	501783	G	3	0	3	0.00000
SRR9696284	Clavibacter	1573	G	13	0	13	0.00000
SRR9696284	Citrobacter	544	G	1	-1	0	0.00000
SRR9696284	Citricoccus	169133	G	2	-2	0	0.00000
SRR9696284	Chthonomonas	1077265	G	1	0	1	0.00000
SRR9696284	Chryseobacterium	59732	G	15	1	16	0.00000
SRR9696284	Christensenella	990721	G	1	0	1	0.00000
SRR9696284	Chlorobium	1091	G	1	0	1	0.00000
SRR9696284	Chlorobaculum	256319	G	1	0	1	0.00000
SRR9696284	Chlamydia	810	G	1	0	1	0.00000
SRR9696284	Chitinophaga	79328	G	3	0	3	0.00000
SRR9696284	Chania	1745211	G	1	0	1	0.00000
SRR9696284	Cellvibrio	10	G	1	0	1	0.00000
SRR9696284	Cellulosimicrobium	157920	G	4	0	4	0.00000
SRR9696284	Cellulosilyticum	698776	G	1	0	1	0.00000
SRR9696284	Cellulophaga	104264	G	1	0	1	0.00000
SRR9696284	Cellulomonas	1707	G	13	0	13	0.00000
SRR9696284	Celeribacter	875170	G	1	0	1	0.00000
SRR9696284	Caulobacter	75	G	6	0	6	0.00000
SRR9696284	Carnobacterium	2747	G	8	0	8	0.00000
SRR9696284	Cardiobacterium	2717	G	3	0	3	0.00000
SRR9696284	Capnocytophaga	1016	G	4	0	4	0.00000
SRR9696284	Campylobacter	194	G	11	0	11	0.00000
SRR9696284	Calothrix	1186	G	2	0	2	0.00000
SRR9696284	Caldicellulosiruptor	44000	G	1	0	1	0.00000
SRR9696284	Butyrivibrio	830	G	2	0	2	0.00000
SRR9696284	Burkholderia	32008	G	23	2	25	0.00000
SRR9696284	Buchnera	32199	G	5	0	5	0.00000
SRR9696284	Brevundimonas	41275	G	5	2	7	0.00000
SRR9696284	Brevirhabdus	1855413	G	2	0	2	0.00000
SRR9696284	Brevibacterium	1696	G	12	0	12	0.00000
SRR9696284	Brevibacillus	55080	G	2	0	2	0.00000
SRR9696284	Brenneria	71655	G	1	-1	0	0.00000
SRR9696284	Bradyrhizobium	374	G	38	1	39	0.00000
SRR9696284	Brachyspira	29521	G	2	0	2	0.00000
SRR9696284	Brachybacterium	43668	G	16	0	16	0.00000
SRR9696284	Bosea	85413	G	4	0	4	0.00000
SRR9696284	Bordetella	517	G	20	5	25	0.00000
SRR9696284	Blautia	572511	G	4	0	4	0.00000
SRR9696284	Blastococcus	38501	G	5	0	5	0.00000
SRR9696284	Blastochloris	59282	G	3	0	3	0.00000
SRR9696284	Bixzunavirus	680114	G	1	-1	0	0.00000
SRR9696284	Bifidobacterium	1678	G	9	0	9	0.00000
SRR9696284	Bernardetia	1937972	G	1	0	1	0.00000
SRR9696284	Belliella	232244	G	1	0	1	0.00000
SRR9696284	Beijerinckia	532	G	2	1	3	0.00000
SRR9696284	Bdellovibrio	958	G	1	0	1	0.00000
SRR9696284	Basilea	1472344	G	1	0	1	0.00000
SRR9696284	Bartonella	773	G	3	0	3	0.00000
SRR9696284	Baekduia	2600304	G	1	0	1	0.00000
SRR9696284	Bacteroides	816	G	4	0	4	0.00000
SRR9696284	Azotobacter	352	G	3	-3	0	0.00000
SRR9696284	Azospirillum	191	G	6	0	6	0.00000
SRR9696284	Azospira	146937	G	1	0	1	0.00000
SRR9696284	Azoarcus	12960	G	2	0	2	0.00000
SRR9696284	Austwickia	1184606	G	1	0	1	0.00000
SRR9696284	Auritidibacter	1160973	G	3	0	3	0.00000
SRR9696284	Auricoccus	2005363	G	1	0	1	0.00000
SRR9696284	Auraticoccus	1278221	G	2	0	2	0.00000
SRR9696284	Aurantimicrobium	1705353	G	2	0	2	0.00000
SRR9696284	Asticcacaulis	76890	G	1	0	1	0.00000
SRR9696284	Arthrospira	35823	G	1	-1	0	0.00000
SRR9696284	Arthrobacter	1663	G	34	0	34	0.00000
SRR9696284	Arsenicicoccus	267408	G	4	0	4	0.00000
SRR9696284	Arcobacter	28196	G	8	0	8	0.00000
SRR9696284	Archangium	47	G	1	0	1	0.00000
SRR9696284	Archaeoglobus	2233	G	1	0	1	0.00000
SRR9696284	Arcanobacterium	28263	G	3	0	3	0.00000
SRR9696284	Arabia	2005386	G	1	0	1	0.00000
SRR9696284	Aquitalea	407217	G	1	0	1	0.00000
SRR9696284	Aquisphaera	1511635	G	2	0	2	0.00000
SRR9696284	Aquimarina	290174	G	1	0	1	0.00000
SRR9696284	Aquaspirillum	187	G	1	0	1	0.00000
SRR9696284	Aquabacterium	92793	G	1	0	1	0.00000
SRR9696284	Antarctobacter	74032	G	1	0	1	0.00000
SRR9696284	Antarcticibacterium	2058174	G	2	0	2	0.00000
SRR9696284	Anoxybacillus	150247	G	1	0	1	0.00000
SRR9696284	Anaplasma	768	G	1	0	1	0.00000
SRR9696284	Anaerostipes	207244	G	1	0	1	0.00000
SRR9696284	Anabaena	1163	G	2	1	3	0.00000
SRR9696284	Amycolatopsis	1813	G	7	-2	5	0.00000
SRR9696284	Aminobacter	31988	G	1	0	1	0.00000
SRR9696284	Alteromonas	226	G	3	0	3	0.00000
SRR9696284	Altererythrobacter	361177	G	4	0	4	0.00000
SRR9696284	Allokutzneria	1137960	G	1	0	1	0.00000
SRR9696284	Allofrancisella	1869285	G	1	-1	0	0.00000
SRR9696284	Alloactinosynnema	674734	G	2	0	2	0.00000
SRR9696284	Alkalitalea	1193324	G	1	0	1	0.00000
SRR9696284	Alkaliphilus	114627	G	1	0	1	0.00000
SRR9696284	Alkalilimnicola	133193	G	1	0	1	0.00000
SRR9696284	Alicycliphilus	201096	G	1	7	8	0.00000
SRR9696284	Algoriphagus	246875	G	1	0	1	0.00000
SRR9696284	Alcanivorax	59753	G	2	1	3	0.00000
SRR9696284	Alcaligenes	507	G	2	0	2	0.00000
SRR9696284	Agromyces	33877	G	7	0	7	0.00000
SRR9696284	Agrococcus	46352	G	3	3	6	0.00000
SRR9696284	Agrobacterium	357	G	4	0	4	0.00000
SRR9696284	Aggregatibacter	416916	G	2	0	2	0.00000
SRR9696284	Afipia	1033	G	1	0	1	0.00000
SRR9696284	Aerosticca	2707020	G	1	0	1	0.00000
SRR9696284	Aeromonas	642	G	9	1	10	0.00000
SRR9696284	Aeromicrobium	2040	G	7	0	7	0.00000
SRR9696284	Aerococcus	1375	G	8	0	8	0.00000
SRR9696284	Aequorivita	153265	G	1	0	1	0.00000
SRR9696284	Adlercreutzia	447020	G	1	0	1	0.00000
SRR9696284	Actinosynnema	40566	G	4	0	4	0.00000
SRR9696284	Actinopolymorpha	117156	G	3	0	3	0.00000
SRR9696284	Actinoplanes	1865	G	17	1	18	0.00000
SRR9696284	Actinomyces	1654	G	46	0	46	0.00000
SRR9696284	Actinomadura	1988	G	6	0	6	0.00000
SRR9696284	Actinobaculum	76833	G	1	0	1	0.00000
SRR9696284	Actinobacillus	713	G	2	0	2	0.00000
SRR9696284	Actinoalloteichus	65496	G	8	0	8	0.00000
SRR9696284	Acidovorax	12916	G	2	1	3	0.00000
SRR9696284	Acidithiobacillus	119977	G	1	0	1	0.00000
SRR9696284	Acidipropionibacterium	1912215	G	20	0	20	0.00000
SRR9696284	Acidiphilium	522	G	1	0	1	0.00000
SRR9696284	Acidihalobacter	1765964	G	2	0	2	0.00000
SRR9696284	Acidibrevibacterium	2603324	G	2	0	2	0.00000
SRR9696284	Acidianus	12914	G	1	0	1	0.00000
SRR9696284	Acidaminococcus	904	G	1	2	3	0.00000
SRR9696284	Achromobacter	222	G	7	2	9	0.00000
SRR9696284	Acholeplasma	2147	G	1	0	1	0.00000
SRR9696284	Acetobacter	434	G	1	0	1	0.00000
SRR9696284	Acetoanaerobium	186831	G	1	0	1	0.00000
SRR9696284	Acaryochloris	155977	G	1	0	1	0.00000
SRR9696284	Absiella	2057233	G	1	-1	0	0.00000
SRR9696284	Abiotrophia	46123	G	3	0	3	0.00000
