sample	name	taxonomy_id	taxonomy_lvl	kraken_assigned_reads	added_reads	new_est_reads	fraction_total_reads
SRR6145058	Candidatus Nanopelagicales	2039638	O	23	1	24	0.00000
SRR6145058	Candidatus Brocadiales	1127829	O	7	0	7	0.00000
SRR6145058	Primates	9443	O	7868181	4955	7873136	0.86056
SRR6145058	Propionibacteriales	85009	O	497024	4775	501799	0.05485
SRR6145058	Bacillales	1385	O	102867	19249	122116	0.01335
SRR6145058	Corynebacteriales	85007	O	101390	1523	102913	0.01125
SRR6145058	Micrococcales	85006	O	98986	2660	101646	0.01111
SRR6145058	Pseudomonadales	72274	O	77558	3194	80752	0.00883
SRR6145058	Lactobacillales	186826	O	59302	3208	62510	0.00683
SRR6145058	Actinomycetales	2037	O	33786	813	34599	0.00378
SRR6145058	Burkholderiales	80840	O	32956	1025	33981	0.00371
SRR6145058	Rhizobiales	356	O	22803	421	23224	0.00254
SRR6145058	Flavobacteriales	200644	O	19023	187	19210	0.00210
SRR6145058	Rhodobacterales	204455	O	17887	1273	19160	0.00209
SRR6145058	Neisseriales	206351	O	16870	825	17695	0.00193
SRR6145058	Sphingomonadales	204457	O	13564	499	14063	0.00154
SRR6145058	Enterobacterales	91347	O	11369	2629	13998	0.00153
SRR6145058	Xanthomonadales	135614	O	11313	294	11607	0.00127
SRR6145058	Caudovirales	28883	O	3961	7348	11309	0.00124
SRR6145058	Caulobacterales	204458	O	9557	416	9973	0.00109
SRR6145058	Pasteurellales	135625	O	9472	347	9819	0.00107
SRR6145058	Streptomycetales	85011	O	8427	98	8525	0.00093
SRR6145058	Bacteroidales	171549	O	8325	15	8340	0.00091
SRR6145058	Deinococcales	118964	O	7310	11	7321	0.00080
SRR6145058	Fusobacteriales	203491	O	6374	24	6398	0.00070
SRR6145058	Veillonellales	1843489	O	5660	13	5673	0.00062
SRR6145058	Rhodospirillales	204441	O	4855	655	5510	0.00060
SRR6145058	Tissierellales	1737405	O	4420	451	4871	0.00053
SRR6145058	Oceanospirillales	135619	O	4130	61	4191	0.00046
SRR6145058	Pseudonocardiales	85010	O	3185	-63	3122	0.00034
SRR6145058	Sphingobacteriales	200666	O	2987	75	3062	0.00033
SRR6145058	Clostridiales	186802	O	2328	75	2403	0.00026
SRR6145058	Micromonosporales	85008	O	2087	25	2112	0.00023
SRR6145058	Myxococcales	29	O	1367	1	1368	0.00015
SRR6145058	Streptosporangiales	85012	O	1062	14	1076	0.00012
SRR6145058	Campylobacterales	213849	O	1089	1	1090	0.00012
SRR6145058	Bifidobacteriales	85004	O	1061	-8	1053	0.00012
SRR6145058	Aeromonadales	135624	O	939	104	1043	0.00011
SRR6145058	Cytophagales	768507	O	888	0	888	0.00010
SRR6145058	Rhodocyclales	206389	O	720	78	798	0.00009
SRR6145058	Isosphaerales	2691356	O	120	674	794	0.00009
SRR6145058	Nostocales	1161	O	782	-18	764	0.00008
SRR6145058	Alteromonadales	135622	O	707	8	715	0.00008
SRR6145058	Spirochaetales	136	O	642	1	643	0.00007
SRR6145058	Geodermatophilales	1643682	O	639	14	653	0.00007
SRR6145058	Sporichthyales	2495578	O	528	5	533	0.00006
SRR6145058	Selenomonadales	909929	O	550	1	551	0.00006
SRR6145058	Nitrosomonadales	32003	O	398	128	526	0.00006
SRR6145058	Coriobacteriales	84999	O	509	3	512	0.00006
SRR6145058	Chromatiales	135613	O	576	6	582	0.00006
SRR6145058	Cellvibrionales	1706369	O	527	2	529	0.00006
SRR6145058	Cardiobacteriales	135615	O	520	11	531	0.00006
SRR6145058	Nakamurellales	1643684	O	419	7	426	0.00005
SRR6145058	Frankiales	85013	O	415	3	418	0.00005
SRR6145058	Rubrobacterales	84996	O	344	0	344	0.00004
SRR6145058	Brachyspirales	1643686	O	21	359	380	0.00004
SRR6145058	Vibrionales	135623	O	283	5	288	0.00003
SRR6145058	Synechococcales	1890424	O	247	4	251	0.00003
SRR6145058	Haloferacales	1644055	O	250	12	262	0.00003
SRR6145058	Chitinophagales	1853229	O	252	0	252	0.00003
SRR6145058	Zurhausenvirales	2732533	O	196	-14	182	0.00002
SRR6145058	Thermales	68933	O	156	0	156	0.00002
SRR6145058	Rickettsiales	766	O	205	-3	202	0.00002
SRR6145058	Planctomycetales	112	O	191	33	224	0.00002
SRR6145058	Natrialbales	1644060	O	204	2	206	0.00002
SRR6145058	Methylococcales	135618	O	92	89	181	0.00002
SRR6145058	Jiangellales	1217098	O	214	3	217	0.00002
SRR6145058	Halobacteriales	2235	O	213	10	223	0.00002
SRR6145058	Gemmatales	2691355	O	222	0	222	0.00002
SRR6145058	Desulfuromonadales	69541	O	178	3	181	0.00002
SRR6145058	Desulfovibrionales	213115	O	206	2	208	0.00002
SRR6145058	Verrucomicrobiales	48461	O	79	16	95	0.00001
SRR6145058	Thiotrichales	72273	O	101	1	102	0.00001
SRR6145058	Thermoanaerobacterales	68295	O	87	0	87	0.00001
SRR6145058	Solirubrobacterales	588673	O	134	1	135	0.00001
SRR6145058	Pirellulales	2691354	O	122	0	122	0.00001
SRR6145058	Petitvirales	2732414	O	27	28	55	0.00001
SRR6145058	Oscillatoriales	1150	O	118	4	122	0.00001
SRR6145058	Opitutales	415000	O	116	1	117	0.00001
SRR6145058	Nevskiales	1775403	O	107	2	109	0.00001
SRR6145058	Mycoplasmatales	2085	O	117	1	118	0.00001
SRR6145058	Methanococcales	2182	O	49	0	49	0.00001
SRR6145058	Legionellales	118969	O	108	0	108	0.00001
SRR6145058	Kineosporiales	622452	O	90	2	92	0.00001
SRR6145058	Hydrogenophilales	119069	O	71	1	72	0.00001
SRR6145058	Glycomycetales	85014	O	49	83	132	0.00001
SRR6145058	Gemmatimonadales	219686	O	134	0	134	0.00001
SRR6145058	Euzebyales	908621	O	46	0	46	0.00001
SRR6145058	Erysipelotrichales	526525	O	71	21	92	0.00001
SRR6145058	Entomoplasmatales	186328	O	51	3	54	0.00001
SRR6145058	Egicoccales	1755823	O	53	0	53	0.00001
SRR6145058	Eggerthellales	1643822	O	95	0	95	0.00001
SRR6145058	Desulfobacterales	213118	O	96	0	96	0.00001
SRR6145058	Chroococcidiopsidales	1890505	O	124	6	130	0.00001
SRR6145058	Chroococcales	1118	O	83	5	88	0.00001
SRR6145058	Catenulisporales	414714	O	69	0	69	0.00001
SRR6145058	Bryobacterales	332160	O	18	48	66	0.00001
SRR6145058	Bdellovibrionales	213481	O	51	0	51	0.00001
SRR6145058	Acidobacteriales	204433	O	79	0	79	0.00001
SRR6145058	Acidimicrobiales	84993	O	102	20	122	0.00001
SRR6145058	Victivallales	278082	O	9	0	9	0.00000
SRR6145058	Thermotogales	2419	O	19	-4	15	0.00000
SRR6145058	Thermoproteales	2266	O	21	0	21	0.00000
SRR6145058	Thermoplasmatales	2301	O	6	0	6	0.00000
SRR6145058	Thermomicrobiales	189776	O	5	0	5	0.00000
SRR6145058	Thermodesulfobacteriales	188710	O	9	0	9	0.00000
SRR6145058	Thermococcales	2258	O	28	0	28	0.00000
SRR6145058	Tepidiformales	2682226	O	17	0	17	0.00000
SRR6145058	Syntrophobacterales	213462	O	26	0	26	0.00000
SRR6145058	Synergistales	649776	O	28	0	28	0.00000
SRR6145058	Sulfolobales	2281	O	20	0	20	0.00000
SRR6145058	Sphaerobacterales	85001	O	22	0	22	0.00000
SRR6145058	Sobelivirales	2732553	O	1	0	1	0.00000
SRR6145058	Silvanigrellales	2024973	O	6	0	6	0.00000
SRR6145058	Sepolyvirales	2732532	O	12	0	12	0.00000
SRR6145058	Sedimentisphaerales	2483366	O	14	12	26	0.00000
SRR6145058	Saprospirales	1936988	O	13	0	13	0.00000
SRR6145058	Salinisphaerales	742030	O	17	0	17	0.00000
SRR6145058	Rowavirales	2732559	O	1	0	1	0.00000
SRR6145058	Reovirales	2732541	O	1	0	1	0.00000
SRR6145058	Puniceicoccales	415001	O	3	0	3	0.00000
SRR6145058	Pleurocapsales	52604	O	23	1	24	0.00000
SRR6145058	Pimascovirales	2732555	O	2	0	2	0.00000
SRR6145058	Phycisphaerales	666506	O	26	0	26	0.00000
SRR6145058	Petrotogales	1643947	O	15	0	15	0.00000
SRR6145058	Pelagibacterales	54526	O	33	0	33	0.00000
SRR6145058	Patatavirales	2732550	O	1	0	1	0.00000
SRR6145058	Parvularculales	255473	O	14	0	14	0.00000
SRR6145058	Parachlamydiales	1963360	O	12	0	12	0.00000
SRR6145058	Ortervirales	2169561	O	7	0	7	0.00000
SRR6145058	Orbales	1240482	O	24	0	24	0.00000
SRR6145058	Nitrospirales	189778	O	43	0	43	0.00000
SRR6145058	Nitrososphaerales	1033996	O	10	0	10	0.00000
SRR6145058	Nitrosopumilales	31932	O	8	6	14	0.00000
SRR6145058	Nidovirales	76804	O	1	0	1	0.00000
SRR6145058	Nautiliales	235899	O	10	2	12	0.00000
SRR6145058	Natranaerobiales	485256	O	3	0	3	0.00000
SRR6145058	Methylacidiphilales	717963	O	4	0	4	0.00000
SRR6145058	Methanosarcinales	94695	O	46	-1	45	0.00000
SRR6145058	Methanopyrales	68985	O	1	0	1	0.00000
SRR6145058	Methanomicrobiales	2191	O	20	0	20	0.00000
SRR6145058	Methanomassiliicoccales	1235850	O	5	2	7	0.00000
SRR6145058	Methanocellales	570264	O	6	1	7	0.00000
SRR6145058	Methanobacteriales	2158	O	29	0	29	0.00000
SRR6145058	Martellivirales	2732544	O	1	17	18	0.00000
SRR6145058	Mariprofundales	580371	O	9	0	9	0.00000
SRR6145058	Marinilabiliales	1970189	O	44	0	44	0.00000
SRR6145058	Magnetococcales	1191478	O	5	0	5	0.00000
SRR6145058	Limnochordales	1676649	O	7	0	7	0.00000
SRR6145058	Leptospirales	1643688	O	22	-4	18	0.00000
SRR6145058	Ktedonobacterales	388448	O	8	3	11	0.00000
SRR6145058	Kosmotogales	1643946	O	3	0	3	0.00000
SRR6145058	Kiritimatiellales	1921782	O	9	6	15	0.00000
SRR6145058	Immundisolibacterales	1934945	O	28	0	28	0.00000
SRR6145058	Imitervirales	2732554	O	4	0	4	0.00000
SRR6145058	Ignavibacteriales	795748	O	2	0	2	0.00000
SRR6145058	Holosporales	1921002	O	10	0	10	0.00000
SRR6145058	Herpesvirales	548681	O	11	0	11	0.00000
SRR6145058	Halopanivirales	2732011	O	1	0	1	0.00000
SRR6145058	Halanaerobiales	53433	O	25	0	25	0.00000
SRR6145058	Gloeoemargaritales	1955042	O	7	0	7	0.00000
SRR6145058	Gloeobacterales	307595	O	20	9	29	0.00000
SRR6145058	Fimbriimonadales	1663425	O	15	12	27	0.00000
SRR6145058	Fibrobacterales	218872	O	4	2	6	0.00000
SRR6145058	Endomicrobiales	1783344	O	1	1	2	0.00000
SRR6145058	Emcibacterales	2066490	O	23	0	23	0.00000
SRR6145058	Elusimicrobiales	641854	O	1	0	1	0.00000
SRR6145058	Egibacterales	1747768	O	34	0	34	0.00000
SRR6145058	Dictyoglomales	203487	O	5	0	5	0.00000
SRR6145058	Desulfurococcales	114380	O	10	-2	8	0.00000
SRR6145058	Desulfurobacteriales	1485951	O	3	0	3	0.00000
SRR6145058	Desulfurellales	213113	O	4	1	5	0.00000
SRR6145058	Desulfarculales	453227	O	12	1	13	0.00000
SRR6145058	Dehalococcoidales	1202465	O	2	0	2	0.00000
SRR6145058	Deferribacterales	191393	O	16	0	16	0.00000
SRR6145058	Chthonomonadales	1077263	O	5	2	7	0.00000
SRR6145058	Chrysiogenales	189769	O	3	0	3	0.00000
SRR6145058	Chloroflexales	32064	O	37	-11	26	0.00000
SRR6145058	Chlorobiales	191411	O	35	4	39	0.00000
SRR6145058	Chlamydiales	51291	O	9	-1	8	0.00000
SRR6145058	Chitovirales	2732527	O	10	0	10	0.00000
SRR6145058	Calditrichales	1962852	O	5	0	5	0.00000
SRR6145058	Caldilineales	475963	O	4	0	4	0.00000
SRR6145058	Bunyavirales	1980410	O	1	0	1	0.00000
SRR6145058	Bradymonadales	1779134	O	36	0	36	0.00000
SRR6145058	Bacteroidetes Order II. Incertae sedis	1100069	O	78	0	78	0.00001
SRR6145058	Bacteriovoracales	2024979	O	40	0	40	0.00000
SRR6145058	Ardenticatenales	1382929	O	16	0	16	0.00000
SRR6145058	Archaeoglobales	2231	O	7	0	7	0.00000
SRR6145058	Aquificales	32069	O	22	0	22	0.00000
SRR6145058	Anaerolineales	292629	O	18	0	18	0.00000
SRR6145058	Algavirales	2732524	O	7	0	7	0.00000
SRR6145058	Actinopolysporales	622450	O	29	0	29	0.00000
SRR6145058	Acidothermales	1643683	O	12	0	12	0.00000
SRR6145058	Acidithiobacillales	225057	O	30	0	30	0.00000
SRR6145058	Acidilobales	871006	O	6	19	25	0.00000
SRR6145058	Acidiferrobacterales	1692040	O	39	0	39	0.00000
SRR6145058	Acidaminococcales	1843488	O	23	-6	17	0.00000
SRR6145058	Acholeplasmatales	186329	O	24	5	29	0.00000
