sample	name	taxonomy_id	taxonomy_lvl	kraken_assigned_reads	added_reads	new_est_reads	fraction_total_reads
SRR6145058	Homo sapiens	9606	S	7868181	4955	7873136	0.86056
SRR6145058	Candidatus Saccharibacteria bacterium oral taxon 957	2572088	S	38	18	56	0.00001
SRR6145058	Candidatus Saccharibacteria bacterium oral taxon 955	2572087	S	7	7	14	0.00000
SRR6145058	Nostoc sp. 'Lobaria pulmonaria (5183) cyanobiont'	1618022	S	7	1	8	0.00000
SRR6145058	Blochmannia endosymbiont of Camponotus (Colobopsis) obliquus	1505597	S	1	0	1	0.00000
SRR6145058	Deinococcus soli Cha et al. 2016	1309411	S	105	31	136	0.00001
SRR6145058	Nostoc sp. 'Peltigera membranacea cyanobiont' N6	1261031	S	8	2	10	0.00000
SRR6145058	Candidatus Saccharibacteria bacterium oral taxon 488	713059	S	189	66	255	0.00003
SRR6145058	Cutibacterium acnes	1747	S	468607	9585	478192	0.05227
SRR6145058	Sphingomonas ginsengisoli An et al. 2013	363835	S	75	1	76	0.00001
SRR6145058	Lymphocystis disease virus - isolate China	256729	S	1	0	1	0.00000
SRR6145058	Micrococcus luteus	1270	S	25043	14493	39536	0.00432
SRR6145058	Moraxella osloensis	34062	S	36531	1126	37657	0.00412
SRR6145058	Staphylococcus epidermidis	1282	S	26940	7660	34600	0.00378
SRR6145058	Staphylococcus hominis	1290	S	13986	1156	15142	0.00166
SRR6145058	Streptococcus mitis	28037	S	10661	2365	13026	0.00142
SRR6145058	Staphylococcus warneri	1292	S	5600	7383	12983	0.00142
SRR6145058	Staphylococcus saprophyticus	29385	S	11846	970	12816	0.00140
SRR6145058	Cutibacterium granulosum	33011	S	11306	421	11727	0.00128
SRR6145058	Paraburkholderia fungorum	134537	S	10489	760	11249	0.00123
SRR6145058	Corynebacterium segmentosum	43990	S	9309	409	9718	0.00106
SRR6145058	Actinomyces oris	544580	S	5400	4238	9638	0.00105
SRR6145058	Actinomyces naeslundii	1655	S	4749	3876	8625	0.00094
SRR6145058	Staphylococcus sciuri	1296	S	8203	260	8463	0.00093
SRR6145058	Acinetobacter junii	40215	S	7146	809	7955	0.00087
SRR6145058	Corynebacterium ureicelerivorans	401472	S	7310	544	7854	0.00086
SRR6145058	Neisseria mucosa	488	S	6366	1420	7786	0.00085
SRR6145058	Tsukamurella tyrosinosolvens	57704	S	6952	779	7731	0.00085
SRR6145058	Staphylococcus capitis	29388	S	6674	556	7230	0.00079
SRR6145058	Streptococcus pneumoniae	1313	S	3088	3810	6898	0.00075
SRR6145058	Corynebacterium matruchotii	43768	S	6751	45	6796	0.00074
SRR6145058	Streptococcus oralis	1303	S	4555	1790	6345	0.00069
SRR6145058	Haemophilus parainfluenzae	729	S	5664	426	6090	0.00067
SRR6145058	Staphylococcus aureus	1280	S	1802	4175	5977	0.00065
SRR6145058	Staphylococcus phage IME1361_01	1965490	S	1	5898	5899	0.00064
SRR6145058	Acinetobacter schindleri	108981	S	4813	897	5710	0.00062
SRR6145058	Chryseobacterium taklimakanense	536441	S	4840	524	5364	0.00059
SRR6145058	Streptococcus sanguinis	1305	S	4853	231	5084	0.00056
SRR6145058	Acinetobacter baumannii	470	S	953	3934	4887	0.00053
SRR6145058	Kytococcus sedentarius	1276	S	4494	292	4786	0.00052
SRR6145058	Dermacoccus nishinomiyaensis	1274	S	4590	185	4775	0.00052
SRR6145058	Veillonella parvula	29466	S	4505	174	4679	0.00051
SRR6145058	Janibacter indicus	857417	S	4190	402	4592	0.00050
SRR6145058	Streptococcus gordonii	1302	S	4286	255	4541	0.00050
SRR6145058	Cutibacterium avidum	33010	S	4380	145	4525	0.00049
SRR6145058	Staphylococcus pasteuri	45972	S	2921	1570	4491	0.00049
SRR6145058	Rothia dentocariosa	2047	S	4260	147	4407	0.00048
SRR6145058	Micrococcus sp. KBS0714	1179670	S	1105	4322	5427	0.00059
SRR6145058	Paracoccus sanguinis	1545044	S	3661	407	4068	0.00044
SRR6145058	Gemella haemolysans	1379	S	3686	121	3807	0.00042
SRR6145058	Kocuria palustris	71999	S	3576	204	3780	0.00041
SRR6145058	Rothia mucilaginosa	43675	S	3508	59	3567	0.00039
SRR6145058	Staphylococcus cohnii	29382	S	3187	271	3458	0.00038
SRR6145058	Gordonia terrae	2055	S	2527	868	3395	0.00037
SRR6145058	Paracoccus yeei	147645	S	1761	1629	3390	0.00037
SRR6145058	Deinococcus wulumuqiensis	980427	S	2999	294	3293	0.00036
SRR6145058	Finegoldia magna	1260	S	2931	272	3203	0.00035
SRR6145058	Dietzia timorensis	499555	S	2572	520	3092	0.00034
SRR6145058	Lautropia mirabilis	47671	S	2753	159	2912	0.00032
SRR6145058	Staphylococcus haemolyticus	1283	S	2306	519	2825	0.00031
SRR6145058	Halomonas hydrothermalis	115561	S	2561	252	2813	0.00031
SRR6145058	Serratia marcescens	615	S	1712	1078	2790	0.00030
SRR6145058	Actinomyces viscosus	1656	S	2534	96	2630	0.00029
SRR6145058	Stenotrophomonas maltophilia	40324	S	1618	957	2575	0.00028
SRR6145058	Gordonia bronchialis	2054	S	2284	137	2421	0.00026
SRR6145058	Gordonia sp. JH63	2698900	S	2077	2367	4444	0.00049
SRR6145058	Neisseria subflava	28449	S	1902	388	2290	0.00025
SRR6145058	Tsukamurella paurometabola	2061	S	2055	221	2276	0.00025
SRR6145058	Corynebacterium kroppenstedtii	161879	S	2220	41	2261	0.00025
SRR6145058	Corynebacterium sanguinis	2594913	S	1909	345	2254	0.00025
SRR6145058	Prevotella melaninogenica	28132	S	1995	253	2248	0.00025
SRR6145058	Escherichia coli	562	S	115	2010	2125	0.00023
SRR6145058	Acinetobacter johnsonii	40214	S	1280	748	2028	0.00022
SRR6145058	Schaalia odontolytica	1660	S	1915	68	1983	0.00022
SRR6145058	Pseudomonas aeruginosa	287	S	359	1579	1938	0.00021
SRR6145058	Rothia aeria	172042	S	1856	66	1922	0.00021
SRR6145058	Rhodococcus sp. PBTS 1	1653478	S	1844	104	1948	0.00021
SRR6145058	Neisseria elongata	495	S	1660	174	1834	0.00020
SRR6145058	Capnocytophaga sputigena	1019	S	1659	173	1832	0.00020
SRR6145058	Streptococcus cristatus	45634	S	1703	118	1821	0.00020
SRR6145058	Streptococcus gwangjuense	1433513	S	1354	458	1812	0.00020
SRR6145058	Fusobacterium nucleatum	851	S	1528	196	1724	0.00019
SRR6145058	Dolosigranulum pigrum	29394	S	1638	24	1662	0.00018
SRR6145058	Deinococcus radiodurans	1299	S	1494	128	1622	0.00018
SRR6145058	Klebsiella pneumoniae	573	S	185	1435	1620	0.00018
SRR6145058	Kocuria indica	1049583	S	893	698	1591	0.00017
SRR6145058	Brevundimonas diminuta	293	S	746	839	1585	0.00017
SRR6145058	Microbacterium aurum	36805	S	1420	111	1531	0.00017
SRR6145058	Pseudomonas stutzeri	316	S	1307	219	1526	0.00017
SRR6145058	Streptococcus salivarius	1304	S	886	612	1498	0.00016
SRR6145058	Sphingomonas melonis	152682	S	761	705	1466	0.00016
SRR6145058	Chryseobacterium haifense	421525	S	1212	237	1449	0.00016
SRR6145058	Roseomonas mucosa	207340	S	417	979	1396	0.00015
SRR6145058	Corynebacterium striatum	43770	S	1060	316	1376	0.00015
SRR6145058	Sphingobacterium lactis	797291	S	1288	81	1369	0.00015
SRR6145058	Lawsonella clevelandensis	1528099	S	1317	23	1340	0.00015
SRR6145058	Dietzia lutea	546160	S	1159	146	1305	0.00014
SRR6145058	Corynebacterium jeikeium	38289	S	805	493	1298	0.00014
SRR6145058	Pseudomonas putida	303	S	724	570	1294	0.00014
SRR6145058	Corynebacterium simulans	146827	S	965	306	1271	0.00014
SRR6145058	Klebsiella michiganensis	1134687	S	124	1113	1237	0.00014
SRR6145058	Neisseria meningitidis	487	S	507	716	1223	0.00013
SRR6145058	Streptococcus pseudopneumoniae	257758	S	801	384	1185	0.00013
SRR6145058	Delftia tsuruhatensis	180282	S	623	560	1183	0.00013
SRR6145058	Acinetobacter pittii	48296	S	720	442	1162	0.00013
SRR6145058	Prevotella intermedia	28131	S	1053	93	1146	0.00013
SRR6145058	Paracoccus contaminans	1945662	S	988	102	1090	0.00012
SRR6145058	Xanthomonas campestris	339	S	942	118	1060	0.00012
SRR6145058	Brevundimonas naejangsanensis	588932	S	894	97	991	0.00011
SRR6145058	Janibacter melonis	262209	S	927	59	986	0.00011
SRR6145058	Porphyromonas gingivalis	837	S	863	74	937	0.00010
SRR6145058	Corynebacterium singulare	161899	S	759	144	903	0.00010
SRR6145058	Haemophilus haemolyticus	726	S	750	131	881	0.00010
SRR6145058	Aquabacterium olei	1296669	S	749	123	872	0.00010
SRR6145058	Streptococcus australis	113107	S	697	173	870	0.00010
SRR6145058	Brevundimonas vancanneytii	1325724	S	280	568	848	0.00009
SRR6145058	Janibacter limosus	53458	S	795	52	847	0.00009
SRR6145058	Haemophilus influenzae	727	S	461	369	830	0.00009
SRR6145058	Pseudomonas oryzihabitans	47885	S	801	25	826	0.00009
SRR6145058	Lysobacter enzymogenes	69	S	709	117	826	0.00009
SRR6145058	Leptotrichia wadei	157687	S	707	112	819	0.00009
SRR6145058	Streptococcus pyogenes	1314	S	106	708	814	0.00009
SRR6145058	Corynebacterium diphtheriae	1717	S	262	546	808	0.00009
SRR6145058	Pseudomonas alcaligenes	43263	S	768	31	799	0.00009
SRR6145058	Acinetobacter ursingii	108980	S	726	67	793	0.00009
SRR6145058	Chryseobacterium sp. F5649	2487071	S	792	784	1576	0.00017
SRR6145058	Bacillus cereus	1396	S	486	287	773	0.00008
SRR6145058	Gemella morbillorum	29391	S	677	74	751	0.00008
SRR6145058	Sphingobium yanoikuyae	13690	S	353	393	746	0.00008
SRR6145058	Chryseobacterium sp. H6466	2487072	S	693	742	1435	0.00016
SRR6145058	Corynebacterium mycetoides	38302	S	611	116	727	0.00008
SRR6145058	Staphylococcus auricularis	29379	S	708	16	724	0.00008
SRR6145058	Corynebacterium aurimucosum	169292	S	638	78	716	0.00008
SRR6145058	Mycolicibacterium gilvum	1804	S	445	270	715	0.00008
SRR6145058	Leptotrichia hongkongensis	554406	S	599	115	714	0.00008
SRR6145058	Pseudopropionibacterium propionicum	1750	S	704	6	710	0.00008
SRR6145058	Corynebacterium minutissimum	38301	S	636	65	701	0.00008
SRR6145058	Staphylococcus sp. AntiMn-1	1715860	S	30	679	709	0.00008
SRR6145058	Capnocytophaga gingivalis	1017	S	659	20	679	0.00007
SRR6145058	Abiotrophia defectiva	46125	S	660	6	666	0.00007
SRR6145058	Acinetobacter lwoffii	28090	S	337	328	665	0.00007
SRR6145058	Neisseria flavescens	484	S	500	164	664	0.00007
SRR6145058	Streptococcus sp. NPS 308	1902136	S	649	155	804	0.00009
SRR6145058	Peptoniphilus harei	54005	S	611	32	643	0.00007
SRR6145058	Microbacterium paraoxydans	199592	S	171	458	629	0.00007
SRR6145058	Corynebacterium genitalium	38288	S	595	31	626	0.00007
SRR6145058	Acinetobacter indicus	756892	S	546	77	623	0.00007
SRR6145058	Acinetobacter haemolyticus	29430	S	512	104	616	0.00007
SRR6145058	Stenotrophomonas sp. pho	2211160	S	203	606	809	0.00009
SRR6145058	Brevibacterium luteolum	199591	S	553	45	598	0.00007
SRR6145058	Pauljensenia hongkongensis	178339	S	556	33	589	0.00006
SRR6145058	Brevibacterium linens	1703	S	386	203	589	0.00006
SRR6145058	Streptococcus thermophilus	1308	S	454	127	581	0.00006
SRR6145058	Kocuria sp. KD4	2719588	S	786	575	1361	0.00015
SRR6145058	Fusobacterium pseudoperiodonticum	2663009	S	477	96	573	0.00006
SRR6145058	Sulfitobacter donghicola	421000	S	4	555	559	0.00006
SRR6145058	Rhizobium pusense	648995	S	132	419	551	0.00006
SRR6145058	Veillonella dispar	39778	S	520	28	548	0.00006
SRR6145058	Actinomyces radicidentis	111015	S	514	31	545	0.00006
SRR6145058	Brevundimonas vesicularis	41276	S	272	272	544	0.00006
SRR6145058	Staphylococcus caprae	29380	S	487	46	533	0.00006
SRR6145058	Epidermidibacterium keratini	1891644	S	528	5	533	0.00006
SRR6145058	Methylorubrum populi	223967	S	399	133	532	0.00006
SRR6145058	Cardiobacterium hominis	2718	S	519	12	531	0.00006
SRR6145058	Lysobacter oculi	2698682	S	495	33	528	0.00006
SRR6145058	Brevundimonas mediterranea	74329	S	464	63	527	0.00006
SRR6145058	Methylobacterium sp. XJLW	739141	S	67	525	592	0.00006
SRR6145058	Staphylococcus nepalensis	214473	S	504	17	521	0.00006
SRR6145058	Roseomonas sp. FDAARGOS_362	2018065	S	287	519	806	0.00009
SRR6145058	Prevotella denticola	28129	S	478	38	516	0.00006
SRR6145058	Moraxella catarrhalis	480	S	504	9	513	0.00006
SRR6145058	Corynebacterium imitans	156978	S	473	37	510	0.00006
SRR6145058	Stenotrophomonas sp. Pemsol	2040586	S	205	508	713	0.00008
SRR6145058	Gordonia polyisoprenivorans	84595	S	494	12	506	0.00006
SRR6145058	Methylobacterium radiotolerans	31998	S	159	346	505	0.00006
SRR6145058	Leptotrichia buccalis	40542	S	434	69	503	0.00005
SRR6145058	Gardnerella vaginalis	2702	S	485	7	492	0.00005
SRR6145058	Corynebacterium glutamicum	1718	S	39	453	492	0.00005
SRR6145058	Salmonella enterica	28901	S	44	438	482	0.00005
SRR6145058	Corynebacterium glaucum	187491	S	453	17	470	0.00005
SRR6145058	Mycolicibacterium mageritense	53462	S	405	51	456	0.00005
SRR6145058	Mycolicibacterium aurum	1791	S	414	41	455	0.00005
SRR6145058	Dietzia psychralcaliphila	139021	S	427	28	455	0.00005
SRR6145058	Corynebacterium riegelii	156976	S	421	30	451	0.00005
SRR6145058	Haemophilus parahaemolyticus	735	S	433	17	450	0.00005
SRR6145058	Streptococcus mutans	1309	S	404	43	447	0.00005
SRR6145058	Corynebacterium xerosis	1725	S	400	43	443	0.00005
SRR6145058	Agrobacterium tumefaciens	358	S	280	159	439	0.00005
SRR6145058	Brachybacterium saurashtrense	556288	S	383	53	436	0.00005
SRR6145058	Mycolicibacterium poriferae	39694	S	85	347	432	0.00005
SRR6145058	Aggregatibacter aphrophilus	732	S	395	34	429	0.00005
SRR6145058	Streptococcus vestibularis	1343	S	344	80	424	0.00005
SRR6145058	Dietzia sp. DQ12-45-1b	912801	S	71	424	495	0.00005
SRR6145058	Mycolicibacterium psychrotolerans	216929	S	385	38	423	0.00005
SRR6145058	Klebsiella oxytoca	571	S	137	286	423	0.00005
SRR6145058	Mycobacterium sp. KMS	189918	S	47	418	465	0.00005
SRR6145058	Anaerococcus prevotii	33034	S	389	24	413	0.00005
SRR6145058	Variovorax paradoxus	34073	S	336	73	409	0.00004
SRR6145058	Capnocytophaga endodontalis	2708117	S	339	65	404	0.00004
SRR6145058	Achromobacter xylosoxidans	85698	S	231	172	403	0.00004
SRR6145058	Bosea vaviloviae	1526658	S	348	53	401	0.00004
SRR6145058	Gemella sanguinis	84135	S	384	16	400	0.00004
SRR6145058	Mycobacterium dioxanotrophicus	482462	S	362	37	399	0.00004
SRR6145058	Aggregatibacter segnis	739	S	364	27	391	0.00004
SRR6145058	Acinetobacter guillouiae	106649	S	384	7	391	0.00004
SRR6145058	Streptococcus anginosus	1328	S	183	207	390	0.00004
SRR6145058	Prevotella oris	28135	S	368	22	390	0.00004
SRR6145058	Massilia oculi	945844	S	350	40	390	0.00004
SRR6145058	Staphylococcus kloosii	29384	S	375	10	385	0.00004
SRR6145058	Pseudomonas mendocina	300	S	350	33	383	0.00004
SRR6145058	Mycobacteroides abscessus	36809	S	188	194	382	0.00004
SRR6145058	Prevotella jejuni	1177574	S	336	41	377	0.00004
SRR6145058	Aerococcus viridans	1377	S	292	85	377	0.00004
SRR6145058	Corynebacterium casei	160386	S	280	96	376	0.00004
SRR6145058	Rhodobacter sphaeroides	1063	S	332	40	372	0.00004
SRR6145058	Streptococcus parasanguinis	1318	S	317	54	371	0.00004
SRR6145058	Mycolicibacterium phocaicum	319706	S	310	61	371	0.00004
SRR6145058	Rhodopseudomonas palustris	1076	S	313	52	365	0.00004
SRR6145058	Capnocytophaga leadbetteri	327575	S	294	71	365	0.00004
SRR6145058	Leptotrichia trevisanii	109328	S	324	38	362	0.00004
SRR6145058	Methylorubrum extorquens	408	S	175	186	361	0.00004
SRR6145058	Brevibacterium aurantiacum	273384	S	289	70	359	0.00004
SRR6145058	Roseomonas gilardii	257708	S	329	29	358	0.00004
SRR6145058	Streptococcus sp. FDAARGOS_522	2420310	S	6	356	362	0.00004
SRR6145058	Mycolicibacterium vanbaalenii	110539	S	256	100	356	0.00004
SRR6145058	Bosea sp. PAMC 26642	1792307	S	355	45	400	0.00004
SRR6145058	Enterobacter hormaechei	158836	S	37	317	354	0.00004
SRR6145058	Paracoccus aminovorans	34004	S	314	38	352	0.00004
SRR6145058	Nakamurella multipartita	53461	S	344	8	352	0.00004
SRR6145058	Methylobacterium brachiatum	269660	S	298	54	352	0.00004
SRR6145058	Corynebacterium camporealensis	161896	S	325	26	351	0.00004
SRR6145058	Deinococcus gobiensis	502394	S	342	5	347	0.00004
SRR6145058	Mycolicibacterium gadium	1794	S	260	86	346	0.00004
SRR6145058	Mycobacteroides chelonae	1774	S	84	262	346	0.00004
SRR6145058	Lactococcus lactis	1358	S	217	127	344	0.00004
SRR6145058	Lactobacillus crispatus	47770	S	181	159	340	0.00004
SRR6145058	Pseudomonas fluorescens	294	S	212	127	339	0.00004
SRR6145058	Leptotrichia hofstadii	157688	S	282	56	338	0.00004
SRR6145058	Eikenella corrodens	539	S	297	41	338	0.00004
SRR6145058	Corynebacterium timonense	441500	S	324	13	337	0.00004
SRR6145058	Pseudoxanthomonas suwonensis	314722	S	303	33	336	0.00004
SRR6145058	Propionibacterium acidifaciens	556499	S	318	18	336	0.00004
SRR6145058	Comamonas aquatica	225991	S	306	29	335	0.00004
SRR6145058	Tannerella forsythia	28112	S	309	24	333	0.00004
SRR6145058	Chryseobacterium gleum	250	S	265	67	332	0.00004
SRR6145058	Veillonella atypica	39777	S	320	11	331	0.00004
SRR6145058	Acinetobacter radioresistens	40216	S	313	17	330	0.00004
SRR6145058	Brevundimonas sp. DS20	1532555	S	199	324	523	0.00006
SRR6145058	Staphylococcus lugdunensis	28035	S	312	10	322	0.00004
SRR6145058	Mycolicibacterium frederiksbergense	117567	S	231	89	320	0.00003
SRR6145058	Sphingomonas sp. NIC1	1961362	S	503	319	822	0.00009
SRR6145058	Deinococcus ficus	317577	S	316	3	319	0.00003
SRR6145058	Methylobacterium mesophilicum	39956	S	299	19	318	0.00003
SRR6145058	Aerococcus urinaeequi	51665	S	272	45	317	0.00003
SRR6145058	Pseudomonas luteola	47886	S	238	74	312	0.00003
SRR6145058	Sorangium cellulosum	56	S	303	8	311	0.00003
SRR6145058	Mycobacterium tuberculosis	1773	S	4	306	310	0.00003
SRR6145058	Paracoccus zhejiangensis	1077935	S	271	38	309	0.00003
SRR6145058	Mycobacterium grossiae	1552759	S	275	34	309	0.00003
SRR6145058	Brachybacterium faecium	43669	S	262	46	308	0.00003
SRR6145058	Streptomyces venezuelae	54571	S	270	36	306	0.00003
SRR6145058	Gordonia iterans	1004901	S	282	23	305	0.00003
SRR6145058	Acidovorax sp. JS42	232721	S	38	304	342	0.00004
SRR6145058	Acidipropionibacterium acidipropionici	1748	S	243	61	304	0.00003
SRR6145058	Staphylococcus arlettae	29378	S	284	18	302	0.00003
SRR6145058	Paracoccus pantotrophus	82367	S	267	35	302	0.00003
SRR6145058	Streptococcus koreensis	2382163	S	154	147	301	0.00003
SRR6145058	Streptococcus agalactiae	1311	S	59	242	301	0.00003
SRR6145058	Sphingomonas paucimobilis	13689	S	279	22	301	0.00003
SRR6145058	Methylobacterium sp. C1	1479019	S	103	301	404	0.00004
SRR6145058	Corynebacterium resistens	258224	S	262	38	300	0.00003
SRR6145058	Halomonas meridiana	29570	S	271	26	297	0.00003
SRR6145058	Bosea sp. ANAM02	2020412	S	1082	297	1379	0.00015
SRR6145058	Nocardia cyriacigeorgica	135487	S	253	43	296	0.00003
SRR6145058	Microbacterium hominis	162426	S	275	19	294	0.00003
SRR6145058	Staphylococcus equorum	246432	S	114	178	292	0.00003
SRR6145058	Corynebacterium doosanense	1121358	S	263	29	292	0.00003
SRR6145058	Streptococcus intermedius	1338	S	225	63	288	0.00003
SRR6145058	Ralstonia solanacearum	305	S	156	132	288	0.00003
SRR6145058	Kocuria rhizophila	72000	S	92	196	288	0.00003
SRR6145058	Acinetobacter bereziniae	106648	S	283	5	288	0.00003
SRR6145058	Aeromonas caviae	648	S	69	215	284	0.00003
SRR6145058	Paracoccus denitrificans	266	S	245	37	282	0.00003
SRR6145058	Lysobacter capsici	435897	S	243	38	281	0.00003
SRR6145058	Staphylococcus sp. M0911	2025492	S	110	278	388	0.00004
SRR6145058	Enterobacter cloacae	550	S	90	186	276	0.00003
SRR6145058	Streptococcus sp. 1643	2576376	S	494	275	769	0.00008
SRR6145058	Lactobacillus casei	1582	S	8	267	275	0.00003
SRR6145058	Brachybacterium ginsengisoli	1331682	S	233	42	275	0.00003
SRR6145058	Gordonia rubripertincta	36822	S	218	55	273	0.00003
SRR6145058	Mycolicibacterium chubuense	1800	S	234	38	272	0.00003
SRR6145058	Streptococcus phage K13	1448274	S	4	271	275	0.00003
SRR6145058	Nocardia brasiliensis	37326	S	235	36	271	0.00003
SRR6145058	Propionibacterium freudenreichii	1744	S	201	68	269	0.00003
SRR6145058	Haematobacter massiliensis	195105	S	211	55	266	0.00003
SRR6145058	Neisseria cinerea	483	S	210	54	264	0.00003
SRR6145058	Microbacterium chocolatum	84292	S	249	14	263	0.00003
SRR6145058	Mycobacterium sp. QIA-37	1561223	S	40	261	301	0.00003
SRR6145058	Kocuria sp. BT304	1702043	S	123	261	384	0.00004
SRR6145058	Acinetobacter nosocomialis	106654	S	205	55	260	0.00003
SRR6145058	Deinococcus actinosclerus	1768108	S	220	37	257	0.00003
SRR6145058	Methylobacterium aquaticum	270351	S	226	30	256	0.00003
SRR6145058	Brevundimonas sp. Bb-A	2560058	S	160	255	415	0.00005
SRR6145058	Sphingomonas koreensis	93064	S	194	57	251	0.00003
SRR6145058	Lactobacillus iners	147802	S	240	10	250	0.00003
SRR6145058	Mycolicibacterium duvalii	39688	S	217	32	249	0.00003
SRR6145058	Gordonia insulae	2420509	S	240	9	249	0.00003
SRR6145058	Brachybacterium avium	2017485	S	193	56	249	0.00003
SRR6145058	Paracoccus jeotgali	2065379	S	234	14	248	0.00003
SRR6145058	Brevundimonas sp. 'scallop'	2562582	S	352	248	600	0.00007
SRR6145058	Rhodococcus pyridinivorans	103816	S	58	189	247	0.00003
SRR6145058	Staphylococcus xylosus	1288	S	239	7	246	0.00003
SRR6145058	Ensifer adhaerens	106592	S	222	24	246	0.00003
SRR6145058	Sphingomonas taxi	1549858	S	235	9	244	0.00003
SRR6145058	Nocardia farcinica	37329	S	193	50	243	0.00003
SRR6145058	Mycobacterium avium	1764	S	137	105	242	0.00003
SRR6145058	Corynebacterium variabile	1727	S	212	30	242	0.00003
SRR6145058	Clostridium botulinum	1491	S	218	23	241	0.00003
SRR6145058	Sphingopyxis macrogoltabida	33050	S	188	51	239	0.00003
SRR6145058	Bradyrhizobium elkanii	29448	S	202	37	239	0.00003
SRR6145058	Neisseria lactamica	486	S	142	96	238	0.00003
SRR6145058	Leuconostoc pseudomesenteroides	33968	S	214	23	237	0.00003
SRR6145058	Geodermatophilus obscurus	1861	S	219	18	237	0.00003
SRR6145058	Treponema denticola	158	S	223	13	236	0.00003
SRR6145058	Mycolicibacterium parafortuitum	39692	S	210	26	236	0.00003
SRR6145058	Aeromonas hydrophila	644	S	94	142	236	0.00003
SRR6145058	Gordonia alkanivorans	84096	S	80	155	235	0.00003
SRR6145058	Mycobacterium sp. THAF192	2587868	S	61	234	295	0.00003
SRR6145058	Comamonas testosteroni	285	S	142	90	232	0.00003
SRR6145058	Prevotella scopos	589437	S	194	37	231	0.00003
SRR6145058	Neisseria gonorrhoeae	485	S	135	96	231	0.00003
SRR6145058	Frateuria aurantia	81475	S	224	7	231	0.00003
SRR6145058	Xanthomonas citri	346	S	40	190	230	0.00003
SRR6145058	Rhodococcus erythropolis	1833	S	51	178	229	0.00003
SRR6145058	Corynebacterium flavescens	28028	S	214	13	227	0.00002
SRR6145058	Chryseobacterium arthrosphaerae	651561	S	205	22	227	0.00002
SRR6145058	Brevundimonas sp. GW460-12-10-14-LB2	1827469	S	346	227	573	0.00006
SRR6145058	Mycolicibacterium fortuitum	1766	S	189	35	224	0.00002
SRR6145058	Parvimonas micra	33033	S	205	17	222	0.00002
SRR6145058	Kocuria rosea	1275	S	211	11	222	0.00002
SRR6145058	Methylobacterium durans	2202825	S	208	12	220	0.00002
SRR6145058	Brevundimonas subvibrioides	74313	S	212	8	220	0.00002
SRR6145058	Campylobacter concisus	199	S	217	2	219	0.00002
SRR6145058	Actinomyces slackii	52774	S	217	2	219	0.00002
SRR6145058	Streptomyces coelicolor	1902	S	6	212	218	0.00002
SRR6145058	Alicycliphilus denitrificans	179636	S	118	100	218	0.00002
SRR6145058	Acidipropionibacterium jensenii	1749	S	178	39	217	0.00002
SRR6145058	Cupriavidus taiwanensis	164546	S	173	43	216	0.00002
SRR6145058	Serinicoccus profundi	1078471	S	190	25	215	0.00002
SRR6145058	Corynebacterium endometrii	2488819	S	206	7	213	0.00002
SRR6145058	Brachybacterium vulturis	2017484	S	164	49	213	0.00002
SRR6145058	Sphingomonas sanxanigenens	397260	S	172	40	212	0.00002
SRR6145058	Corynebacterium frankenforstense	1230998	S	204	7	211	0.00002
SRR6145058	Stenotrophomonas acidaminiphila	128780	S	168	41	209	0.00002
SRR6145058	Modestobacter marinus	477641	S	196	13	209	0.00002
SRR6145058	Rhizobium oryzihabitans	2267833	S	24	184	208	0.00002
SRR6145058	Streptococcus viridans	78535	S	156	50	206	0.00002
SRR6145058	Rhodococcus opacus	37919	S	168	38	206	0.00002
SRR6145058	Blastococcus saxobsidens	138336	S	192	14	206	0.00002
SRR6145058	Staphylococcus pettenkoferi	170573	S	200	5	205	0.00002
SRR6145058	Ornithinimicrobium flavum	1288636	S	177	28	205	0.00002
SRR6145058	Microbacterium foliorum	104336	S	193	12	205	0.00002
SRR6145058	Chryseobacterium indologenes	253	S	182	23	205	0.00002
SRR6145058	Arthrobacter sp. NEB 688	904039	S	204	10	214	0.00002
SRR6145058	Corynebacterium urealyticum	43771	S	168	35	203	0.00002
SRR6145058	Clavibacter michiganensis	28447	S	192	11	203	0.00002
SRR6145058	Campylobacter gracilis	824	S	202	1	203	0.00002
SRR6145058	Mycolicibacterium vaccae	1810	S	180	22	202	0.00002
SRR6145058	Acidovorax avenae	80867	S	142	60	202	0.00002
SRR6145058	Sphingobacterium daejeonense	371142	S	184	17	201	0.00002
SRR6145058	Methylobacterium terrae	2202827	S	176	25	201	0.00002
SRR6145058	Klebsiella aerogenes	548	S	171	30	201	0.00002
SRR6145058	Burkholderia cenocepacia	95486	S	77	124	201	0.00002
SRR6145058	Ramlibacter tataouinensis	94132	S	186	14	200	0.00002
SRR6145058	Propionibacterium virus Pirate	1982303	S	38	200	238	0.00003
SRR6145058	Acinetobacter towneri	202956	S	105	95	200	0.00002
SRR6145058	Gordonia sp. 135	2676309	S	110	199	309	0.00003
SRR6145058	Fusobacterium hwasookii	1583098	S	157	42	199	0.00002
SRR6145058	Paracoccus mutanolyticus	1499308	S	61	137	198	0.00002
SRR6145058	Mycolicibacterium rutilum	370526	S	155	43	198	0.00002
SRR6145058	Marmoricola scoriae	642780	S	172	26	198	0.00002
SRR6145058	Azospirillum brasilense	192	S	139	59	198	0.00002
SRR6145058	Cloacibacterium normanense	237258	S	186	10	196	0.00002
SRR6145058	Methylobacterium currus	2051553	S	164	31	195	0.00002
SRR6145058	Rhizobium leguminosarum	384	S	144	50	194	0.00002
SRR6145058	Deinococcus metallilatus	1211322	S	190	4	194	0.00002
SRR6145058	Bosea sp. Tri-49	1867715	S	1425	194	1619	0.00018
SRR6145058	Pannonibacter phragmitetus	121719	S	145	48	193	0.00002
SRR6145058	Mycolicibacterium smegmatis	1772	S	153	40	193	0.00002
SRR6145058	Acinetobacter sp. DUT-2	1809055	S	94	193	287	0.00003
SRR6145058	Phycicoccus dokdonensis	443156	S	181	11	192	0.00002
SRR6145058	Streptococcus sp. I-G2	1156431	S	119	191	310	0.00003
SRR6145058	Skermanella pratensis	2233999	S	182	9	191	0.00002
SRR6145058	Defluviimonas alba	1335048	S	156	34	190	0.00002
SRR6145058	Rubrivivax gelatinosus	28068	S	163	26	189	0.00002
SRR6145058	Cupriavidus pauculus	82633	S	168	20	188	0.00002
SRR6145058	Brevundimonas sp. SGAir0440	2579977	S	719	188	907	0.00010
SRR6145058	Proteus mirabilis	584	S	161	25	186	0.00002
SRR6145058	Sphingomonas insulae	424800	S	179	6	185	0.00002
SRR6145058	Raoultella terrigena	577	S	110	74	184	0.00002
SRR6145058	Klebsiella variicola	244366	S	28	156	184	0.00002
SRR6145058	Corynebacterium halotolerans	225326	S	177	7	184	0.00002
SRR6145058	Actinomyces howellii	52771	S	182	2	184	0.00002
SRR6145058	Ottowia oryzae	2109914	S	174	9	183	0.00002
SRR6145058	Friedmanniella sagamiharensis	546874	S	174	9	183	0.00002
SRR6145058	Pantoea dispersa	59814	S	150	32	182	0.00002
SRR6145058	Nocardia terpenica	455432	S	168	13	181	0.00002
SRR6145058	Diaphorobacter sp. JS3050	2735554	S	22	181	203	0.00002
SRR6145058	Pimelobacter simplex	2045	S	151	29	180	0.00002
SRR6145058	Xanthobacter autotrophicus	280	S	150	29	179	0.00002
SRR6145058	Streptococcus sp. I-P16	1156433	S	112	178	290	0.00003
SRR6145058	Streptococcus dysgalactiae	1334	S	52	125	177	0.00002
SRR6145058	Rhizorhabdus dicambivorans	1850238	S	111	66	177	0.00002
SRR6145058	Pseudomonas nitroreducens	46680	S	128	49	177	0.00002
SRR6145058	Mycolicibacterium litorale	758802	S	140	37	177	0.00002
SRR6145058	Microbacterium oxydans	82380	S	159	18	177	0.00002
SRR6145058	Chryseobacterium shandongense	1493872	S	147	30	177	0.00002
SRR6145058	Campylobacter showae	204	S	175	2	177	0.00002
SRR6145058	Filifactor alocis	143361	S	164	12	176	0.00002
SRR6145058	Rhodococcus ruber	1830	S	157	18	175	0.00002
SRR6145058	Brevibacterium sandarakinum	629680	S	154	21	175	0.00002
SRR6145058	Agrococcus carbonis	684552	S	158	17	175	0.00002
SRR6145058	Streptomyces sp. CC0208	2306165	S	3	174	177	0.00002
SRR6145058	Rhizobium sp. S41	1869170	S	41	174	215	0.00002
SRR6145058	Micropruina glycogenica	75385	S	171	3	174	0.00002
SRR6145058	Sphaerotilus natans	34103	S	144	29	173	0.00002
SRR6145058	Streptococcus phage phiARI0460-1	1701824	S	1	172	173	0.00002
SRR6145058	Mycolicibacterium monacense	85693	S	17	155	172	0.00002
SRR6145058	Kocuria turfanensis	388357	S	162	10	172	0.00002
SRR6145058	Selenomonas sputigena	69823	S	168	2	170	0.00002
SRR6145058	Prevotella enoeca	76123	S	154	16	170	0.00002
SRR6145058	Lactobacillus brevis	1580	S	152	18	170	0.00002
SRR6145058	Streptococcus sp. HSISS1	1316410	S	6	169	175	0.00002
SRR6145058	Streptococcus sp. 116-D4	2598453	S	945	169	1114	0.00012
SRR6145058	Sphingobium cloacae	120107	S	91	78	169	0.00002
SRR6145058	Rhodococcus fascians	1828	S	146	23	169	0.00002
SRR6145058	Sphingopyxis granuli	267128	S	43	125	168	0.00002
SRR6145058	Acinetobacter sp. WCHA45	2004644	S	849	168	1017	0.00011
SRR6145058	Schaalia meyeri	52773	S	161	5	166	0.00002
SRR6145058	Phenylobacterium zucineum	284016	S	155	11	166	0.00002
SRR6145058	Nocardioides humi	449461	S	146	20	166	0.00002
SRR6145058	Corynebacterium vitaeruminis	38305	S	135	31	166	0.00002
SRR6145058	Corynebacterium stationis	1705	S	148	18	166	0.00002
SRR6145058	Leptothrix cholodnii	34029	S	139	24	163	0.00002
SRR6145058	Caulobacter flavus	1679497	S	142	21	163	0.00002
SRR6145058	Calothrix sp. NIES-2100	1954172	S	13	163	176	0.00002
SRR6145058	Stenotrophomonas rhizophila	216778	S	143	19	162	0.00002
SRR6145058	Mycolicibacterium sediminis	1286180	S	149	13	162	0.00002
SRR6145058	Corynebacterium humireducens	1223514	S	154	8	162	0.00002
SRR6145058	Anaerococcus mediterraneensis	1870984	S	143	19	162	0.00002
SRR6145058	Stenotrophomonas sp. PAMC25021	2565559	S	1	161	162	0.00002
SRR6145058	Rhizobacter gummiphilus	946333	S	146	15	161	0.00002
SRR6145058	Prevotella dentalis	52227	S	153	8	161	0.00002
SRR6145058	Paracoccus kondratievae	135740	S	147	14	161	0.00002
SRR6145058	Sinorhizobium fredii	380	S	90	70	160	0.00002
SRR6145058	Mycobacterium gallinarum	39689	S	123	37	160	0.00002
SRR6145058	Microbacterium sp. No. 7	1714373	S	160	17	177	0.00002
SRR6145058	Tessaracoccus flavescens	399497	S	148	11	159	0.00002
SRR6145058	Delftia acidovorans	80866	S	60	99	159	0.00002
SRR6145058	Streptomyces lydicus	47763	S	104	54	158	0.00002
SRR6145058	Sphingobium amiense	135719	S	81	77	158	0.00002
SRR6145058	Acinetobacter soli	487316	S	153	5	158	0.00002
SRR6145058	Nocardioides dokdonensis	450734	S	126	31	157	0.00002
SRR6145058	Methylobacterium nodulans	114616	S	152	5	157	0.00002
SRR6145058	Massilia putida	1141883	S	126	30	156	0.00002
SRR6145058	Caulobacter segnis	88688	S	128	28	156	0.00002
SRR6145058	Sphingobacterium sp. G1-14	2003121	S	147	153	300	0.00003
SRR6145058	Microbacterium sp. PAMC 28756	1795053	S	153	99	252	0.00003
SRR6145058	Lachnoanaerobaculum umeaense	617123	S	151	2	153	0.00002
SRR6145058	Kocuria flava	446860	S	145	8	153	0.00002
SRR6145058	Celeribacter indicus	1208324	S	96	56	152	0.00002
SRR6145058	Acinetobacter lactucae	1785128	S	124	28	152	0.00002
SRR6145058	Sphingomonas hengshuiensis	1609977	S	149	2	151	0.00002
SRR6145058	Dermabacter vaginalis	1630135	S	128	22	150	0.00002
SRR6145058	Corynebacterium marinum	349751	S	133	17	150	0.00002
SRR6145058	Burkholderia cepacia	292	S	78	72	150	0.00002
SRR6145058	Deinococcus geothermalis	68909	S	143	6	149	0.00002
SRR6145058	Bradyrhizobium erythrophlei	1437360	S	142	6	148	0.00002
SRR6145058	Bacteroides fragilis	817	S	133	15	148	0.00002
SRR6145058	Nocardia asteroides	1824	S	112	35	147	0.00002
SRR6145058	Enterobacter roggenkampii	1812935	S	63	84	147	0.00002
SRR6145058	Corallococcus coralloides	184914	S	141	6	147	0.00002
SRR6145058	Cnuibacter physcomitrellae	1619308	S	27	120	147	0.00002
SRR6145058	Streptococcus milleri	33040	S	71	75	146	0.00002
SRR6145058	Gordonia phthalatica	1136941	S	136	10	146	0.00002
SRR6145058	Empedobacter brevis	247	S	143	2	145	0.00002
SRR6145058	Deinococcus swuensis	1182571	S	143	2	145	0.00002
SRR6145058	Luteipulveratus mongoliensis	571913	S	143	1	144	0.00002
SRR6145058	Leptotrichia shahii	157691	S	120	24	144	0.00002
SRR6145058	Intrasporangium calvum	53358	S	140	4	144	0.00002
SRR6145058	Acidovorax carolinensis	553814	S	105	39	144	0.00002
SRR6145058	Mycolicibacterium madagascariense	212765	S	136	7	143	0.00002
SRR6145058	Lysobacter antibioticus	84531	S	127	16	143	0.00002
SRR6145058	Roseateles depolymerans	76731	S	126	16	142	0.00002
SRR6145058	Rhodococcus hoagii	43767	S	127	14	141	0.00002
SRR6145058	Mycolicibacterium chitae	1792	S	118	23	141	0.00002
SRR6145058	Mycolicibacterium arabiense	1286181	S	133	8	141	0.00002
SRR6145058	Treponema sp. OMZ 804	120683	S	140	13	153	0.00002
SRR6145058	Streptococcus phage phiARI0131-2	1701814	S	3	140	143	0.00002
SRR6145058	Mycolicibacterium goodii	134601	S	115	25	140	0.00002
SRR6145058	Saccharothrix syringae	103733	S	125	14	139	0.00002
SRR6145058	Protaetiibacter intestinalis	2419774	S	124	15	139	0.00002
SRR6145058	Nocardioides euryhalodurans	2518370	S	125	14	139	0.00002
SRR6145058	Mycolicibacterium phlei	1771	S	109	30	139	0.00002
SRR6145058	Mesorhizobium loti	381	S	44	95	139	0.00002
SRR6145058	Bradyrhizobium lablabi	722472	S	50	89	139	0.00002
SRR6145058	Staphylococcus virus IPLA7	1197953	S	10	138	148	0.00002
SRR6145058	Pseudomonas chlororaphis	587753	S	104	34	138	0.00002
SRR6145058	Novosphingobium resinovorum	158500	S	106	32	138	0.00002
SRR6145058	Mycolicibacterium tokaiense	39695	S	130	8	138	0.00002
SRR6145058	Rhodococcus rhodochrous	1829	S	109	28	137	0.00001
SRR6145058	Ezakiella massiliensis	1852374	S	122	15	137	0.00001
SRR6145058	Elizabethkingia anophelis	1117645	S	112	25	137	0.00001
SRR6145058	Prevotella fusca	589436	S	126	10	136	0.00001
SRR6145058	Paracoccus aminophilus	34003	S	130	6	136	0.00001
SRR6145058	Lysobacter gummosus	262324	S	116	20	136	0.00001
SRR6145058	Acidipropionibacterium virtanenii	2057246	S	123	13	136	0.00001
SRR6145058	Pseudomonas monteilii	76759	S	71	64	135	0.00001
SRR6145058	Mycolicibacterium rhodesiae	36814	S	108	27	135	0.00001
SRR6145058	Conexibacter woesei	191495	S	134	1	135	0.00001
SRR6145058	Neisseria polysaccharea	489	S	70	64	134	0.00001
SRR6145058	Mycolicibacterium doricum	126673	S	98	36	134	0.00001
SRR6145058	Mycolicibacterium aubagnense	319707	S	110	24	134	0.00001
SRR6145058	Aeromicrobium erythreum	2041	S	125	9	134	0.00001
SRR6145058	Pseudonocardia autotrophica	2074	S	119	13	132	0.00001
SRR6145058	Pseudomonas fragi	296	S	67	65	132	0.00001
SRR6145058	Bosea sp. F3-2	2599640	S	588	132	720	0.00008
SRR6145058	Acetobacter orientalis	146474	S	128	3	131	0.00001
SRR6145058	Streptococcus suis	1307	S	120	10	130	0.00001
SRR6145058	Humibacter sp. BT305	2282656	S	25	130	155	0.00002
SRR6145058	Dermabacter jinjuensis	1667168	S	73	57	130	0.00001
SRR6145058	Corynebacterium testudinoris	136857	S	125	5	130	0.00001
SRR6145058	Chroococcidiopsis thermalis	54299	S	124	6	130	0.00001
SRR6145058	Agrococcus jejuensis	399736	S	111	19	130	0.00001
SRR6145058	Streptococcus sobrinus	1310	S	128	1	129	0.00001
SRR6145058	Serinicoccus marinus	247333	S	99	30	129	0.00001
SRR6145058	Serinicoccus chungangensis	767452	S	113	16	129	0.00001
SRR6145058	Corynebacterium sp. ATCC 6931	1487956	S	129	61	190	0.00002
SRR6145058	[Polyangium] brachysporum	413882	S	121	7	128	0.00001
SRR6145058	Cellulosimicrobium cellulans	1710	S	66	62	128	0.00001
SRR6145058	Calothrix sp. NIES-2098	1954171	S	10	128	138	0.00002
SRR6145058	Bradyrhizobium japonicum	375	S	43	85	128	0.00001
SRR6145058	Corynebacterium phocae	161895	S	126	1	127	0.00001
SRR6145058	Corynebacterium maris	575200	S	124	3	127	0.00001
SRR6145058	Acinetobacter gyllenbergii	134534	S	123	4	127	0.00001
SRR6145058	Paraburkholderia aromaticivorans	2026199	S	111	15	126	0.00001
SRR6145058	Methylibium petroleiphilum	105560	S	69	56	125	0.00001
SRR6145058	Corynebacterium ammoniagenes	1697	S	113	12	125	0.00001
SRR6145058	Sphingobacterium sp. B29	1933220	S	128	124	252	0.00003
SRR6145058	Rhodobacteraceae bacterium	1904441	S	88	36	124	0.00001
SRR6145058	Rhodobacter blasticus	1075	S	119	5	124	0.00001
SRR6145058	Paucibacter sp. KCTC 42545	1768242	S	124	14	138	0.00002
SRR6145058	Nocardia nova	37330	S	116	8	124	0.00001
SRR6145058	Mycolicibacterium hassiacum	46351	S	88	35	123	0.00001
SRR6145058	Ralstonia pickettii	329	S	72	50	122	0.00001
SRR6145058	Pseudoxanthomonas spadix	415229	S	109	13	122	0.00001
SRR6145058	Mycolicibacterium thermoresistibile	1797	S	101	21	122	0.00001
SRR6145058	Corynebacterium efficiens	152794	S	118	4	122	0.00001
SRR6145058	Pantoea vagans	470934	S	93	28	121	0.00001
SRR6145058	Mogibacterium diversum	114527	S	113	8	121	0.00001
SRR6145058	Leifsonia xyli	1575	S	108	13	121	0.00001
SRR6145058	Bosea sp. AS-1	2015316	S	526	121	647	0.00007
SRR6145058	Acinetobacter venetianus	52133	S	112	9	121	0.00001
SRR6145058	Staphylococcus virus CNPH82	398839	S	4	120	124	0.00001
SRR6145058	Sphingobacterium hotanense	649196	S	115	5	120	0.00001
SRR6145058	Paracoccus sp. Arc7-R13	2500532	S	743	118	861	0.00009
SRR6145058	Nocardioides sp. KUDC 5002	2589074	S	118	12	130	0.00001
SRR6145058	Streptomyces hygroscopicus	1912	S	48	69	117	0.00001
SRR6145058	Streptococcus equinus	1335	S	59	58	117	0.00001
SRR6145058	Pseudomonas oleovorans	301	S	60	57	117	0.00001
SRR6145058	Pseudomonas koreensis	198620	S	96	21	117	0.00001
SRR6145058	Nocardioides seonyuensis	2518371	S	102	15	117	0.00001
SRR6145058	Nocardioides daphniae	402297	S	93	24	117	0.00001
SRR6145058	Nocardia arthritidis	228602	S	109	8	117	0.00001
SRR6145058	Microvirga ossetica	1882682	S	109	8	117	0.00001
SRR6145058	Streptomyces albus	1888	S	110	6	116	0.00001
SRR6145058	Sphingopyxis fribergensis	1515612	S	92	24	116	0.00001
SRR6145058	Rhodococcus sp. p52	935199	S	26	116	142	0.00002
SRR6145058	Mycolicibacterium boenickei	146017	S	94	22	116	0.00001
SRR6145058	Microbacterium testaceum	2033	S	111	4	115	0.00001
SRR6145058	Microbacterium sediminis	904291	S	102	13	115	0.00001
SRR6145058	Jiangella sp. DSM 45060	1798224	S	115	10	125	0.00001
SRR6145058	Actinomyces pacaensis	1852377	S	114	1	115	0.00001
SRR6145058	Paraoceanicella profunda	2579971	S	97	17	114	0.00001
SRR6145058	Nocardia mangyaensis	2213200	S	94	20	114	0.00001
SRR6145058	Actinosynnema pretiosum	42197	S	40	74	114	0.00001
SRR6145058	Actinomadura verrucosospora	46165	S	104	10	114	0.00001
SRR6145058	Streptococcus phage phiARI0131-1	1701813	S	2	113	115	0.00001
SRR6145058	Sphingomonas panacis	1560345	S	111	2	113	0.00001
SRR6145058	Nonomuraea sp. ATCC 55076	1909395	S	113	8	121	0.00001
SRR6145058	Mycolicibacterium celeriflavum	1249101	S	98	15	113	0.00001
SRR6145058	Sphingomonas sp. MM-1	745310	S	136	112	248	0.00003
SRR6145058	Pseudonocardia dioxanivorans	240495	S	104	8	112	0.00001
SRR6145058	Porphyromonas asaccharolytica	28123	S	112	0	112	0.00001
SRR6145058	Nocardia otitidiscaviarum	1823	S	102	10	112	0.00001
SRR6145058	Mycolicibacterium fallax	1793	S	87	25	112	0.00001
SRR6145058	Mycobacteroides immunogenum	83262	S	96	16	112	0.00001
SRR6145058	Friedmanniella luteola	546871	S	108	4	112	0.00001
SRR6145058	Asticcacaulis excentricus	78587	S	111	1	112	0.00001
SRR6145058	Methylobacterium sp. DM1	2067957	S	58	111	169	0.00002
SRR6145058	Salipiger profundus	1229727	S	74	36	110	0.00001
SRR6145058	Microterricola viridarii	412690	S	103	7	110	0.00001
SRR6145058	Erythrobacter flavus	192812	S	68	42	110	0.00001
SRR6145058	Mycolicibacterium moriokaense	39691	S	103	6	109	0.00001
SRR6145058	Microlunatus phosphovorus	29405	S	108	1	109	0.00001
SRR6145058	Caulobacter rhizosphaerae	2010972	S	89	20	109	0.00001
SRR6145058	Burkholderia gladioli	28095	S	98	11	109	0.00001
SRR6145058	Bifidobacterium adolescentis	1680	S	102	7	109	0.00001
SRR6145058	Staphylococcus vitulinus	71237	S	106	2	108	0.00001
SRR6145058	Saccharopolyspora erythraea	1836	S	101	7	108	0.00001
SRR6145058	Rhizobium rhizoryzae	451876	S	101	7	108	0.00001
SRR6145058	Nocardia seriolae	37332	S	89	19	108	0.00001
SRR6145058	Sphingobium sp. LF-16	2185111	S	10	107	117	0.00001
SRR6145058	Rhodovulum sulfidophilum	35806	S	81	26	107	0.00001
SRR6145058	Paraburkholderia caffeinilytica	1761016	S	100	7	107	0.00001
SRR6145058	Mycolicibacterium alvei	67081	S	83	24	107	0.00001
SRR6145058	Croceicoccus naphthovorans	1348774	S	52	55	107	0.00001
SRR6145058	Citrobacter freundii	546	S	24	83	107	0.00001
SRR6145058	Capnocytophaga ochracea	1018	S	69	38	107	0.00001
SRR6145058	Sphingopyxis lindanitolerans	2054227	S	81	25	106	0.00001
SRR6145058	Rhodococcus qingshengii	334542	S	15	91	106	0.00001
SRR6145058	Pulveribacter suum	2116657	S	94	12	106	0.00001
SRR6145058	Pseudonocardia sp. EC080610-09	1688404	S	1	106	107	0.00001
SRR6145058	Lysobacter soli	453783	S	100	6	106	0.00001
SRR6145058	Lentzea guizhouensis	1586287	S	100	6	106	0.00001
SRR6145058	Burkholderia pseudomallei	28450	S	41	65	106	0.00001
SRR6145058	Auraticoccus monumenti	675864	S	105	1	106	0.00001
SRR6145058	Aeromicrobium choanae	1736691	S	99	7	106	0.00001
SRR6145058	[Eubacterium] sulci	143393	S	103	2	105	0.00001
SRR6145058	Novosphingobium pentaromativorans	205844	S	46	59	105	0.00001
SRR6145058	Caulobacter vibrioides	155892	S	81	24	105	0.00001
SRR6145058	Amycolatopsis methanolica	1814	S	95	10	105	0.00001
SRR6145058	Acidovorax citrulli	80869	S	65	40	105	0.00001
SRR6145058	Rhodococcus sp. NJ-530	2490853	S	18	104	122	0.00001
SRR6145058	Klebsiella quasipneumoniae	1463165	S	24	80	104	0.00001
SRR6145058	Treponema sp. OMZ 838	1539298	S	103	9	112	0.00001
SRR6145058	Deinococcus proteolyticus	55148	S	102	1	103	0.00001
SRR6145058	Bosea sp. RAC05	1842539	S	475	103	578	0.00006
SRR6145058	Azospirillum lipoferum	193	S	76	27	103	0.00001
SRR6145058	Tessaracoccus aquimaris	1332264	S	97	5	102	0.00001
SRR6145058	Rhodoferax koreense	1842727	S	87	15	102	0.00001
SRR6145058	Bacillus megaterium	1404	S	82	20	102	0.00001
SRR6145058	Azorhizobium caulinodans	7	S	94	8	102	0.00001
SRR6145058	Sphingobium sp. RSMS	520734	S	35	101	136	0.00001
SRR6145058	Faecalibacterium prausnitzii	853	S	81	20	101	0.00001
SRR6145058	Corynebacterium ulcerans	65058	S	95	6	101	0.00001
SRR6145058	Alcaligenes faecalis	511	S	91	10	101	0.00001
SRR6145058	Variovorax boronicumulans	436515	S	61	39	100	0.00001
SRR6145058	Dermabacter hominis	36740	S	61	39	100	0.00001
SRR6145058	Xanthomonas translucens	343	S	90	9	99	0.00001
SRR6145058	Acinetobacter sp. ACNIH1	1636603	S	449	99	548	0.00006
SRR6145058	Tessaracoccus timonensis	2161816	S	93	5	98	0.00001
SRR6145058	Lysobacter lycopersici	1324796	S	93	5	98	0.00001
SRR6145058	Gluconobacter oxydans	442	S	60	38	98	0.00001
SRR6145058	Baekduia soli	496014	S	98	0	98	0.00001
SRR6145058	Mycolicibacterium confluentis	28047	S	92	5	97	0.00001
SRR6145058	Mycobacterium chimaera	222805	S	53	44	97	0.00001
SRR6145058	Methylobacterium oryzae	334852	S	9	88	97	0.00001
SRR6145058	Cupriavidus gilardii	82541	S	69	28	97	0.00001
SRR6145058	Corynebacterium pelargi	1471400	S	84	13	97	0.00001
SRR6145058	Achromobacter denitrificans	32002	S	66	31	97	0.00001
SRR6145058	Streptococcus periodonticum	2490633	S	44	52	96	0.00001
SRR6145058	Sphingomonas wittichii	160791	S	74	22	96	0.00001
SRR6145058	Parascardovia denticolens	78258	S	96	0	96	0.00001
SRR6145058	Nocardiopsis dassonvillei	2014	S	90	6	96	0.00001
SRR6145058	Glutamicibacter creatinolyticus	162496	S	95	1	96	0.00001
SRR6145058	Enterococcus faecalis	1351	S	86	10	96	0.00001
SRR6145058	Corynebacterium sphenisci	191493	S	94	2	96	0.00001
SRR6145058	Corynebacterium nuruki	1032851	S	93	3	96	0.00001
SRR6145058	Comamonas serinivorans	1082851	S	88	8	96	0.00001
SRR6145058	Brevibacterium siliguriense	1136497	S	79	17	96	0.00001
SRR6145058	Sphingomonas indica	941907	S	93	2	95	0.00001
SRR6145058	Sphingobacterium mizutaii	1010	S	93	2	95	0.00001
SRR6145058	Pluralibacter gergoviae	61647	S	90	5	95	0.00001
SRR6145058	Lactobacillus paracasei	1597	S	25	70	95	0.00001
SRR6145058	Corynebacterium uterequi	1072256	S	93	2	95	0.00001
SRR6145058	Corynebacterium glyciniphilum	1404244	S	94	1	95	0.00001
SRR6145058	Bradyrhizobium sp.	376	S	29	66	95	0.00001
SRR6145058	Ochrobactrum anthropi	529	S	64	30	94	0.00001
SRR6145058	Inhella inkyongensis	392593	S	86	8	94	0.00001
SRR6145058	Pseudomonas simiae	321846	S	82	11	93	0.00001
SRR6145058	Methylobacterium phyllosphaerae	418223	S	33	60	93	0.00001
SRR6145058	Lysobacter maris	1605891	S	86	7	93	0.00001
SRR6145058	Luteimonas yindakuii	2565782	S	84	9	93	0.00001
SRR6145058	Enterobacter kobei	208224	S	18	75	93	0.00001
SRR6145058	Cupriavidus metallidurans	119219	S	65	28	93	0.00001
SRR6145058	Corynebacterium callunae	1721	S	83	10	93	0.00001
SRR6145058	Actinoplanes teichomyceticus	1867	S	84	9	93	0.00001
SRR6145058	Actinomyces qiguomingii	2057800	S	92	1	93	0.00001
SRR6145058	Tabrizicola piscis	2494374	S	89	3	92	0.00001
SRR6145058	Pasteurella multocida	747	S	71	21	92	0.00001
SRR6145058	Lactobacillus plantarum	1590	S	29	63	92	0.00001
SRR6145058	Kineococcus radiotolerans	131568	S	90	2	92	0.00001
SRR6145058	Diaphorobacter polyhydroxybutyrativorans	1546149	S	18	74	92	0.00001
SRR6145058	Bradyrhizobium diazoefficiens	1355477	S	28	64	92	0.00001
SRR6145058	Sinomonas atrocyanea	37927	S	90	1	91	0.00001
SRR6145058	Pseudomonas psychrotolerans	237610	S	89	2	91	0.00001
SRR6145058	Mycolicibacterium anyangense	1431246	S	85	6	91	0.00001
SRR6145058	Kribbella flavida	182640	S	89	2	91	0.00001
SRR6145058	Kibdelosporangium phytohabitans	860235	S	88	3	91	0.00001
SRR6145058	Jiangella alkaliphila	419479	S	84	7	91	0.00001
SRR6145058	Burkholderia multivorans	87883	S	71	20	91	0.00001
SRR6145058	Rathayibacter festucae	110937	S	50	40	90	0.00001
SRR6145058	Propionibacterium virus ATCC29399BT	1982253	S	49	90	139	0.00002
SRR6145058	Frankia inefficax	298654	S	89	1	90	0.00001
SRR6145058	Burkholderia thailandensis	57975	S	20	70	90	0.00001
SRR6145058	Amycolatopsis keratiniphila	129921	S	51	39	90	0.00001
SRR6145058	Actinoplanes missouriensis	1866	S	82	8	90	0.00001
SRR6145058	Acinetobacter sp. NEB149	2725684	S	51	90	141	0.00002
SRR6145058	Raoultella ornithinolytica	54291	S	19	70	89	0.00001
SRR6145058	Phytohabitans suffuscus	624315	S	82	7	89	0.00001
SRR6145058	Micromonospora aurantiaca	47850	S	19	70	89	0.00001
SRR6145058	Erythrobacter litoralis	39960	S	64	25	89	0.00001
SRR6145058	Corynebacterium renale	1724	S	88	1	89	0.00001
SRR6145058	Starkeya novella	921	S	71	17	88	0.00001
SRR6145058	Rubrobacter sp. SCSIO 52915	2653852	S	88	2	90	0.00001
SRR6145058	Rhodococcus coprophilus	38310	S	85	3	88	0.00001
SRR6145058	Mycolicibacterium insubricum	444597	S	74	14	88	0.00001
SRR6145058	Minicystis rosea	888845	S	87	1	88	0.00001
SRR6145058	Chryseobacterium indoltheticum	254	S	80	8	88	0.00001
SRR6145058	Azospirillum sp. CFH 70021	2202148	S	88	9	97	0.00001
SRR6145058	Amycolatopsis albispora	1804986	S	64	24	88	0.00001
SRR6145058	Streptococcus pseudoporcinus	361101	S	36	51	87	0.00001
SRR6145058	Mycobacterium paragordonae	1389713	S	86	1	87	0.00001
SRR6145058	Bifidobacterium longum	216816	S	68	19	87	0.00001
SRR6145058	Beijerinckiaceae bacterium RH AL1	2572036	S	87	11	98	0.00001
SRR6145058	Allokutzneria albata	211114	S	82	5	87	0.00001
SRR6145058	Acinetobacter dispersus	70348	S	85	2	87	0.00001
SRR6145058	Streptococcus sp. LPB0220	2610896	S	243	86	329	0.00004
SRR6145058	Saccharothrix espanaensis	103731	S	78	8	86	0.00001
SRR6145058	Propionibacterium phage PHL082M00	1500808	S	1	86	87	0.00001
SRR6145058	Sphingobium hydrophobicum	1673076	S	54	31	85	0.00001
SRR6145058	Corynebacterium aquilae	203263	S	84	1	85	0.00001
SRR6145058	Chryseobacterium carnipullorum	1124835	S	73	12	85	0.00001
SRR6145058	Tessaracoccus flavus	1610493	S	80	4	84	0.00001
SRR6145058	Sphingobium baderi	1332080	S	48	36	84	0.00001
SRR6145058	Qipengyuania sediminis	1532023	S	81	3	84	0.00001
SRR6145058	Phreatobacter cathodiphilus	1868589	S	79	5	84	0.00001
SRR6145058	Isoptericola dokdonensis	372663	S	78	6	84	0.00001
SRR6145058	Capnocytophaga sp. FDAARGOS_737	2545799	S	363	84	447	0.00005
SRR6145058	Bradyrhizobium ottawaense	931866	S	9	75	84	0.00001
SRR6145058	Achromobacter spanius	217203	S	72	12	84	0.00001
SRR6145058	Marinovum algicola	42444	S	62	21	83	0.00001
SRR6145058	Bacillus subtilis	1423	S	26	57	83	0.00001
SRR6145058	Atopobium parvulum	1382	S	83	0	83	0.00001
SRR6145058	Streptosporangium roseum	2001	S	77	5	82	0.00001
SRR6145058	Sphingomonas sp. FARSPH	2219696	S	259	82	341	0.00004
SRR6145058	Roseovarius indicus	540747	S	61	21	82	0.00001
SRR6145058	Rhizobium phaseoli	396	S	31	51	82	0.00001
SRR6145058	Chryseobacterium balustinum	246	S	71	11	82	0.00001
SRR6145058	Campylobacter rectus	203	S	81	1	82	0.00001
SRR6145058	Burkholderia lata	482957	S	54	28	82	0.00001
SRR6145058	Enterobacter asburiae	61645	S	28	53	81	0.00001
SRR6145058	Corynebacterium pseudopelargi	2080757	S	69	12	81	0.00001
SRR6145058	Corynebacterium atypicum	191610	S	76	5	81	0.00001
SRR6145058	Bradyrhizobium guangzhouense	1325095	S	59	22	81	0.00001
SRR6145058	Actinomyces israelii	1659	S	80	1	81	0.00001
SRR6145058	Streptomyces sp. RLB1-9	2594454	S	2	80	82	0.00001
SRR6145058	Streptomyces niveus	193462	S	72	8	80	0.00001
SRR6145058	Mycolicibacterium sarraceniae	1534348	S	72	8	80	0.00001
SRR6145058	Chryseobacterium sp.	1871047	S	73	7	80	0.00001
SRR6145058	Actinomadura amylolytica	1411117	S	71	9	80	0.00001
SRR6145058	Tardibacter chloracetimidivorans	1921510	S	47	32	79	0.00001
SRR6145058	Streptomyces chartreusis	1969	S	67	12	79	0.00001
SRR6145058	Rickettsia felis	42862	S	70	9	79	0.00001
SRR6145058	Novosphingobium aromaticivorans	48935	S	68	11	79	0.00001
SRR6145058	Leclercia adecarboxylata	83655	S	40	39	79	0.00001
SRR6145058	Hydrogenophaga sp. NH-16	2184519	S	71	79	150	0.00002
SRR6145058	Herbaspirillum huttiense	863372	S	64	15	79	0.00001
SRR6145058	Fusobacterium periodonticum	860	S	42	37	79	0.00001
SRR6145058	Caulobacter mirabilis	69666	S	75	4	79	0.00001
SRR6145058	Beutenbergia cavernae	84757	S	78	1	79	0.00001
SRR6145058	Tatumella ptyseos	82987	S	76	2	78	0.00001
SRR6145058	Streptococcus sp. FDAARGOS_192	1839799	S	47	78	125	0.00001
SRR6145058	Rhodobacter capsulatus	1061	S	65	13	78	0.00001
SRR6145058	Pelagibaca abyssi	1250539	S	56	22	78	0.00001
SRR6145058	Gemmatirosa kalamazoonesis	861299	S	78	0	78	0.00001
SRR6145058	Dinoroseobacter shibae	215813	S	54	24	78	0.00001
SRR6145058	Chryseobacterium carnis	1241979	S	73	5	78	0.00001
SRR6145058	Agromyces aureus	453304	S	70	8	78	0.00001
SRR6145058	Neisseria chenwenguii	1853278	S	76	1	77	0.00001
SRR6145058	Mycolicibacterium pulveris	36813	S	70	7	77	0.00001
SRR6145058	Campylobacter ureolyticus	827	S	75	2	77	0.00001
SRR6145058	Brochothrix thermosphacta	2756	S	75	2	77	0.00001
SRR6145058	Actinomyces gaoshouyii	1960083	S	75	2	77	0.00001
SRR6145058	Xylophilus sp. KACC 21265	2697032	S	76	12	88	0.00001
SRR6145058	Sinorhizobium meliloti	382	S	62	14	76	0.00001
SRR6145058	Rubrobacter sp. SCSIO 52909	2653851	S	76	1	77	0.00001
SRR6145058	Pseudarthrobacter phenanthrenivorans	361575	S	70	6	76	0.00001
SRR6145058	Microlunatus soli	630515	S	74	2	76	0.00001
SRR6145058	Bradyrhizobium guangdongense	1325090	S	49	27	76	0.00001
SRR6145058	Acidovorax ebreus	721785	S	11	65	76	0.00001
SRR6145058	Streptococcus sp. FDAARGOS_520	2420308	S	1	75	76	0.00001
SRR6145058	Streptococcus equi	1336	S	72	3	75	0.00001
SRR6145058	Propionibacterium virus PHL071N05	1982280	S	69	75	144	0.00002
SRR6145058	Microbacterium sp. TPU 3598	1938334	S	75	6	81	0.00001
SRR6145058	Cupriavidus necator	106590	S	64	11	75	0.00001
SRR6145058	Corynebacterium argentoratense	42817	S	73	2	75	0.00001
SRR6145058	Streptomyces tsukubensis	83656	S	70	4	74	0.00001
SRR6145058	Sanguibacter keddieii	60920	S	72	2	74	0.00001
SRR6145058	Mycolicibacterium helvum	1534349	S	67	7	74	0.00001
SRR6145058	Lactobacillus delbrueckii	1584	S	68	6	74	0.00001
SRR6145058	Cupriavidus oxalaticus	96344	S	62	12	74	0.00001
SRR6145058	Corynebacterium deserti	1408191	S	65	9	74	0.00001
SRR6145058	Rhodococcus sp. BH4	1807790	S	12	73	85	0.00001
SRR6145058	Pseudomonas sp. 02C 26	2054914	S	73	2	75	0.00001
SRR6145058	Phytohabitans flavus	1076124	S	68	5	73	0.00001
SRR6145058	Mycobacterium conspicuum	44010	S	72	1	73	0.00001
SRR6145058	Mameliella alba	561184	S	62	11	73	0.00001
SRR6145058	Haemophilus pittmaniae	249188	S	71	2	73	0.00001
SRR6145058	Corynebacterium lactis	1231000	S	72	1	73	0.00001
SRR6145058	Cellulomonas shaoxiangyii	2566013	S	64	9	73	0.00001
SRR6145058	Streptomyces griseorubiginosus	67304	S	63	9	72	0.00001
SRR6145058	Streptomyces bingchenggensis	379067	S	69	3	72	0.00001
SRR6145058	Streptococcus sp. HSISM1	1316408	S	214	72	286	0.00003
SRR6145058	Pseudomonas sp. BJP69	2597770	S	45	72	117	0.00001
SRR6145058	Microbacterium oleivorans	273677	S	69	3	72	0.00001
SRR6145058	Kitasatospora setae	2066	S	69	3	72	0.00001
SRR6145058	Hydrogenophilus thermoluteolus	297	S	71	1	72	0.00001
SRR6145058	Croceicoccus marinus	450378	S	51	21	72	0.00001
SRR6145058	Corynebacterium cystitidis	35757	S	72	0	72	0.00001
SRR6145058	Chryseobacterium sp. NBC 122	2547600	S	72	1	73	0.00001
SRR6145058	Brevibacterium sp. YB235	1496080	S	94	72	166	0.00002
SRR6145058	Acidovorax sp. T1	1858609	S	62	72	134	0.00001
SRR6145058	Porphyrobacter neustonensis	1112	S	63	8	71	0.00001
SRR6145058	Polymorphum gilvum	991904	S	65	6	71	0.00001
SRR6145058	Mycolicibacterium aichiense	1799	S	55	16	71	0.00001
SRR6145058	Mycobacterium parmense	185642	S	67	4	71	0.00001
SRR6145058	Mycobacterium branderi	43348	S	69	2	71	0.00001
SRR6145058	Kutzneria albida	43357	S	68	3	71	0.00001
SRR6145058	Corynebacterium epidermidicanis	1050174	S	69	2	71	0.00001
SRR6145058	Achromobacter insolitus	217204	S	63	8	71	0.00001
SRR6145058	Yangia pacifica	311180	S	60	10	70	0.00001
SRR6145058	Streptomyces cattleya	29303	S	67	3	70	0.00001
SRR6145058	Sphingosinicella microcystinivorans	335406	S	69	1	70	0.00001
SRR6145058	Sandaracinus amylolyticus	927083	S	70	0	70	0.00001
SRR6145058	Propionibacterium phage PHL085N00	1500812	S	3	70	73	0.00001
SRR6145058	Porphyrobacter sp. CACIAM 03H1	2003315	S	70	13	83	0.00001
SRR6145058	Phreatobacter stygius	1940610	S	68	2	70	0.00001
SRR6145058	Neorhizobium galegae	399	S	66	4	70	0.00001
SRR6145058	Cellulomonas fimi	1708	S	59	11	70	0.00001
SRR6145058	Arthrobacter crystallopoietes	37928	S	69	1	70	0.00001
SRR6145058	Streptomyces sp. VN1	1821625	S	13	69	82	0.00001
SRR6145058	Streptomyces sp. S1D4-23	2594463	S	2	69	71	0.00001
SRR6145058	Streptomyces griseus	1911	S	53	16	69	0.00001
SRR6145058	Sphingopyxis alaskensis	117207	S	63	6	69	0.00001
SRR6145058	Mycobacterium kansasii	1768	S	67	2	69	0.00001
SRR6145058	Massilia violaceinigra	2045208	S	65	4	69	0.00001
SRR6145058	Hydrogenophaga pseudoflava	47421	S	39	30	69	0.00001
SRR6145058	Elizabethkingia bruuniana	1756149	S	25	44	69	0.00001
SRR6145058	Deinococcus deserti	310783	S	69	0	69	0.00001
SRR6145058	Corynebacterium terpenotabidum	89154	S	65	4	69	0.00001
SRR6145058	Catenulispora acidiphila	304895	S	69	0	69	0.00001
SRR6145058	Xanthomonas sacchari	56458	S	61	7	68	0.00001
SRR6145058	Serpentinomonas mccroryi	1458426	S	62	6	68	0.00001
SRR6145058	Pantoea agglomerans	549	S	62	6	68	0.00001
SRR6145058	Mycobacterium florentinum	292462	S	60	8	68	0.00001
SRR6145058	Microbacterium pygmaeum	370764	S	67	1	68	0.00001
SRR6145058	Chryseobacterium antarcticum	266748	S	67	1	68	0.00001
SRR6145058	Cellulomonas gilvus	11	S	60	8	68	0.00001
SRR6145058	Aquisphaera giovannonii	406548	S	67	1	68	0.00001
SRR6145058	Aeromonas veronii	654	S	58	10	68	0.00001
SRR6145058	Xylanimonas allomyrinae	2509459	S	59	8	67	0.00001
SRR6145058	Pseudomonas syringae	317	S	33	34	67	0.00001
SRR6145058	Pseudomonas sp. FDAARGOS_380	2018067	S	106	67	173	0.00002
SRR6145058	Massilia umbonata	864828	S	54	13	67	0.00001
SRR6145058	Labrys neptuniae	376174	S	65	2	67	0.00001
SRR6145058	Halovulum dunhuangense	1505036	S	64	3	67	0.00001
SRR6145058	Chryseobacterium bernardetii	1241978	S	54	13	67	0.00001
SRR6145058	Burkholderia contaminans	488447	S	45	22	67	0.00001
SRR6145058	Bradyrhizobium guangxiense	1325115	S	48	19	67	0.00001
SRR6145058	Actinoplanes friuliensis	196914	S	65	2	67	0.00001
SRR6145058	Tistrella mobilis	171437	S	58	8	66	0.00001
SRR6145058	Sulfitobacter pseudonitzschiae	1402135	S	53	13	66	0.00001
SRR6145058	Pseudomonas sp. phDV1	253237	S	39	66	105	0.00001
SRR6145058	Myxococcus xanthus	34	S	52	14	66	0.00001
SRR6145058	Mycobacterium stomatepiae	470076	S	57	9	66	0.00001
SRR6145058	Mycobacterium simiae	1784	S	65	1	66	0.00001
SRR6145058	Micromonospora narathiwatensis	299146	S	57	9	66	0.00001
SRR6145058	Microcella alkaliphila	279828	S	63	3	66	0.00001
SRR6145058	Microbacterium lemovicicum	1072463	S	63	3	66	0.00001
SRR6145058	Leuconostoc suionicum	1511761	S	57	9	66	0.00001
SRR6145058	Leucobacter triazinivorans	1784719	S	62	4	66	0.00001
SRR6145058	Buchnera aphidicola	9	S	67	-1	66	0.00001
SRR6145058	Aeromicrobium marinum	219314	S	62	4	66	0.00001
SRR6145058	Streptomyces griseoviridis	45398	S	59	6	65	0.00001
SRR6145058	Stella humosa	94	S	64	1	65	0.00001
SRR6145058	Pseudomonas otitidis	319939	S	64	1	65	0.00001
SRR6145058	Microbacterium protaetiae	2509458	S	62	3	65	0.00001
SRR6145058	Hylemonella gracilis	80880	S	63	2	65	0.00001
SRR6145058	Enterococcus faecium	1352	S	48	17	65	0.00001
SRR6145058	Deinococcus puniceus	1182568	S	65	0	65	0.00001
SRR6145058	Aeromonas sp. ASNIH5	1758179	S	14	65	79	0.00001
SRR6145058	Streptomyces viridifaciens	48665	S	12	52	64	0.00001
SRR6145058	Streptomyces spectabilis	68270	S	55	9	64	0.00001
SRR6145058	Staphylococcus simulans	1286	S	62	2	64	0.00001
SRR6145058	Rhodoferax sediminis	2509614	S	62	2	64	0.00001
SRR6145058	Pseudonocardia sp. EC080625-04	1096868	S	2	64	66	0.00001
SRR6145058	Mycobacterium intracellulare	1767	S	24	40	64	0.00001
SRR6145058	Micromonospora sp. L5	648999	S	11	64	75	0.00001
SRR6145058	Deinococcus maricopensis	309887	S	64	0	64	0.00001
SRR6145058	Brevirhabdus pacifica	1267768	S	46	18	64	0.00001
SRR6145058	Bradyrhizobium oligotrophicum	44255	S	59	5	64	0.00001
SRR6145058	Bradyrhizobium betae	244734	S	45	19	64	0.00001
SRR6145058	Amycolatopsis orientalis	31958	S	52	12	64	0.00001
SRR6145058	Aggregatibacter actinomycetemcomitans	714	S	54	10	64	0.00001
SRR6145058	Acetobacter senegalensis	446692	S	46	18	64	0.00001
SRR6145058	Streptococcus sp. A12	1759399	S	253	63	316	0.00003
SRR6145058	Streptacidiphilus bronchialis	2126346	S	61	2	63	0.00001
SRR6145058	Silicimonas algicola	1826607	S	62	1	63	0.00001
SRR6145058	Rhodococcus sp. 2G	1570939	S	19	63	82	0.00001
SRR6145058	Mycobacterium saskatchewanense	220927	S	61	2	63	0.00001
SRR6145058	Lachnospiraceae bacterium	1898203	S	4	59	63	0.00001
SRR6145058	Herbaspirillum seropedicae	964	S	52	11	63	0.00001
SRR6145058	Chryseobacterium glaciei	1685010	S	58	5	63	0.00001
SRR6145058	Chelatococcus daeguensis	444444	S	47	16	63	0.00001
SRR6145058	Carnobacterium maltaromaticum	2751	S	59	4	63	0.00001
SRR6145058	Bordetella bronchiseptica	518	S	12	51	63	0.00001
SRR6145058	Agromyces protaetiae	2509455	S	57	6	63	0.00001
SRR6145058	Aerosticca soli	2010829	S	45	18	63	0.00001
SRR6145058	Acinetobacter wuhouensis	1879050	S	56	7	63	0.00001
SRR6145058	Acidovorax sp. KKS102	358220	S	202	63	265	0.00003
SRR6145058	Veillonella rodentium	248315	S	61	1	62	0.00001
SRR6145058	Pseudomonas plecoglossicida	70775	S	30	32	62	0.00001
SRR6145058	Paenarthrobacter aurescens	43663	S	15	47	62	0.00001
SRR6145058	Mycobacterium cookii	1775	S	61	1	62	0.00001
SRR6145058	Meiothermus silvanus	52022	S	62	0	62	0.00001
SRR6145058	Macrococcus caseolyticus	69966	S	56	6	62	0.00001
SRR6145058	Lactobacillus salivarius	1624	S	59	3	62	0.00001
SRR6145058	Dokdonella koreensis	323415	S	61	1	62	0.00001
SRR6145058	Cystobacter fuscus	43	S	54	8	62	0.00001
SRR6145058	Cellulomonas flavigena	1711	S	55	7	62	0.00001
SRR6145058	Azospirillum thiophilum	528244	S	52	10	62	0.00001
SRR6145058	Actinoalloteichus hoggarensis	1470176	S	60	2	62	0.00001
SRR6145058	Variovorax sp. PAMC 28711	1795631	S	61	3	64	0.00001
SRR6145058	Staphylococcus argenteus	985002	S	10	51	61	0.00001
SRR6145058	Mycolicibacillus koreensis	1069220	S	54	7	61	0.00001
SRR6145058	Micromonospora echinaurantiaca	47857	S	52	9	61	0.00001
SRR6145058	Mesorhizobium oceanicum	1670800	S	56	5	61	0.00001
SRR6145058	Iamiaceae bacterium SCSIO 58843	2664374	S	61	0	61	0.00001
SRR6145058	Curtobacterium pusillum	69373	S	50	11	61	0.00001
SRR6145058	Corynebacterium provencense	1737425	S	59	2	61	0.00001
SRR6145058	Anaeromyxobacter dehalogenans	161493	S	45	16	61	0.00001
SRR6145058	Acinetobacter sp. SWBY1	2079596	S	62	61	123	0.00001
SRR6145058	Staphylococcus virus PH15	399185	S	5	60	65	0.00001
SRR6145058	Schaalia cardiffensis	181487	S	59	1	60	0.00001
SRR6145058	Rhodospirillum centenum	34018	S	55	5	60	0.00001
SRR6145058	Rhodococcus sp. AQ5-07	2054902	S	14	60	74	0.00001
SRR6145058	Pseudomonas entomophila	312306	S	56	4	60	0.00001
SRR6145058	Mixta calida	665913	S	44	16	60	0.00001
SRR6145058	Leifsonia sp. 21MFCrub1.1	1798223	S	44	60	104	0.00001
SRR6145058	Isoptericola variabilis	139208	S	54	6	60	0.00001
SRR6145058	Dechlorosoma suillum	146939	S	31	29	60	0.00001
SRR6145058	Chryseobacterium nakagawai	1241982	S	38	22	60	0.00001
SRR6145058	Bacillus thuringiensis	1428	S	32	28	60	0.00001
SRR6145058	Actinopolymorpha singaporensis	117157	S	60	0	60	0.00001
SRR6145058	Actinoplanes derwentensis	113562	S	58	2	60	0.00001
SRR6145058	Acinetobacter sp. WCHA55	2004646	S	193	60	253	0.00003
SRR6145058	Streptomyces sp. SCSIO 03032	1109743	S	59	1	60	0.00001
SRR6145058	Sphingobium chlorophenolicum	46429	S	47	12	59	0.00001
SRR6145058	Paracoccus sp. AK26	2589076	S	846	59	905	0.00010
SRR6145058	Nocardiopsis gilva	280236	S	56	3	59	0.00001
SRR6145058	Microbacterium wangchenii	2541726	S	56	3	59	0.00001
SRR6145058	Luteimicrobium xylanilyticum	1133546	S	58	1	59	0.00001
SRR6145058	Leucobacter sp. DSM 101948	1935379	S	59	3	62	0.00001
SRR6145058	Comamonas thiooxydans	363952	S	30	29	59	0.00001
SRR6145058	Clostridium tetani	1513	S	45	14	59	0.00001
SRR6145058	Chryseobacterium jeonii	266749	S	59	0	59	0.00001
SRR6145058	Bradyrhizobium paxllaeri	190148	S	53	6	59	0.00001
SRR6145058	Amycolatopsis sp. YIM 10	2653857	S	59	9	68	0.00001
SRR6145058	Rhizobium sp. Y9	1914541	S	20	58	78	0.00001
SRR6145058	Microbacterium oryzae	743009	S	55	3	58	0.00001
SRR6145058	Lysobacter alkalisoli	2591633	S	55	3	58	0.00001
SRR6145058	Lysinimonas sp. KACC 19322	2592654	S	58	6	64	0.00001
SRR6145058	Luteimonas sp. YGD11-2	2508168	S	454	58	512	0.00006
SRR6145058	Hartmannibacter diazotrophicus	1482074	S	54	4	58	0.00001
SRR6145058	Halomonas sp. JS92-SW72	2306583	S	132	58	190	0.00002
SRR6145058	Deinococcus irradiatisoli	2202254	S	58	0	58	0.00001
SRR6145058	Cupriavidus campinensis	151783	S	49	9	58	0.00001
SRR6145058	Chryseobacterium sp. NEB161	2724619	S	235	58	293	0.00003
SRR6145058	Chryseobacterium gallinarum	1324352	S	55	3	58	0.00001
SRR6145058	Chryseobacterium aureum	2497456	S	55	3	58	0.00001
SRR6145058	Celeribacter manganoxidans	1411902	S	50	8	58	0.00001
SRR6145058	Ancylobacter pratisalsi	1745854	S	52	6	58	0.00001
SRR6145058	Xenorhabdus nematophila	628	S	3	54	57	0.00001
SRR6145058	Streptomyces sp. RLB3-17	2594455	S	6	57	63	0.00001
SRR6145058	Streptomyces sampsonii	42239	S	6	51	57	0.00001
SRR6145058	Streptomyces lincolnensis	1915	S	51	6	57	0.00001
SRR6145058	Streptococcus phage phiARI0746	1701837	S	1	57	58	0.00001
SRR6145058	Staphylococcus virus IPLA5	1197952	S	4	57	61	0.00001
SRR6145058	Riemerella anatipestifer	34085	S	52	5	57	0.00001
SRR6145058	Rhizobium sp. IRBG74	424182	S	16	57	73	0.00001
SRR6145058	Neisseria animalis	492	S	56	1	57	0.00001
SRR6145058	Micromonospora krabiensis	307121	S	52	5	57	0.00001
SRR6145058	Hypericibacter adhaerens	2602016	S	53	4	57	0.00001
SRR6145058	Devosia ginsengisoli	400770	S	53	4	57	0.00001
SRR6145058	Curtobacterium flaccumfaciens	2035	S	50	7	57	0.00001
SRR6145058	Clostridioides difficile	1496	S	32	25	57	0.00001
SRR6145058	Caulobacter henricii	69395	S	52	5	57	0.00001
SRR6145058	Blastochloris tepida	2233851	S	48	9	57	0.00001
SRR6145058	Agromyces flavus	589382	S	52	5	57	0.00001
SRR6145058	Streptomyces rimosus	1927	S	53	3	56	0.00001
SRR6145058	Streptomyces globosus	68209	S	51	5	56	0.00001
SRR6145058	Stenotrophomonas sp. ASS1	2282124	S	42	56	98	0.00001
SRR6145058	Pseudomonas multiresinivorans	95301	S	45	11	56	0.00001
SRR6145058	Mycolicibacter terrae	1788	S	47	9	56	0.00001
SRR6145058	Mycobacterium sp. WY10	1920667	S	22	56	78	0.00001
SRR6145058	Microlunatus sp. Gsoil 973	2672569	S	56	1	57	0.00001
SRR6145058	Labilithrix luteola	1391654	S	56	0	56	0.00001
SRR6145058	Kingella kingae	504	S	55	1	56	0.00001
SRR6145058	Eikenella exigua	2528037	S	48	8	56	0.00001
SRR6145058	Bradyrhizobium icense	1274631	S	52	4	56	0.00001
SRR6145058	Agromyces sp. KACC 19306	2592652	S	56	5	61	0.00001
SRR6145058	Acinetobacter tandoii	202954	S	55	1	56	0.00001
SRR6145058	Verminephrobacter eiseniae	364317	S	54	1	55	0.00001
SRR6145058	Streptomyces lavendulae	1914	S	48	7	55	0.00001
SRR6145058	Streptomyces cacaoi	1898	S	49	6	55	0.00001
SRR6145058	Streptomyces albulus	68570	S	50	5	55	0.00001
SRR6145058	Staphylococcus phage StB27	1147044	S	14	55	69	0.00001
SRR6145058	Saccharomonospora azurea	40988	S	46	9	55	0.00001
SRR6145058	Pseudomonas rhodesiae	76760	S	46	9	55	0.00001
SRR6145058	Novosphingobium sp. Gsoil 351	2675225	S	55	1	56	0.00001
SRR6145058	Nitrospirillum amazonense	28077	S	53	2	55	0.00001
SRR6145058	Mycolicibacter sinensis	875328	S	50	5	55	0.00001
SRR6145058	Mycolicibacter minnesotensis	1118379	S	52	3	55	0.00001
SRR6145058	Corynebacterium rouxii	2719119	S	41	14	55	0.00001
SRR6145058	Bradyrhizobium sp. SG09	2599805	S	6	55	61	0.00001
SRR6145058	Arenimonas daejeonensis	370777	S	53	2	55	0.00001
SRR6145058	Thauera humireducens	1134435	S	49	5	54	0.00001
SRR6145058	Streptomyces vietnamensis	362257	S	47	7	54	0.00001
SRR6145058	Saccharomonospora glauca	40990	S	43	11	54	0.00001
SRR6145058	Pseudomonas sihuiensis	1274359	S	35	19	54	0.00001
SRR6145058	Pseudomonas fulva	47880	S	43	11	54	0.00001
SRR6145058	Pseudomonas citronellolis	53408	S	49	5	54	0.00001
SRR6145058	Polaromonas sp. JS666	296591	S	36	54	90	0.00001
SRR6145058	Mycolicibacter hiberniae	29314	S	50	4	54	0.00001
SRR6145058	Massilia lutea	321985	S	46	8	54	0.00001
SRR6145058	Janthinobacterium agaricidamnosum	55508	S	48	6	54	0.00001
SRR6145058	Gemmataceae bacterium	2052164	S	49	5	54	0.00001
SRR6145058	Corynebacterium geronticis	2079234	S	51	3	54	0.00001
SRR6145058	Corallococcus macrosporus	35	S	37	17	54	0.00001
SRR6145058	Streptomyces ambofaciens	1889	S	41	12	53	0.00001
SRR6145058	Saccharomonospora cyanea	40989	S	40	13	53	0.00001
SRR6145058	Propionibacterium australiense	119981	S	51	2	53	0.00001
SRR6145058	Olsenella uli	133926	S	53	0	53	0.00001
SRR6145058	Neomicrococcus aestuarii	556325	S	52	1	53	0.00001
SRR6145058	Massilia flava	871742	S	48	5	53	0.00001
SRR6145058	Frankia alni	1859	S	41	12	53	0.00001
SRR6145058	Egicoccus halophilus	1670830	S	53	0	53	0.00001
SRR6145058	Chryseobacterium sp. SNU WT5	2594269	S	53	6	59	0.00001
SRR6145058	Burkholderia ubonensis	101571	S	32	21	53	0.00001
SRR6145058	Bradyrhizobium sp. SK17	2057741	S	251	53	304	0.00003
SRR6145058	Blastomonas fulva	1550728	S	29	24	53	0.00001
SRR6145058	Blastochloris viridis	1079	S	46	7	53	0.00001
SRR6145058	Staphylococcus succinus	61015	S	51	1	52	0.00001
SRR6145058	Sphingobium sp. TKS	1315974	S	80	52	132	0.00001
SRR6145058	Ruegeria pomeroyi	89184	S	50	2	52	0.00001
SRR6145058	Rathayibacter sp. VKM Ac-2759	2609252	S	52	8	60	0.00001
SRR6145058	Ralstonia mannitolilytica	105219	S	35	17	52	0.00001
SRR6145058	Ralstonia insidiosa	190721	S	43	9	52	0.00001
SRR6145058	Niveispirillum cyanobacteriorum	1612173	S	50	2	52	0.00001
SRR6145058	Micromonospora coxensis	356852	S	44	8	52	0.00001
SRR6145058	Massilia armeniaca	2072590	S	39	13	52	0.00001
SRR6145058	Limnoglobus roseus	2598579	S	52	0	52	0.00001
SRR6145058	Leisingera aquaemixtae	1396826	S	47	5	52	0.00001
SRR6145058	Corynebacterium crudilactis	1652495	S	42	10	52	0.00001
SRR6145058	Burkholderia plantarii	41899	S	47	5	52	0.00001
SRR6145058	Amycolatopsis japonica	208439	S	25	27	52	0.00001
SRR6145058	Thioclava nitratireducens	1915078	S	47	4	51	0.00001
SRR6145058	Streptomyces sp. WAC00288	2094021	S	7	51	58	0.00001
SRR6145058	Streptomyces scabiei	1930	S	46	5	51	0.00001
SRR6145058	Streptomyces globisporus	1908	S	33	18	51	0.00001
SRR6145058	Stappia indica	538381	S	49	2	51	0.00001
SRR6145058	Shinella sp. HZN7	879274	S	148	51	199	0.00002
SRR6145058	Rhizobium etli	29449	S	33	18	51	0.00001
SRR6145058	Pseudomonas libanensis	75588	S	28	23	51	0.00001
SRR6145058	Pseudomonas denitrificans (nomen rejiciendum)	43306	S	51	4	55	0.00001
SRR6145058	Pseudomonas balearica	74829	S	39	12	51	0.00001
SRR6145058	Pseudolabrys taiwanensis	331696	S	48	3	51	0.00001
SRR6145058	Phaeobacter gallaeciensis	60890	S	36	15	51	0.00001
SRR6145058	Nakamurella panacisegetis	1090615	S	51	0	51	0.00001
SRR6145058	Micromonospora echinofusca	47858	S	45	6	51	0.00001
SRR6145058	Castellaniella defragrans	75697	S	45	6	51	0.00001
SRR6145058	Weissella cibaria	137591	S	48	2	50	0.00001
SRR6145058	Thermomonospora curvata	2020	S	45	5	50	0.00001
SRR6145058	Streptomyces clavuligerus	1901	S	48	2	50	0.00001
SRR6145058	Rhodococcus sp. YL-1	1045808	S	9	50	59	0.00001
SRR6145058	Rhizobium flavum	1335061	S	23	27	50	0.00001
SRR6145058	Porphyrobacter sp. YT40	2547601	S	91	50	141	0.00002
SRR6145058	Mycobacterium basiliense	2094119	S	50	0	50	0.00001
SRR6145058	Mobiluncus curtisii	2051	S	49	1	50	0.00001
SRR6145058	Micromonospora auratinigra	261654	S	43	7	50	0.00001
SRR6145058	Mesorhizobium ciceri	39645	S	20	30	50	0.00001
SRR6145058	Hyphomicrobium denitrificans	53399	S	46	4	50	0.00001
SRR6145058	Herbaspirillum robiniae	2014887	S	43	7	50	0.00001
SRR6145058	Haliangium ochraceum	80816	S	50	0	50	0.00001
SRR6145058	Glutamicibacter nicotianae	37929	S	19	31	50	0.00001
SRR6145058	Gluconobacter albidus	318683	S	49	1	50	0.00001
SRR6145058	Corynebacterium suranareeae	2506452	S	44	6	50	0.00001
SRR6145058	Chryseobacterium lactis	1241981	S	43	7	50	0.00001
SRR6145058	Brevibacterium sp. CS2	2575923	S	858	50	908	0.00010
SRR6145058	Aminobacter aminovorans	83263	S	41	9	50	0.00001
SRR6145058	Altererythrobacter marensis	543877	S	47	3	50	0.00001
SRR6145058	Streptomyces aureoverticillatus	66871	S	44	5	49	0.00001
SRR6145058	Streptomyces antimycoticus	68175	S	33	16	49	0.00001
SRR6145058	Stackebrandtia nassauensis	283811	S	49	0	49	0.00001
SRR6145058	Spirosoma pollinicola	2057025	S	48	1	49	0.00001
SRR6145058	Salinicoccus halodurans	407035	S	49	0	49	0.00001
SRR6145058	Pseudomonas moraviensis	321662	S	39	10	49	0.00001
SRR6145058	Pseudarthrobacter equi	728066	S	42	7	49	0.00001
SRR6145058	Propionibacterium virus PHL009M11	1982273	S	46	49	95	0.00001
SRR6145058	Pectobacterium carotovorum	554	S	36	13	49	0.00001
SRR6145058	Novosphingobium ginsenosidimutans	1176536	S	48	1	49	0.00001
SRR6145058	Nocardioides sp. CF8	110319	S	139	49	188	0.00002
SRR6145058	Mycobacterium lacus	169765	S	49	0	49	0.00001
SRR6145058	Micromonospora coriariae	285665	S	44	5	49	0.00001
SRR6145058	Massilia albidiflava	321983	S	39	10	49	0.00001
SRR6145058	Klebsiella grimontii	2058152	S	3	46	49	0.00001
SRR6145058	Exiguobacterium mexicanum	340146	S	48	1	49	0.00001
SRR6145058	Cupriavidus basilensis	68895	S	46	3	49	0.00001
SRR6145058	Bradyrhizobium sp. ORS 3257	167468	S	49	6	55	0.00001
SRR6145058	Bradyrhizobium sp. ORS 278	114615	S	49	6	55	0.00001
SRR6145058	Yoonia vestfoldensis	245188	S	39	9	48	0.00001
SRR6145058	Treponema putidum	221027	S	42	6	48	0.00001
SRR6145058	Streptomyces subrutilus	36818	S	42	6	48	0.00001
SRR6145058	Streptomyces albireticuli	1940	S	45	3	48	0.00001
SRR6145058	Sphingopyxis sp. MG	1866325	S	9	48	57	0.00001
SRR6145058	Rhodococcus jostii	132919	S	39	9	48	0.00001
SRR6145058	Pseudomonas knackmussii	65741	S	42	6	48	0.00001
SRR6145058	Parvibaculum lavamentivorans	256618	S	37	11	48	0.00001
SRR6145058	Micromonospora echinospora	1877	S	45	3	48	0.00001
SRR6145058	Massilia sp. WG5	1707785	S	151	48	199	0.00002
SRR6145058	Frondihabitans sp. PAMC 28766	1795630	S	48	2	50	0.00001
SRR6145058	Arthrobacter sp. PAMC 25486	1494608	S	48	1	49	0.00001
SRR6145058	Archangium gephyra	48	S	45	3	48	0.00001
SRR6145058	Acinetobacter calcoaceticus	471	S	45	3	48	0.00001
SRR6145058	Xanthomonas hyacinthi	56455	S	40	7	47	0.00001
SRR6145058	Variibacter gotjawalensis	1333996	S	46	1	47	0.00001
SRR6145058	Thermobispora bispora	2006	S	47	0	47	0.00001
SRR6145058	Streptomyces xiamenensis	408015	S	46	1	47	0.00001
SRR6145058	Streptomyces sp. S1D4-14	2594461	S	1	47	48	0.00001
SRR6145058	Streptomyces nigra	1827580	S	41	6	47	0.00001
SRR6145058	Streptomyces davaonensis	348043	S	42	5	47	0.00001
SRR6145058	Sagittula sp. P11	2009329	S	83	47	130	0.00001
SRR6145058	Rhodococcus sp. DMU1	2722825	S	12	47	59	0.00001
SRR6145058	Propionibacterium virus Keiki	1982255	S	10	47	57	0.00001
SRR6145058	Porphyrobacter sp. LM 6	1896196	S	47	10	57	0.00001
SRR6145058	Nocardioides baekrokdamisoli	1804624	S	46	1	47	0.00001
SRR6145058	Mycobacterium mantenii	560555	S	46	1	47	0.00001
SRR6145058	Melittangium boletus	83453	S	41	6	47	0.00001
SRR6145058	Martelella mediterranea	293089	S	39	8	47	0.00001
SRR6145058	Komagataeibacter xylinus	28448	S	31	16	47	0.00001
SRR6145058	Kitasatospora aureofaciens	1894	S	7	40	47	0.00001
SRR6145058	Enterobacter bugandensis	881260	S	37	10	47	0.00001
SRR6145058	Brevibacterium sp. 'Marine'	2725563	S	71	47	118	0.00001
SRR6145058	Altererythrobacter dongtanensis	692370	S	42	5	47	0.00001
SRR6145058	Acidovorax cattleyae	80868	S	32	15	47	0.00001
SRR6145058	Acetobacteraceae bacterium	1909293	S	47	0	47	0.00001
SRR6145058	Acetobacter tropicalis	104102	S	34	13	47	0.00001
SRR6145058	Streptomyces katrae	68223	S	40	6	46	0.00001
SRR6145058	Rhizobium sp. CCGE531	2364271	S	2	46	48	0.00001
SRR6145058	Oligotropha carboxidovorans	40137	S	35	11	46	0.00001
SRR6145058	Nocardioides sp. HDW12A	2714938	S	96	46	142	0.00002
SRR6145058	Micromonospora terminaliae	1914461	S	40	6	46	0.00001
SRR6145058	Methylobacterium sp. AMS5	925818	S	67	46	113	0.00001
SRR6145058	Gluconacetobacter diazotrophicus	33996	S	45	1	46	0.00001
SRR6145058	Georhizobium profundi	2341112	S	40	6	46	0.00001
SRR6145058	Chryseobacterium camelliae	1265445	S	44	2	46	0.00001
SRR6145058	Bordetella petrii	94624	S	30	16	46	0.00001
SRR6145058	Bifidobacterium breve	1685	S	37	9	46	0.00001
SRR6145058	Bergeyella cardium	1585976	S	45	1	46	0.00001
SRR6145058	Austwickia chelonae	100225	S	46	0	46	0.00001
SRR6145058	Agrobacterium fabrum	1176649	S	35	11	46	0.00001
SRR6145058	Verrucosispora maris	1003110	S	39	6	45	0.00000
SRR6145058	Streptomyces tirandamycinicus	2174846	S	40	5	45	0.00000
SRR6145058	Streptomyces olivaceus	47716	S	7	38	45	0.00000
SRR6145058	Streptomyces antibioticus	1890	S	40	5	45	0.00000
SRR6145058	Streptomyces alfalfae	1642299	S	1	44	45	0.00000
SRR6145058	Sphingobium sp. YBL2	484429	S	20	45	65	0.00001
SRR6145058	Simplicispira suum	2109915	S	41	4	45	0.00000
SRR6145058	Serratia liquefaciens	614	S	30	15	45	0.00000
SRR6145058	Rhizobium pseudoryzae	379684	S	42	3	45	0.00000
SRR6145058	Mycobacterium shigaense	722731	S	42	3	45	0.00000
SRR6145058	Methylosinus trichosporium	426	S	41	4	45	0.00000
SRR6145058	Hypericibacter terrae	2602015	S	43	2	45	0.00000
SRR6145058	Cryobacterium arcticum	670052	S	33	12	45	0.00000
SRR6145058	Actinoplanes sp. OR16	946334	S	61	45	106	0.00001
SRR6145058	Streptomyces lunaelactis	1535768	S	42	2	44	0.00000
SRR6145058	Polaromonas naphthalenivorans	216465	S	41	3	44	0.00000
SRR6145058	Nordella sp. HKS 07	2712222	S	44	0	44	0.00000
SRR6145058	Neisseria brasiliensis	2666100	S	38	6	44	0.00000
SRR6145058	Mycobacterium sp. YC-RL4	1682113	S	227	44	271	0.00003
SRR6145058	Mycobacterium heidelbergense	53376	S	41	3	44	0.00000
SRR6145058	Mycobacterium colombiense	339268	S	43	1	44	0.00000
SRR6145058	Massilia sp. NR 4-1	1678028	S	44	4	48	0.00001
SRR6145058	Lichenihabitans psoromatis	2528642	S	43	1	44	0.00000
SRR6145058	Lactobacillus fermentum	1613	S	38	6	44	0.00000
SRR6145058	Cupriavidus sp. USMAA2-4	876364	S	8	44	52	0.00001
SRR6145058	Aeromonas sp. ASNIH1	1636606	S	8	44	52	0.00001
SRR6145058	Acinetobacter defluvii	1871111	S	38	6	44	0.00000
SRR6145058	[Mycobacterium] stephanolepidis	1520670	S	33	10	43	0.00000
SRR6145058	Thauera chlorobenzoica	96773	S	33	10	43	0.00000
SRR6145058	Streptomyces luteoverticillatus	66425	S	40	3	43	0.00000
SRR6145058	Streptomyces aquilus	2548456	S	38	5	43	0.00000
SRR6145058	Streptomyces alboflavus	67267	S	39	4	43	0.00000
SRR6145058	Saccharomonospora marina	632569	S	36	7	43	0.00000
SRR6145058	Rhodococcus aetherivorans	191292	S	7	36	43	0.00000
SRR6145058	Prauserella marina	530584	S	42	1	43	0.00000
SRR6145058	Paraoerskovia marina	545619	S	42	1	43	0.00000
SRR6145058	Paraburkholderia phytofirmans	261302	S	35	8	43	0.00000
SRR6145058	Nocardiopsis alba	53437	S	41	2	43	0.00000
SRR6145058	Mycobacteroides saopaulense	1578165	S	41	2	43	0.00000
SRR6145058	Mogibacterium pumilum	86332	S	41	2	43	0.00000
SRR6145058	Micromonospora rifamycinica	291594	S	38	5	43	0.00000
SRR6145058	Micromonospora purpureochromogenes	47872	S	37	6	43	0.00000
SRR6145058	Micromonospora inositola	47865	S	37	6	43	0.00000
SRR6145058	Micromonospora chokoriensis	356851	S	39	4	43	0.00000
SRR6145058	Delftia sp. Cs1-4	742013	S	24	43	67	0.00001
SRR6145058	Bradyrhizobium symbiodeficiens	1404367	S	35	8	43	0.00000
SRR6145058	Bacteroides dorei	357276	S	30	13	43	0.00000
SRR6145058	Azospirillum oryzae	286727	S	24	19	43	0.00000
SRR6145058	Aeromonas media	651	S	24	19	43	0.00000
SRR6145058	Xanthomonas euvesicatoria	456327	S	12	30	42	0.00000
SRR6145058	Streptomyces sp. 2114.2	1881022	S	4	42	46	0.00001
SRR6145058	Streptomyces parvulus	146923	S	35	7	42	0.00000
SRR6145058	Streptomyces malaysiensis	92644	S	9	33	42	0.00000
SRR6145058	Streptomyces asterosporus	285570	S	35	7	42	0.00000
SRR6145058	Rubrobacter xylanophilus	49319	S	42	0	42	0.00000
SRR6145058	Roseibacterium elongatum	159346	S	41	1	42	0.00000
SRR6145058	Rhodococcus sp. PBTS 2	1653479	S	42	25	67	0.00001
SRR6145058	Rathayibacter sp. VKM Ac-2760	2609253	S	42	15	57	0.00001
SRR6145058	Pseudorhodoplanes sinuspersici	1235591	S	41	1	42	0.00000
SRR6145058	Pseudomonas sp. LTJR-52	2479392	S	147	42	189	0.00002
SRR6145058	Paraburkholderia terricola	169427	S	40	2	42	0.00000
SRR6145058	Novosphingobium tardaugens	169176	S	33	9	42	0.00000
SRR6145058	Neisseria canis	493	S	40	2	42	0.00000
SRR6145058	Mycobacterium xenopi	1789	S	41	1	42	0.00000
SRR6145058	Microbacterium sp. SGAir0570	2070348	S	19	42	61	0.00001
SRR6145058	Gluconobacter thailandicus	257438	S	34	8	42	0.00000
SRR6145058	Gemmata obscuriglobus	114	S	41	1	42	0.00000
SRR6145058	Chondromyces crocatus	52	S	42	0	42	0.00000
SRR6145058	Bradyrhizobium sp. ORS 285	115808	S	42	5	47	0.00001
SRR6145058	Bradyrhizobium sp. 1S5	1404402	S	21	42	63	0.00001
SRR6145058	Betapapillomavirus 3	334207	S	42	0	42	0.00000
SRR6145058	Azospirillum humicireducens	1226968	S	29	13	42	0.00000
SRR6145058	Arthrobacter alpinus	656366	S	29	13	42	0.00000
SRR6145058	Aeromonas sp. ASNIH7	1920107	S	6	42	48	0.00001
SRR6145058	Xylanimonas cellulosilytica	186189	S	36	5	41	0.00000
SRR6145058	Xanthomonas oryzae	347	S	38	3	41	0.00000
SRR6145058	Streptomyces violaceoruber	1935	S	34	7	41	0.00000
SRR6145058	Streptomyces sp. DSM 40868	2721173	S	41	6	47	0.00001
SRR6145058	Streptomyces pristinaespiralis	38300	S	35	6	41	0.00000
SRR6145058	Streptomyces nitrosporeus	28894	S	38	3	41	0.00000
SRR6145058	Streptomyces griseochromogenes	68214	S	37	4	41	0.00000
SRR6145058	Staphylococcus phage StB20-like	1732064	S	1	41	42	0.00000
SRR6145058	Rhodococcus sp. 008	1723645	S	7	41	48	0.00001
SRR6145058	Pseudomonas sp. JY-Q	1338689	S	8	41	49	0.00001
SRR6145058	Pseudomonas psychrophila	122355	S	40	1	41	0.00000
SRR6145058	Pseudomonas furukawaii	1149133	S	38	3	41	0.00000
SRR6145058	Paraburkholderia caribensis	75105	S	37	4	41	0.00000
SRR6145058	Mycobacterium noviomagense	459858	S	41	0	41	0.00000
SRR6145058	Methylibium sp. Pch-M	2082386	S	49	41	90	0.00001
SRR6145058	Klebsiella sp. LTGPAF-6F	1905288	S	1	41	42	0.00000
SRR6145058	Hoyosella subflava	639313	S	41	0	41	0.00000
SRR6145058	Glutamicibacter mishrai	1775880	S	39	2	41	0.00000
SRR6145058	Enterococcus mundtii	53346	S	40	1	41	0.00000
SRR6145058	Deinococcus peraridilitoris	432329	S	41	0	41	0.00000
SRR6145058	Bacteroides vulgatus	821	S	28	13	41	0.00000
SRR6145058	Youhaiella tibetensis	1447062	S	37	3	40	0.00000
SRR6145058	Variovorax sp. SRS16	282217	S	22	40	62	0.00001
SRR6145058	Streptomyces formicae	1616117	S	32	8	40	0.00000
SRR6145058	Streptomyces ficellus	1977088	S	36	4	40	0.00000
SRR6145058	Sphingobacterium thalpophilum	259	S	37	3	40	0.00000
SRR6145058	Rhodococcus biphenylivorans	1500843	S	5	35	40	0.00000
SRR6145058	Pseudomonas alcaliphila	101564	S	26	14	40	0.00000
SRR6145058	Paraburkholderia xenovorans	36873	S	30	10	40	0.00000
SRR6145058	Micromonospora siamensis	299152	S	35	5	40	0.00000
SRR6145058	Microbacterium sp. CGR1	1696072	S	17	40	57	0.00001
SRR6145058	Methylovirgula ligni	569860	S	38	2	40	0.00000
SRR6145058	Burkholderia glumae	337	S	32	8	40	0.00000
SRR6145058	Brachybacterium sp. SGAir0954	2571029	S	467	40	507	0.00006
SRR6145058	Xanthomonas hortorum	56454	S	16	23	39	0.00000
SRR6145058	Vitreoscilla filiformis	63	S	38	1	39	0.00000
SRR6145058	Streptomyces xinghaiensis	1038928	S	37	2	39	0.00000
SRR6145058	Streptomyces sp. WAC 01438	2203204	S	39	5	44	0.00000
SRR6145058	Streptomyces rubrolavendulae	285473	S	5	34	39	0.00000
SRR6145058	Streptomyces nodosus	40318	S	37	2	39	0.00000
SRR6145058	Streptomyces galilaeus	33899	S	35	4	39	0.00000
SRR6145058	Streptomyces fungicidicus	68203	S	33	6	39	0.00000
SRR6145058	Sphingomonas sp. C8-2	2492837	S	67	39	106	0.00001
SRR6145058	Sphingobium sp. PAMC28499	2565554	S	41	39	80	0.00001
SRR6145058	Roseivivax sp. THAF197b	2588299	S	3	39	42	0.00000
SRR6145058	Rhodobacter sp. LPB0142	1850250	S	143	39	182	0.00002
SRR6145058	Rhizobium daejeonense	240521	S	36	3	39	0.00000
SRR6145058	Pseudomonas brassicacearum	930166	S	15	24	39	0.00000
SRR6145058	Propionibacterium virus Stormborn	1982307	S	54	39	93	0.00001
SRR6145058	Micromonospora tulbaghiae	479978	S	26	13	39	0.00000
SRR6145058	Microbacterium paludicola	300019	S	12	27	39	0.00000
SRR6145058	Microbacterium amylolyticum	936337	S	38	1	39	0.00000
SRR6145058	Hydrogenophaga sp. BA0156	2716225	S	146	39	185	0.00002
SRR6145058	Glutamicibacter halophytocola	1933880	S	38	1	39	0.00000
SRR6145058	Cupriavidus malaysiensis	367825	S	5	34	39	0.00000
SRR6145058	Caulobacter sp. FWC26	69665	S	135	39	174	0.00002
SRR6145058	Brevibacterium sp. o2	2697565	S	124	39	163	0.00002
SRR6145058	Bradyrhizobium zhanjiangense	1325107	S	35	4	39	0.00000
SRR6145058	Aeromonas sp. ASNIH3	1636608	S	9	39	48	0.00001
SRR6145058	Actinoalloteichus hymeniacidonis	340345	S	39	0	39	0.00000
SRR6145058	Streptomyces sp. ICC1	2099583	S	1	38	39	0.00000
SRR6145058	Streptomyces hundungensis	1077946	S	36	2	38	0.00000
SRR6145058	Streptomyces exfoliatus	1905	S	34	4	38	0.00000
SRR6145058	Streptomyces actuosus	1885	S	33	5	38	0.00000
SRR6145058	Staphylococcus phage StB20	1147043	S	7	38	45	0.00000
SRR6145058	Salinispora arenicola	168697	S	34	4	38	0.00000
SRR6145058	Roseitalea porphyridii	1852022	S	36	2	38	0.00000
SRR6145058	Rhodoferax ferrireducens	192843	S	37	1	38	0.00000
SRR6145058	Rhizobium sp. TCK	136098	S	4	38	42	0.00000
SRR6145058	Rathayibacter tanaceti	1671680	S	34	4	38	0.00000
SRR6145058	Nitrobacter hamburgensis	912	S	36	2	38	0.00000
SRR6145058	Massilia plicata	321984	S	34	4	38	0.00000
SRR6145058	Leuconostoc citreum	33964	S	35	3	38	0.00000
SRR6145058	Indioceanicola profundi	2220096	S	36	2	38	0.00000
SRR6145058	Herbaspirillum rubrisubalbicans	80842	S	32	6	38	0.00000
SRR6145058	Ferrovibrio terrae	2594003	S	38	0	38	0.00000
SRR6145058	Burkholderia stabilis	95485	S	24	14	38	0.00000
SRR6145058	Bradyrhizobium amphicarpaeae	1404768	S	30	8	38	0.00000
SRR6145058	Bacteroides uniformis	820	S	23	15	38	0.00000
SRR6145058	Achromobacter pestifer	1353889	S	29	9	38	0.00000
SRR6145058	Weissella confusa	1583	S	36	1	37	0.00000
SRR6145058	Streptomyces dengpaensis	2049881	S	34	3	37	0.00000
SRR6145058	Streptomyces bacillaris	68179	S	7	30	37	0.00000
SRR6145058	Streptococcus gallolyticus	315405	S	14	23	37	0.00000
SRR6145058	Sphingobium herbicidovorans	76947	S	27	10	37	0.00000
SRR6145058	Sinorhizobium americanum	194963	S	32	5	37	0.00000
SRR6145058	Pseudomonas protegens	380021	S	34	3	37	0.00000
SRR6145058	Plantibacter flavus	150123	S	21	16	37	0.00000
SRR6145058	Mesorhizobium amorphae	71433	S	33	4	37	0.00000
SRR6145058	Luteitalea pratensis	1855912	S	37	0	37	0.00000
SRR6145058	Leuconostoc gelidum	1244	S	36	1	37	0.00000
SRR6145058	Epibacterium mobile	379347	S	29	8	37	0.00000
SRR6145058	Dermatophilus congolensis	1863	S	37	0	37	0.00000
SRR6145058	Comamonas kerstersii	225992	S	33	4	37	0.00000
SRR6145058	Chryseobacterium joostei	112234	S	31	6	37	0.00000
SRR6145058	Cellulosimicrobium sp. TH-20	1980001	S	12	37	49	0.00001
SRR6145058	Campylobacter jejuni	197	S	11	26	37	0.00000
SRR6145058	Altererythrobacter mangrovi	1982042	S	35	2	37	0.00000
SRR6145058	Variovorax sp. WDL1	207745	S	52	36	88	0.00001
SRR6145058	Streptomyces vinaceus	1960	S	31	5	36	0.00000
SRR6145058	Streptomyces sp. YIM 121038	2136401	S	36	6	42	0.00000
SRR6145058	Streptomyces roseochromogenus	285450	S	32	4	36	0.00000
SRR6145058	Streptomyces pactum	68249	S	30	6	36	0.00000
SRR6145058	Sphingobium indicum	332055	S	16	20	36	0.00000
SRR6145058	Rhodospirillum rubrum	1085	S	34	2	36	0.00000
SRR6145058	Rahnella aquatilis	34038	S	16	20	36	0.00000
SRR6145058	Propionibacterium phage PHL030N00	1500800	S	1	36	37	0.00000
SRR6145058	Phaeobacter inhibens	221822	S	27	9	36	0.00000
SRR6145058	Murdochiella vaginalis	1852373	S	33	3	36	0.00000
SRR6145058	Micromonospora zamorensis	709883	S	33	3	36	0.00000
SRR6145058	Leclercia sp. LSNIH1	1920114	S	6	36	42	0.00000
SRR6145058	Ketogulonicigenium vulgare	92945	S	35	1	36	0.00000
SRR6145058	Janthinobacterium svalbardensis	368607	S	24	12	36	0.00000
SRR6145058	Human papillomavirus	10566	S	36	0	36	0.00000
SRR6145058	Cupriavidus pinatubonensis	248026	S	32	4	36	0.00000
SRR6145058	Collimonas fungivorans	158899	S	31	5	36	0.00000
SRR6145058	Bradyrhizobium canariense	255045	S	35	1	36	0.00000
SRR6145058	Altererythrobacter atlanticus	1267766	S	25	11	36	0.00000
SRR6145058	Actinosynnema mirum	40567	S	4	32	36	0.00000
SRR6145058	Zhihengliuella sp. ISTPL4	2058657	S	72	35	107	0.00001
SRR6145058	Trueperella pyogenes	1661	S	33	2	35	0.00000
SRR6145058	Streptomyces violaceusniger	68280	S	22	13	35	0.00000
SRR6145058	Streptomyces tendae	1932	S	31	4	35	0.00000
SRR6145058	Streptomyces qaidamensis	1783515	S	30	5	35	0.00000
SRR6145058	Streptomyces olivoreticuli	68246	S	33	2	35	0.00000
SRR6145058	Streptomyces noursei	1971	S	22	13	35	0.00000
SRR6145058	Streptomyces gilvosporeus	553510	S	32	3	35	0.00000
SRR6145058	Streptomyces fodineus	1904616	S	30	5	35	0.00000
SRR6145058	Streptomyces alboniger	132473	S	30	5	35	0.00000
SRR6145058	Stigmatella aurantiaca	41	S	33	2	35	0.00000
SRR6145058	Glutamicibacter arilaitensis	256701	S	32	3	35	0.00000
SRR6145058	Ensifer sojae	716925	S	25	10	35	0.00000
SRR6145058	Elizabethkingia meningoseptica	238	S	35	0	35	0.00000
SRR6145058	Collinsella aerofaciens	74426	S	34	1	35	0.00000
SRR6145058	Citrobacter koseri	545	S	15	20	35	0.00000
SRR6145058	Cellulosimicrobium sp. 72-3	2731680	S	12	35	47	0.00001
SRR6145058	Truepera radiovictrix	332249	S	34	0	34	0.00000
SRR6145058	Streptomyces viridosporus	67581	S	29	5	34	0.00000
SRR6145058	Streptomyces sp. M56	1495638	S	10	34	44	0.00000
SRR6145058	Streptomyces leeuwenhoekii	1437453	S	21	13	34	0.00000
SRR6145058	Streptomyces avermitilis	33903	S	31	3	34	0.00000
SRR6145058	Streptococcus sp. HSISS2	1316411	S	25	34	59	0.00001
SRR6145058	Sphingomonas sp. IC081	304378	S	112	34	146	0.00002
SRR6145058	Serpentinomonas raichei	1458425	S	31	3	34	0.00000
SRR6145058	Rhizobium jaguaris	1312183	S	33	1	34	0.00000
SRR6145058	Psychrobacter alimentarius	261164	S	1	33	34	0.00000
SRR6145058	Pseudomonas synxantha	47883	S	27	7	34	0.00000
SRR6145058	Pseudarthrobacter sulfonivorans	121292	S	22	12	34	0.00000
SRR6145058	Paraburkholderia sprentiae	948107	S	33	1	34	0.00000
SRR6145058	Orrella dioscoreae	1851544	S	31	3	34	0.00000
SRR6145058	Mycobacterium shinjukuense	398694	S	34	0	34	0.00000
SRR6145058	Methylobacterium sp. 17Sr1-43	2202828	S	353	34	387	0.00004
SRR6145058	Magnetospirillum magneticum	84159	S	32	2	34	0.00000
SRR6145058	Halomonas sp. A3H3	1346287	S	8	34	42	0.00000
SRR6145058	Flaviflexus salsibiostraticola	1282737	S	33	1	34	0.00000
SRR6145058	Egibacter rhizosphaerae	1670831	S	34	0	34	0.00000
SRR6145058	Dyella thiooxydans	445710	S	33	1	34	0.00000
SRR6145058	Delftia sp. HK171	1920191	S	17	34	51	0.00001
SRR6145058	Chromobacterium vaccinii	1108595	S	29	5	34	0.00000
SRR6145058	Bradyrhizobium sp. TM102	2599819	S	4	34	38	0.00000
SRR6145058	Bradyrhizobium sp. CCBAU 051011	858422	S	34	4	38	0.00000
SRR6145058	Azospira sp. I09	1765049	S	30	34	64	0.00001
SRR6145058	Actinotignum schaalii	59505	S	34	0	34	0.00000
SRR6145058	Actinomyces sp. dk561	2560010	S	111	34	145	0.00002
SRR6145058	Actinomyces sp. Z16	2079536	S	115	34	149	0.00002
SRR6145058	Acinetobacter oleivorans	1148157	S	30	4	34	0.00000
SRR6145058	Variovorax sp. PBL-E5	434014	S	16	33	49	0.00001
SRR6145058	Thiomonas intermedia	926	S	23	10	33	0.00000
SRR6145058	Streptococcus sp. HSISS3	1316412	S	26	33	59	0.00001
SRR6145058	Serinicoccus sp. JLT9	1758689	S	106	33	139	0.00002
SRR6145058	Saccharomonospora viridis	1852	S	31	2	33	0.00000
SRR6145058	Rhodocyclaceae bacterium	1898103	S	10	23	33	0.00000
SRR6145058	Pseudomonas versuta	1788301	S	32	1	33	0.00000
SRR6145058	Pseudomonas orientalis	76758	S	29	4	33	0.00000
SRR6145058	Pseudomonas azotoformans	47878	S	26	7	33	0.00000
SRR6145058	Mycobacterium sp. PYR15	2051552	S	13	33	46	0.00001
SRR6145058	Mycobacterium paraseoulense	590652	S	32	1	33	0.00000
SRR6145058	Micromonospora viridifaciens	1881	S	29	4	33	0.00000
SRR6145058	Microbacterium sp. str. 'China'	2103230	S	33	105	138	0.00002
SRR6145058	Methylobacterium sp. 17Sr1-1	2202826	S	206	33	239	0.00003
SRR6145058	Magnetospirillum gryphiswaldense	55518	S	33	0	33	0.00000
SRR6145058	Ilumatobacter coccineus	467094	S	33	0	33	0.00000
SRR6145058	Hyphomicrobium nitrativorans	1427356	S	32	1	33	0.00000
SRR6145058	Hydrogenophaga sp. PBC	795665	S	121	33	154	0.00002
SRR6145058	Hydrogenophaga crassostreae	1763535	S	33	0	33	0.00000
SRR6145058	Flavobacterium anhuiense	459526	S	27	6	33	0.00000
SRR6145058	Burkholderia stagnalis	1503054	S	27	6	33	0.00000
SRR6145058	Burkholderia pyrrocinia	60550	S	22	11	33	0.00000
SRR6145058	Bradyrhizobium sp. WSM471	319017	S	13	33	46	0.00001
SRR6145058	Bradyrhizobium sp. S23321	335659	S	15	33	48	0.00001
SRR6145058	Agrobacterium larrymoorei	160699	S	31	2	33	0.00000
SRR6145058	Actinobacteria bacterium YIM 96077	2487353	S	33	0	33	0.00000
SRR6145058	Thauera aromatica	59405	S	22	10	32	0.00000
SRR6145058	Streptomyces kanamyceticus	1967	S	26	6	32	0.00000
SRR6145058	Streptococcus porcinus	1340	S	28	4	32	0.00000
SRR6145058	Staphylococcus condimenti	70255	S	30	2	32	0.00000
SRR6145058	Sphingopyxis sp. EG6	1874061	S	90	32	122	0.00001
SRR6145058	Sphingobium fuliginis	336203	S	12	20	32	0.00000
SRR6145058	Rickettsia bellii	33990	S	30	2	32	0.00000
SRR6145058	Rathayibacter tritici	33888	S	27	5	32	0.00000
SRR6145058	Rathayibacter sp. VKM Ac-2804	2609257	S	32	21	53	0.00001
SRR6145058	Pseudomonas oryzae	1392877	S	31	1	32	0.00000
SRR6145058	Paraburkholderia graminis	60548	S	30	2	32	0.00000
SRR6145058	Pandoraea pnomenusa	93220	S	27	5	32	0.00000
SRR6145058	Nocardioides sp. zg-579	2663857	S	139	32	171	0.00002
SRR6145058	Nitrobacter winogradskyi	913	S	30	2	32	0.00000
SRR6145058	Mycobacterium marinum	1781	S	20	12	32	0.00000
SRR6145058	Kitasatospora albolonga	68173	S	25	7	32	0.00000
SRR6145058	Halomonas beimenensis	475662	S	32	0	32	0.00000
SRR6145058	Gammapapillomavirus 8	1175850	S	32	0	32	0.00000
SRR6145058	Frankia casuarinae	106370	S	31	1	32	0.00000
SRR6145058	Cupriavidus sp. USMAHM13	1389192	S	5	32	37	0.00000
SRR6145058	Corynebacterium kutscheri	35755	S	32	0	32	0.00000
SRR6145058	Collimonas arenae	279058	S	28	4	32	0.00000
SRR6145058	Celeribacter ethanolicus	1758178	S	23	9	32	0.00000
SRR6145058	Bradymonas sediminis	1548548	S	12	20	32	0.00000
SRR6145058	Bifidobacterium catenulatum	1686	S	26	6	32	0.00000
SRR6145058	Betapapillomavirus 2	333924	S	32	0	32	0.00000
SRR6145058	Azoarcus communis	41977	S	29	3	32	0.00000
SRR6145058	Xanthomonas perforans	442694	S	6	25	31	0.00000
SRR6145058	Sulfitobacter sp. AM1-D1	1917485	S	38	31	69	0.00001
SRR6145058	Streptomyces cyaneochromogenes	2496836	S	28	3	31	0.00000
SRR6145058	Streptomyces coeruleorubidus	116188	S	25	6	31	0.00000
SRR6145058	Sphingobium sp. CAP-1	2676077	S	64	31	95	0.00001
SRR6145058	Rhodoferax saidenbachensis	1484693	S	30	1	31	0.00000
SRR6145058	Rhodococcus sp. WB1	1033922	S	4	31	35	0.00000
SRR6145058	Rhodococcus imtechensis	262776	S	15	16	31	0.00000
SRR6145058	Pseudomonas sp. ATCC 13867	1294143	S	31	3	34	0.00000
SRR6145058	Plantactinospora sp. BB1	2071627	S	16	31	47	0.00001
SRR6145058	Pelagibacterium halotolerans	531813	S	29	2	31	0.00000
SRR6145058	Paraburkholderia terrae	311230	S	24	7	31	0.00000
SRR6145058	Novosphingobium sp. ABRDHK2	2571749	S	94	31	125	0.00001
SRR6145058	Myxococcus stipitatus	83455	S	30	1	31	0.00000
SRR6145058	Myxococcus hansupus	1297742	S	26	5	31	0.00000
SRR6145058	Mycobacterium seoulense	386911	S	30	1	31	0.00000
SRR6145058	Leuconostoc mesenteroides	1245	S	22	9	31	0.00000
SRR6145058	Leisingera methylohalidivorans	133924	S	27	4	31	0.00000
SRR6145058	Gemmata massiliana	1210884	S	23	8	31	0.00000
SRR6145058	Erythrobacter aureus	2182384	S	29	2	31	0.00000
SRR6145058	Corynebacterium pseudotuberculosis	1719	S	30	1	31	0.00000
SRR6145058	Altererythrobacter namhicola	645517	S	30	1	31	0.00000
SRR6145058	Simonsiella muelleri	72	S	29	1	30	0.00000
SRR6145058	Serratia plymuthica	82996	S	28	2	30	0.00000
SRR6145058	Segniliparus rotundus	286802	S	30	0	30	0.00000
SRR6145058	Pseudomonas sp. VLB120	69328	S	4	30	34	0.00000
SRR6145058	Propionibacterium virus PHL060L00	1982277	S	28	30	58	0.00001
SRR6145058	Paraburkholderia caledonica	134536	S	29	1	30	0.00000
SRR6145058	Mycobacterium marseillense	701042	S	28	2	30	0.00000
SRR6145058	Mesorhizobium australicum	536018	S	23	7	30	0.00000
SRR6145058	Luteibacter rhizovicinus	242606	S	28	2	30	0.00000
SRR6145058	Lacipirellula parvula	2650471	S	30	0	30	0.00000
SRR6145058	Kozakia baliensis	153496	S	28	2	30	0.00000
SRR6145058	Haemophilus virus HP1	10690	S	1	30	31	0.00000
SRR6145058	Gordonia sp. YC-JH1	2059875	S	119	30	149	0.00002
SRR6145058	Gordonia sp. KTR9	337191	S	376	30	406	0.00004
SRR6145058	Corynebacterium mustelae	571915	S	30	0	30	0.00000
SRR6145058	Confluentimicrobium sp. EMB200-NS6	1609966	S	54	30	84	0.00001
SRR6145058	Chryseobacterium piperi	558152	S	30	0	30	0.00000
SRR6145058	Casimicrobium huifangae	2591109	S	27	3	30	0.00000
SRR6145058	Bordetella hinzii	103855	S	26	4	30	0.00000
SRR6145058	Azotobacter chroococcum	353	S	22	8	30	0.00000
SRR6145058	Antarctobacter heliothermus	74033	S	30	0	30	0.00000
SRR6145058	Afipia sp. GAS231	1882747	S	36	30	66	0.00001
SRR6145058	Acidiphilium multivorum	62140	S	12	18	30	0.00000
SRR6145058	Xanthomonas vesicatoria	56460	S	25	4	29	0.00000
SRR6145058	Variovorax sp. PBL-H6	434009	S	46	29	75	0.00001
SRR6145058	Sulfuritalea hydrogenivorans	748811	S	28	1	29	0.00000
SRR6145058	Streptomyces sp. WAC 06738	2203210	S	29	10	39	0.00000
SRR6145058	Streptomyces peucetius	1950	S	27	2	29	0.00000
SRR6145058	Streptococcus pluranimalium	82348	S	28	1	29	0.00000
SRR6145058	Staphylococcus phage IME-SA4	1610872	S	8	29	37	0.00000
SRR6145058	Sneathia amnii	187101	S	29	0	29	0.00000
SRR6145058	Rhodoferax antarcticus	81479	S	28	1	29	0.00000
SRR6145058	Rhodanobacter denitrificans	666685	S	28	1	29	0.00000
SRR6145058	Rathayibacter rathayi	33887	S	25	4	29	0.00000
SRR6145058	Propionibacterium virus P104A	1982268	S	31	29	60	0.00001
SRR6145058	Pantoea stewartii	66269	S	28	1	29	0.00000
SRR6145058	Paludisphaera borealis	1387353	S	29	0	29	0.00000
SRR6145058	Mycobacteroides salmoniphilum	404941	S	28	1	29	0.00000
SRR6145058	Mesorhizobium opportunistum	593909	S	22	7	29	0.00000
SRR6145058	Lactococcus phage Tuc2009	35241	S	2	29	31	0.00000
SRR6145058	Klebsiella sp. M5al	1934254	S	2	29	31	0.00000
SRR6145058	Halomonas socia	1081866	S	29	0	29	0.00000
SRR6145058	Corynebacterium choanis	1862358	S	29	0	29	0.00000
SRR6145058	Chromohalobacter salexigens	158080	S	29	0	29	0.00000
SRR6145058	Bacteroides thetaiotaomicron	818	S	25	4	29	0.00000
SRR6145058	Bacillus amyloliquefaciens	1390	S	14	15	29	0.00000
SRR6145058	Actinopolyspora erythraea	414996	S	29	0	29	0.00000
SRR6145058	Actinoplanes sp. N902-109	649831	S	75	29	104	0.00001
SRR6145058	Acinetobacter cumulans	2136182	S	27	2	29	0.00000
SRR6145058	Acidiphilium cryptum	524	S	11	18	29	0.00000
SRR6145058	Thermomonas sp. SY21	2202149	S	139	28	167	0.00002
SRR6145058	Sulfuritortus calidifontis	1914471	S	23	5	28	0.00000
SRR6145058	Streptomyces spongiicola	1690221	S	25	3	28	0.00000
SRR6145058	Streptomyces fradiae	1906	S	4	24	28	0.00000
SRR6145058	Streptococcus pasteurianus	197614	S	3	25	28	0.00000
SRR6145058	Streptococcus canis	1329	S	25	3	28	0.00000
SRR6145058	Staphylococcus simiae	308354	S	28	0	28	0.00000
SRR6145058	Staphylococcus pseudintermedius	283734	S	23	5	28	0.00000
SRR6145058	Sphingomonas sp. CL5.1	2653203	S	235	28	263	0.00003
SRR6145058	Sphingobium japonicum	332056	S	14	14	28	0.00000
SRR6145058	Rhizobium grahamii	1120045	S	27	1	28	0.00000
SRR6145058	Pseudomonas graminis	158627	S	28	0	28	0.00000
SRR6145058	Propionibacterium phage Moyashi	1654781	S	24	28	52	0.00001
SRR6145058	Paraburkholderia hospita	169430	S	23	5	28	0.00000
SRR6145058	Pantoea ananatis	553	S	27	1	28	0.00000
SRR6145058	Methylorubrum zatmanii	29429	S	4	24	28	0.00000
SRR6145058	Immundisolibacter cernigliae	1810504	S	28	0	28	0.00000
SRR6145058	Hymenobacter swuensis	1446467	S	24	4	28	0.00000
SRR6145058	Hymenobacter sp. PAMC 26628	1484118	S	28	6	34	0.00000
SRR6145058	Exiguobacterium acetylicum	41170	S	18	10	28	0.00000
SRR6145058	Erythrobacter seohaensis	266951	S	23	5	28	0.00000
SRR6145058	Enterobacter sp. LU1	1848517	S	3	28	31	0.00000
SRR6145058	Ensifer alkalisoli	1752398	S	24	4	28	0.00000
SRR6145058	Bordetella trematum	123899	S	25	3	28	0.00000
SRR6145058	Azotobacter salinestris	69964	S	20	8	28	0.00000
SRR6145058	Alienimonas californiensis	2527989	S	28	0	28	0.00000
SRR6145058	Xanthomonas vasicola	56459	S	25	2	27	0.00000
SRR6145058	Streptomyces qinzhouensis	2599401	S	25	2	27	0.00000
SRR6145058	Streptomyces prasinus	67345	S	25	2	27	0.00000
SRR6145058	Streptomyces cyaneogriseus	68192	S	16	11	27	0.00000
SRR6145058	Streptomyces atratus	1893	S	26	1	27	0.00000
SRR6145058	Staphylococcus phage StB12	1147042	S	28	27	55	0.00001
SRR6145058	Rhizobium favelukesii	348824	S	24	3	27	0.00000
SRR6145058	Rathayibacter iranicus	59737	S	26	1	27	0.00000
SRR6145058	Psychromicrobium lacuslunae	1618207	S	27	0	27	0.00000
SRR6145058	Pseudonocardia sp. AL041005-10	445576	S	179	27	206	0.00002
SRR6145058	Pseudomonas lurida	244566	S	24	3	27	0.00000
SRR6145058	Propionibacterium virus P105	1982261	S	26	27	53	0.00001
SRR6145058	Phaeobacter piscinae	1580596	S	17	10	27	0.00000
SRR6145058	Paraburkholderia phymatum	148447	S	26	1	27	0.00000
SRR6145058	Pandoraea thiooxydans	445709	S	27	0	27	0.00000
SRR6145058	Neisseria animaloris	326522	S	26	1	27	0.00000
SRR6145058	Microbacterium sp. 1S1	2606451	S	90	27	117	0.00001
SRR6145058	Methylocystis bryophila	655015	S	26	1	27	0.00000
SRR6145058	Methylocella silvestris	199596	S	26	1	27	0.00000
SRR6145058	Melaminivora sp. SC2-9	2109913	S	97	27	124	0.00001
SRR6145058	Marisediminicola antarctica	674079	S	27	0	27	0.00000
SRR6145058	Leuconostoc lactis	1246	S	19	8	27	0.00000
SRR6145058	Kosakonia cowanii	208223	S	23	4	27	0.00000
SRR6145058	Fibrella aestuarina	651143	S	26	1	27	0.00000
SRR6145058	Dyella japonica	231455	S	27	0	27	0.00000
SRR6145058	Bacillus flexus	86664	S	27	0	27	0.00000
SRR6145058	Arthrobacter dokdonellae	2211210	S	27	0	27	0.00000
SRR6145058	Altererythrobacter epoxidivorans	361183	S	23	4	27	0.00000
SRR6145058	Actinoalloteichus sp. GBA129-24	1612551	S	4	27	31	0.00000
SRR6145058	Acidibrevibacterium fodinaquatile	1969806	S	27	0	27	0.00000
SRR6145058	Tateyamaria omphalii	299262	S	26	0	26	0.00000
SRR6145058	Streptomyces seoulensis	73044	S	23	3	26	0.00000
SRR6145058	Streptomyces koyangensis	188770	S	15	11	26	0.00000
SRR6145058	Streptomyces glaucescens	1907	S	22	4	26	0.00000
SRR6145058	Streptomyces collinus	42684	S	23	3	26	0.00000
SRR6145058	Sphingobium sp. YG1	2082188	S	106	26	132	0.00001
SRR6145058	Sinorhizobium medicae	110321	S	24	2	26	0.00000
SRR6145058	Salinicola tamaricis	1771309	S	26	0	26	0.00000
SRR6145058	Rhodothermus marinus	29549	S	25	1	26	0.00000
SRR6145058	Psychrobacter sp. P11G5	1699624	S	37	26	63	0.00001
SRR6145058	Pseudomonas sp. 13159349	2662034	S	6	26	32	0.00000
SRR6145058	Pseudomonas marincola	437900	S	26	0	26	0.00000
SRR6145058	Propionibacterium virus MrAK	1982258	S	20	26	46	0.00001
SRR6145058	Propionibacterium phage PAC1	1690805	S	25	26	51	0.00001
SRR6145058	Phycisphaera mikurensis	547188	S	26	0	26	0.00000
SRR6145058	Paenibacillus polymyxa	1406	S	9	17	26	0.00000
SRR6145058	Neisseria zoodegmatis	326523	S	24	2	26	0.00000
SRR6145058	Microbacterium endophyticum	1526412	S	26	0	26	0.00000
SRR6145058	Mesorhizobium japonicum	2066070	S	16	10	26	0.00000
SRR6145058	Luteibacter pinisoli	2589080	S	24	2	26	0.00000
SRR6145058	Legionella pneumophila	446	S	25	1	26	0.00000
SRR6145058	Hyphomonas sp. CACIAM 19H1	1873716	S	26	1	27	0.00000
SRR6145058	Granulibacter bethesdensis	364410	S	26	0	26	0.00000
SRR6145058	Glutamicibacter sp. ZJUTW	1155384	S	16	26	42	0.00000
SRR6145058	Chelatococcus sp. CO-6	1702325	S	77	26	103	0.00001
SRR6145058	Bordetella parapertussis	519	S	3	23	26	0.00000
SRR6145058	Bordetella bronchialis	463025	S	25	1	26	0.00000
SRR6145058	Anabaena sp. 90	46234	S	4	26	30	0.00000
SRR6145058	Agrobacterium vitis	373	S	26	0	26	0.00000
SRR6145058	Agrobacterium sp. MA01	2664893	S	12	26	38	0.00000
SRR6145058	Agrobacterium rhizogenes	359	S	22	4	26	0.00000
SRR6145058	Acidovorax sp. RAC01	1842533	S	88	26	114	0.00001
SRR6145058	Xanthomonas cassavae	56450	S	23	2	25	0.00000
SRR6145058	Streptomyces sp. Tue 6075	1661694	S	25	15	40	0.00000
SRR6145058	Streptomyces pluripotens	1355015	S	24	1	25	0.00000
SRR6145058	Rhizobium acidisoli	1538158	S	16	9	25	0.00000
SRR6145058	Pseudohalocynthiibacter aestuariivivens	1591409	S	22	3	25	0.00000
SRR6145058	Propionibacterium virus P144	1982262	S	42	25	67	0.00001
SRR6145058	Paracoccus sp. 2251	2560053	S	306	25	331	0.00004
SRR6145058	Pantoea sp. PSNIH1	1484158	S	61	25	86	0.00001
SRR6145058	Myroides odoratimimus	76832	S	18	7	25	0.00000
SRR6145058	Microbacterium sp. 1.5R	1916917	S	11	25	36	0.00000
SRR6145058	Methylocella tundrae	227605	S	24	1	25	0.00000
SRR6145058	Mesorhizobium erdmanii	1777866	S	20	5	25	0.00000
SRR6145058	Ketogulonicigenium robustum	92947	S	24	1	25	0.00000
SRR6145058	Jeotgalicoccus saudimassiliensis	1461582	S	25	0	25	0.00000
SRR6145058	Halomonas aestuarii	1897729	S	25	0	25	0.00000
SRR6145058	Halobellus limi	699433	S	23	2	25	0.00000
SRR6145058	Erythrobacter gangjinensis	502682	S	25	0	25	0.00000
SRR6145058	Crenobacter cavernae	2290923	S	24	1	25	0.00000
SRR6145058	Bordetella flabilis	463014	S	25	0	25	0.00000
SRR6145058	Bacteroides ovatus	28116	S	18	7	25	0.00000
SRR6145058	Bacteroides heparinolyticus	28113	S	21	4	25	0.00000
SRR6145058	Azospirillum sp. TSH58	664962	S	23	25	48	0.00001
SRR6145058	Achromobacter sp. AONIH1	1758194	S	53	25	78	0.00001
SRR6145058	Vulgatibacter incomptus	1391653	S	24	0	24	0.00000
SRR6145058	Thiomonas arsenitoxydans	426114	S	6	18	24	0.00000
SRR6145058	Streptomyces sp. SM17	565560	S	2	24	26	0.00000
SRR6145058	Streptomyces anulatus	1892	S	19	5	24	0.00000
SRR6145058	Streptococcus himalayensis	1888195	S	23	1	24	0.00000
SRR6145058	Staphylococcus sp. SDB 2975	2044912	S	24	2	26	0.00000
SRR6145058	Sphingomonas sp. LK11	1390395	S	258	24	282	0.00003
SRR6145058	Shewanella putrefaciens	24	S	9	15	24	0.00000
SRR6145058	Serratia fonticola	47917	S	22	2	24	0.00000
SRR6145058	Rubrobacter indicoceani	2051957	S	23	1	24	0.00000
SRR6145058	Rhodobacter sp. CZR27	2033869	S	112	24	136	0.00001
SRR6145058	Pseudomonas resinovorans	53412	S	23	1	24	0.00000
SRR6145058	Pseudomonas palleroniana	191390	S	23	1	24	0.00000
SRR6145058	Propionibacterium virus Solid	1982306	S	33	24	57	0.00001
SRR6145058	Prochlorococcus marinus	1219	S	22	2	24	0.00000
SRR6145058	Plantibacter sp. M259	2583822	S	32	24	56	0.00001
SRR6145058	Ornithinimicrobium sp. HY006	2508882	S	118	24	142	0.00002
SRR6145058	Mycobacterium canettii	78331	S	19	5	24	0.00000
SRR6145058	Mitsuaria sp. 7	1658665	S	204	24	228	0.00002
SRR6145058	Mesorhizobium huakuii	28104	S	4	20	24	0.00000
SRR6145058	Laribacter hongkongensis	168471	S	21	3	24	0.00000
SRR6145058	Janthinobacterium sp. SNU WT3	2590869	S	24	12	36	0.00000
SRR6145058	Hymenobacter sp. PAMC 26554	1484116	S	24	0	24	0.00000
SRR6145058	Flavobacterium johnsoniae	986	S	21	3	24	0.00000
SRR6145058	Enterococcus casseliflavus	37734	S	16	8	24	0.00000
SRR6145058	Elizabethkingia miricola	172045	S	14	10	24	0.00000
SRR6145058	Dickeya zeae	204042	S	22	2	24	0.00000
SRR6145058	Collimonas pratensis	279113	S	20	4	24	0.00000
SRR6145058	Chromobacterium rhizoryzae	1778675	S	5	19	24	0.00000
SRR6145058	Bifidobacterium pseudolongum	1694	S	24	0	24	0.00000
SRR6145058	Bdellovibrio bacteriovorus	959	S	23	1	24	0.00000
SRR6145058	Allochromatium vinosum	1049	S	23	1	24	0.00000
SRR6145058	Alcanivorax dieselolei	285091	S	20	4	24	0.00000
SRR6145058	Aeromonas salmonicida	645	S	19	5	24	0.00000
SRR6145058	Xanthomonas albilineans	29447	S	23	0	23	0.00000
SRR6145058	Thermus thermophilus	274	S	13	10	23	0.00000
SRR6145058	Thermobifida fusca	2021	S	23	0	23	0.00000
SRR6145058	Streptomyces sp. WAC 01529	2203205	S	23	4	27	0.00000
SRR6145058	Streptomyces cavourensis	67258	S	7	16	23	0.00000
SRR6145058	Streptomyces autolyticus	75293	S	5	18	23	0.00000
SRR6145058	Staphylococcus chromogenes	46126	S	23	0	23	0.00000
SRR6145058	Sphingopyxis sp. PAMC25046	2565556	S	74	23	97	0.00001
SRR6145058	Sphingopyxis sp. 113P3	292913	S	83	23	106	0.00001
SRR6145058	Salinispora tropica	168695	S	21	2	23	0.00000
SRR6145058	Rhodothermaceae bacterium	2026787	S	13	10	23	0.00000
SRR6145058	Pyruvatibacter mobilis	1712261	S	22	1	23	0.00000
SRR6145058	Pseudonocardia sp. HH130629-09	1641402	S	91	23	114	0.00001
SRR6145058	Pseudomonas viridiflava	33069	S	23	0	23	0.00000
SRR6145058	Propionibacterium virus P100D	1982266	S	26	23	49	0.00001
SRR6145058	Peptoniphilus ivorii	54006	S	23	0	23	0.00000
SRR6145058	Paracoccus sp. SC2-6	2259340	S	222	23	245	0.00003
SRR6145058	Pandoraea vervacti	656178	S	19	4	23	0.00000
SRR6145058	Paenibacillus mucilaginosus	61624	S	23	0	23	0.00000
SRR6145058	Oryzomicrobium terrae	1735038	S	23	0	23	0.00000
SRR6145058	Mycobacterium haemophilum	29311	S	23	0	23	0.00000
SRR6145058	Morganella morganii	582	S	21	2	23	0.00000
SRR6145058	Martelella endophytica	1486262	S	21	2	23	0.00000
SRR6145058	Marichromatium purpuratum	37487	S	23	0	23	0.00000
SRR6145058	Lactobacillus paracollinoides	240427	S	20	3	23	0.00000
SRR6145058	Komagataeibacter rhaeticus	215221	S	2	21	23	0.00000
SRR6145058	Hyphomonas neptunium	81032	S	22	1	23	0.00000
SRR6145058	Hoeflea phototrophica	244596	S	22	1	23	0.00000
SRR6145058	Herbaspirillum hiltneri	341045	S	22	1	23	0.00000
SRR6145058	Helicobacter pylori	210	S	22	1	23	0.00000
SRR6145058	Halotalea alkalilenta	376489	S	23	0	23	0.00000
SRR6145058	Halobiforma lacisalsi	229731	S	21	2	23	0.00000
SRR6145058	Dialister pneumosintes	39950	S	23	0	23	0.00000
SRR6145058	Chromobacterium violaceum	536	S	19	4	23	0.00000
SRR6145058	Chromobacterium sp. ATCC 53434	2059672	S	23	2	25	0.00000
SRR6145058	Blastomonas sp. RAC04	1842535	S	34	23	57	0.00001
SRR6145058	Bacteriovorax stolpii	960	S	23	0	23	0.00000
SRR6145058	Azospirillum sp. TSA2s	709810	S	31	23	54	0.00001
SRR6145058	Auricoccus indicus	1849491	S	23	0	23	0.00000
SRR6145058	Alistipes shahii	328814	S	17	6	23	0.00000
SRR6145058	Zobellella denitrificans	347534	S	22	0	22	0.00000
SRR6145058	Xanthomonas axonopodis	53413	S	16	6	22	0.00000
SRR6145058	Vibrio parahaemolyticus	670	S	19	3	22	0.00000
SRR6145058	Thauera sp. MZ1T	85643	S	68	22	90	0.00001
SRR6145058	Tetragenococcus halophilus	51669	S	21	1	22	0.00000
SRR6145058	Sphaerobacter thermophilus	2057	S	22	0	22	0.00000
SRR6145058	Salinibacterium sp. CGMCC 1.16371	2079791	S	22	1	23	0.00000
SRR6145058	Roseobacter ponti	1891787	S	22	0	22	0.00000
SRR6145058	Rhodococcus sp. S2-17	1990687	S	37	22	59	0.00001
SRR6145058	Rhodobaca barguzinensis	441209	S	22	0	22	0.00000
SRR6145058	Rhizobium tropici	398	S	19	3	22	0.00000
SRR6145058	Pseudomonas parafulva	157782	S	19	3	22	0.00000
SRR6145058	Propionibacterium virus PHL132N00	1982291	S	21	22	43	0.00000
SRR6145058	Propionibacterium virus P1001	1982263	S	16	22	38	0.00000
SRR6145058	Pigmentiphaga aceris	1940612	S	22	0	22	0.00000
SRR6145058	Phyllobacterium zundukense	1867719	S	21	1	22	0.00000
SRR6145058	Pararhodospirillum photometricum	1084	S	22	0	22	0.00000
SRR6145058	Pandoraea pulmonicola	93221	S	20	2	22	0.00000
SRR6145058	Olivibacter sp. LS-1	2592345	S	26	22	48	0.00001
SRR6145058	Nocardioides sp. dk884	2662361	S	106	22	128	0.00001
SRR6145058	Neisseria weaveri	28091	S	21	1	22	0.00000
SRR6145058	Methylocystis heyeri	391905	S	21	1	22	0.00000
SRR6145058	Massilia sp. YMA4	1593482	S	66	22	88	0.00001
SRR6145058	Lactobacillus sakei	1599	S	21	1	22	0.00000
SRR6145058	Hymenobacter oligotrophus	2319843	S	21	1	22	0.00000
SRR6145058	Halobacterium hubeiense	1407499	S	20	2	22	0.00000
SRR6145058	Gimesia maris	122	S	1	21	22	0.00000
SRR6145058	Fusobacterium necrophorum	859	S	22	0	22	0.00000
SRR6145058	Flavobacterium crocinum	2183896	S	19	3	22	0.00000
SRR6145058	Fastidiosipila sanguinis	236753	S	21	1	22	0.00000
SRR6145058	Erythrobacter atlanticus	1648404	S	17	5	22	0.00000
SRR6145058	Enterobacter soli	885040	S	21	1	22	0.00000
SRR6145058	Devriesea agamarum	472569	S	22	0	22	0.00000
SRR6145058	Clostridium perfringens	1502	S	22	0	22	0.00000
SRR6145058	Cellvibrio japonicus	155077	S	22	0	22	0.00000
SRR6145058	Capnocytophaga canimorsus	28188	S	21	1	22	0.00000
SRR6145058	Burkholderia metallica	488729	S	16	6	22	0.00000
SRR6145058	Burkholderia insecticola	758793	S	22	0	22	0.00000
SRR6145058	Bifidobacterium pseudocatenulatum	28026	S	18	4	22	0.00000
SRR6145058	Bacillus pumilus	1408	S	20	2	22	0.00000
SRR6145058	Anabaena sp. YBS01	2490939	S	1	22	23	0.00000
SRR6145058	Alcanivorax pacificus	1306787	S	21	1	22	0.00000
SRR6145058	Acinetobacter baylyi	202950	S	22	0	22	0.00000
SRR6145058	Acetobacter persici	1076596	S	22	0	22	0.00000
SRR6145058	Acetobacter pasteurianus	438	S	13	9	22	0.00000
SRR6145058	Variovorax sp. RA8	662548	S	65	21	86	0.00001
SRR6145058	Tardiphaga sp. vice278	2592815	S	2	21	23	0.00000
SRR6145058	Streptomyces sp. S501	2420135	S	3	21	24	0.00000
SRR6145058	Streptomyces sp. RLB3-6	2594457	S	1	21	22	0.00000
SRR6145058	Streptomyces rochei	1928	S	12	9	21	0.00000
SRR6145058	Streptomyces platensis	58346	S	13	8	21	0.00000
SRR6145058	Steroidobacter denitrificans	465721	S	20	1	21	0.00000
SRR6145058	Roseovarius mucosus	215743	S	10	11	21	0.00000
SRR6145058	Pseudomonas sp. LTGT-11-2Z	2479393	S	1	21	22	0.00000
SRR6145058	Pseudomonas sp. BIOMIG1BAC	1758730	S	9	21	30	0.00000
SRR6145058	Pseudomonas guangdongensis	1245526	S	20	1	21	0.00000
SRR6145058	Plantactinospora sp. BC1	2108470	S	11	21	32	0.00000
SRR6145058	Paraburkholderia megapolitana	420953	S	21	0	21	0.00000
SRR6145058	Parabacteroides distasonis	823	S	11	10	21	0.00000
SRR6145058	Pandoraea sputorum	93222	S	16	5	21	0.00000
SRR6145058	Ochrobactrum pituitosum	571256	S	13	8	21	0.00000
SRR6145058	Nocardioides sp. 603	2483798	S	106	21	127	0.00001
SRR6145058	Nocardia sp. CFHS0054	2382165	S	103	21	124	0.00001
SRR6145058	Neisseria zalophi	640030	S	21	0	21	0.00000
SRR6145058	Methylocystis rosea	173366	S	18	3	21	0.00000
SRR6145058	Methylocystis parvus	134	S	20	1	21	0.00000
SRR6145058	Mesorhizobium sp. WSM1497	278153	S	5	21	26	0.00000
SRR6145058	Marinobacter salarius	1420917	S	20	1	21	0.00000
SRR6145058	Lacunisphaera limnophila	1838286	S	21	0	21	0.00000
SRR6145058	Lactobacillus gasseri	1596	S	7	14	21	0.00000
SRR6145058	Klebsiella huaxiensis	2153354	S	18	3	21	0.00000
SRR6145058	Haemophilus aegyptius	197575	S	2	19	21	0.00000
SRR6145058	Gemmatimonas aurantiaca	173480	S	21	0	21	0.00000
SRR6145058	Flavobacterium album	2175091	S	21	0	21	0.00000
SRR6145058	Enterocloster bolteae	208479	S	19	2	21	0.00000
SRR6145058	Elizabethkingia ursingii	1756150	S	18	3	21	0.00000
SRR6145058	Dyadobacter fermentans	94254	S	20	1	21	0.00000
SRR6145058	Desulfovibrio vulgaris	881	S	21	0	21	0.00000
SRR6145058	Desulfovibrio carbinoliphilus	345370	S	21	0	21	0.00000
SRR6145058	Corynebacterium sp. NML98-0116	702967	S	273	21	294	0.00003
SRR6145058	Bradyrhizobium sp. 6(2017)	1197460	S	181	21	202	0.00002
SRR6145058	Bifidobacterium dentium	1689	S	21	0	21	0.00000
SRR6145058	Azoarcus olearius	418699	S	6	15	21	0.00000
SRR6145058	Aeromonas sp. ASNIH2	1636607	S	5	21	26	0.00000
SRR6145058	Achromobacter sp. MFA1 R4	1881016	S	21	3	24	0.00000
SRR6145058	Acetobacter oryzifermentans	1633874	S	4	17	21	0.00000
SRR6145058	[Pseudomonas] mesoacidophila	265293	S	15	5	20	0.00000
SRR6145058	Xanthomonas cucurbitae	56453	S	19	1	20	0.00000
SRR6145058	Thioalkalivibrio nitratireducens	186931	S	17	3	20	0.00000
SRR6145058	Streptomyces fulvissimus	68202	S	16	4	20	0.00000
SRR6145058	Staphylococcus agnetis	985762	S	19	1	20	0.00000
SRR6145058	Spirosoma rigui	564064	S	19	1	20	0.00000
SRR6145058	Sphingosinithalassobacter sp. zrk23	2711215	S	85	20	105	0.00001
SRR6145058	Serratia odorifera	618	S	20	0	20	0.00000
SRR6145058	Rhodomicrobium vannielii	1069	S	20	0	20	0.00000
SRR6145058	Rhodococcus sp. WB9	2594007	S	18	20	38	0.00000
SRR6145058	Rhodobacteraceae bacterium 9Alg 56	2683284	S	20	0	20	0.00000
SRR6145058	Pseudomonas sp. TKP	1415630	S	9	20	29	0.00000
SRR6145058	Pseudomonas sp. PONIH3	1636610	S	8	20	28	0.00000
SRR6145058	Pseudomonas mandelii	75612	S	9	11	20	0.00000
SRR6145058	Pseudomonas lactis	1615674	S	13	7	20	0.00000
SRR6145058	Pseudomonas cremoricolorata	157783	S	20	0	20	0.00000
SRR6145058	Pseudarthrobacter sp. NIBRBAC000502771	2590774	S	10	20	30	0.00000
SRR6145058	Propionibacterium virus PHL116M00	1982288	S	58	20	78	0.00001
SRR6145058	Propionibacterium virus PHL113M01	1982286	S	18	20	38	0.00000
SRR6145058	Propionibacterium virus PHL041M10	1982276	S	30	20	50	0.00001
SRR6145058	Propionibacterium virus P1.1	1982264	S	20	20	40	0.00000
SRR6145058	Propionibacterium virus ATCC29399BC	1982252	S	5	20	25	0.00000
SRR6145058	Prevotella ruminicola	839	S	20	0	20	0.00000
SRR6145058	Planctomycetes bacterium	2026780	S	20	0	20	0.00000
SRR6145058	Pectobacterium versatile	2488639	S	12	8	20	0.00000
SRR6145058	Octadecabacter antarcticus	1217908	S	20	0	20	0.00000
SRR6145058	Mucilaginibacter rubeus	2027860	S	4	16	20	0.00000
SRR6145058	Leuconostoc carnosum	1252	S	17	3	20	0.00000
SRR6145058	Leptotrichia goodfellowii	157692	S	20	0	20	0.00000
SRR6145058	Lactococcus garvieae	1363	S	16	4	20	0.00000
SRR6145058	Jeotgalibaca porci	1868793	S	19	1	20	0.00000
SRR6145058	Hydrogenophaga sp. PBL-H3	434010	S	57	20	77	0.00001
SRR6145058	Halorubrum lacusprofundi	2247	S	14	6	20	0.00000
SRR6145058	Halorhodospira halophila	1053	S	20	0	20	0.00000
SRR6145058	Geobacillus stearothermophilus	1422	S	13	7	20	0.00000
SRR6145058	Fluviibacterium aquatile	2552766	S	18	2	20	0.00000
SRR6145058	Eggerthella lenta	84112	S	18	2	20	0.00000
SRR6145058	Duganella sp. GN2-R2	2728020	S	114	20	134	0.00001
SRR6145058	Desulfobulbus oralis	1986146	S	20	0	20	0.00000
SRR6145058	Curtobacterium sp. SGAir0471	2070337	S	66	20	86	0.00001
SRR6145058	Cupriavidus nantongensis	1796606	S	9	11	20	0.00000
SRR6145058	Cronobacter sakazakii	28141	S	13	7	20	0.00000
SRR6145058	Clostridium pasteurianum	1501	S	20	0	20	0.00000
SRR6145058	Caulobacter sp. Ji-3-8	2708539	S	82	20	102	0.00001
SRR6145058	Burkholderia territorii	1503055	S	14	6	20	0.00000
SRR6145058	Bacteroides zoogleoformans	28119	S	17	3	20	0.00000
SRR6145058	Bacillus altitudinis	293387	S	13	7	20	0.00000
SRR6145058	Atlantibacter hermannii	565	S	20	0	20	0.00000
SRR6145058	Aromatoleum aromaticum	551760	S	20	0	20	0.00000
SRR6145058	Aeribacillus pallidus	33936	S	20	0	20	0.00000
SRR6145058	Zymobacter palmae	33074	S	19	0	19	0.00000
SRR6145058	Wenzhouxiangella marina	1579979	S	19	0	19	0.00000
SRR6145058	Thalassobius gelatinovorus	53501	S	19	0	19	0.00000
SRR6145058	Sulfurifustis variabilis	1675686	S	19	0	19	0.00000
SRR6145058	Streptomyces sp. Tu 2975	2676871	S	19	3	22	0.00000
SRR6145058	Streptomyces sp. SUK 48	2582831	S	19	6	25	0.00000
SRR6145058	Streptococcus parauberis	1348	S	17	2	19	0.00000
SRR6145058	Sterolibacterium denitrificans	157592	S	18	1	19	0.00000
SRR6145058	Renibacterium salmoninarum	1646	S	19	0	19	0.00000
SRR6145058	Pseudomonas tolaasii	29442	S	16	3	19	0.00000
SRR6145058	Pseudomonas sp. WCS374	1495331	S	1	19	20	0.00000
SRR6145058	Pseudomonas sp. R3-52-08	1173284	S	4	19	23	0.00000
SRR6145058	Pseudoalteromonas haloplanktis	228	S	6	13	19	0.00000
SRR6145058	Pseudarthrobacter chlorophenolicus	85085	S	17	2	19	0.00000
SRR6145058	Propionibacterium virus PHL112N00	1982285	S	23	19	42	0.00000
SRR6145058	Propionibacterium virus PHL092M00	1982282	S	33	19	52	0.00001
SRR6145058	Propionibacterium virus PHL025M00	1982274	S	24	19	43	0.00000
SRR6145058	Propionibacterium phage PA1-14	1747271	S	27	19	46	0.00001
SRR6145058	Planctomycetes bacterium K2D	2527962	S	1	19	20	0.00000
SRR6145058	Pandoraea fibrosis	1891094	S	15	4	19	0.00000
SRR6145058	Nocardioides sp. S-1144	2582905	S	131	19	150	0.00002
SRR6145058	Nibricoccus aquaticus	2576891	S	19	0	19	0.00000
SRR6145058	Moraxella bovoculi	386891	S	15	4	19	0.00000
SRR6145058	Microvirgula aerodenitrificans	57480	S	19	0	19	0.00000
SRR6145058	Micavibrio aeruginosavorus	349221	S	19	0	19	0.00000
SRR6145058	Mesorhizobium sp. M2A.F.Ca.ET.046.03.2.1	2493674	S	7	19	26	0.00000
SRR6145058	Kosakonia oryzae	497725	S	9	10	19	0.00000
SRR6145058	Halorubrum ezzemoulense	337243	S	17	2	19	0.00000
SRR6145058	Flavobacterium nitrogenifigens	1617283	S	15	4	19	0.00000
SRR6145058	Desulfosarcina ovata	83564	S	19	0	19	0.00000
SRR6145058	Curtobacterium sp. MR_MD2014	1561023	S	62	19	81	0.00001
SRR6145058	Celeribacter baekdonensis	875171	S	15	4	19	0.00000
SRR6145058	Burkholderia sp. OLGA172	1804984	S	224	19	243	0.00003
SRR6145058	Bordetella pseudohinzii	1331258	S	16	3	19	0.00000
SRR6145058	Bifidobacterium bifidum	1681	S	19	0	19	0.00000
SRR6145058	Bacillus velezensis	492670	S	3	16	19	0.00000
SRR6145058	Arthrobacter sp. AQ5-05	2184581	S	4	19	23	0.00000
SRR6145058	Anaerobutyricum hallii	39488	S	17	2	19	0.00000
SRR6145058	Alteromonas macleodii	28108	S	17	2	19	0.00000
SRR6145058	Aeromonas encheleia	73010	S	18	1	19	0.00000
SRR6145058	Acinetobacter equi	1324350	S	19	0	19	0.00000
SRR6145058	Acetobacter aceti	435	S	19	0	19	0.00000
SRR6145058	Thiobacillus denitrificans	36861	S	18	0	18	0.00000
SRR6145058	Thioalkalivibrio versutus	106634	S	18	0	18	0.00000
SRR6145058	Thioalkalivibrio sulfidiphilus	1033854	S	16	2	18	0.00000
SRR6145058	Streptomyces pratensis	1169025	S	3	15	18	0.00000
SRR6145058	Streptococcus urinalis	149016	S	17	1	18	0.00000
SRR6145058	Streptococcus merionis	400065	S	18	0	18	0.00000
SRR6145058	Streptococcus ferus	1345	S	18	0	18	0.00000
SRR6145058	Staphylococcus schweitzeri	1654388	S	15	3	18	0.00000
SRR6145058	Sphingopyxis sp. FD7	1914525	S	71	18	89	0.00001
SRR6145058	Sphingomonas sp. KC8	1030157	S	64	18	82	0.00001
SRR6145058	Sphingobacterium sp. 21	743722	S	20	18	38	0.00000
SRR6145058	Singulisphaera acidiphila	466153	S	18	0	18	0.00000
SRR6145058	Salinibacter ruber	146919	S	18	0	18	0.00000
SRR6145058	Roseovarius sp. THAF8	2587846	S	14	18	32	0.00000
SRR6145058	Roseovarius sp. THAF27	2587850	S	12	18	30	0.00000
SRR6145058	Rathayibacter sp. VKM Ac-2801	2609255	S	18	10	28	0.00000
SRR6145058	Pseudomonas sp. SNU WT1	2518644	S	18	1	19	0.00000
SRR6145058	Propionibacterium virus PHL301M00	1982301	S	40	18	58	0.00001
SRR6145058	Propionibacterium virus PHL179M00	1982298	S	20	18	38	0.00000
SRR6145058	Porphyromonas crevioricanis	393921	S	18	0	18	0.00000
SRR6145058	Opitutus terrae	107709	S	18	0	18	0.00000
SRR6145058	Ochrobactrum quorumnocens	271865	S	17	1	18	0.00000
SRR6145058	Nocardia sp. CS682	1047172	S	108	18	126	0.00001
SRR6145058	Mycobacterium sp. ELW1	1547487	S	67	18	85	0.00001
SRR6145058	Microcystis aeruginosa	1126	S	13	5	18	0.00000
SRR6145058	Lactococcus piscium	1364	S	18	0	18	0.00000
SRR6145058	Lactobacillus paragasseri	2107999	S	7	11	18	0.00000
SRR6145058	Labrenzia sp. THAF35	2587854	S	2	18	20	0.00000
SRR6145058	Labrenzia aggregata	187304	S	4	14	18	0.00000
SRR6145058	Hymenobacter nivis	1850093	S	15	3	18	0.00000
SRR6145058	Halomonas elongata	2746	S	18	0	18	0.00000
SRR6145058	Geobacillus kaustophilus	1462	S	3	15	18	0.00000
SRR6145058	Flavobacterium haoranii	683124	S	16	2	18	0.00000
SRR6145058	Desulfovibrio desulfuricans	876	S	17	1	18	0.00000
SRR6145058	Dechloromonas aromatica	259537	S	18	0	18	0.00000
SRR6145058	Cyanobium gracile	59930	S	17	1	18	0.00000
SRR6145058	Citrobacter sp. CF971	2566012	S	2	18	20	0.00000
SRR6145058	Carnobacterium divergens	2748	S	18	0	18	0.00000
SRR6145058	Capnocytophaga haemolytica	45243	S	18	0	18	0.00000
SRR6145058	Burkholderia seminalis	488731	S	13	5	18	0.00000
SRR6145058	Bacillus litoralis	152268	S	18	0	18	0.00000
SRR6145058	Aquitalea magnusonii	332411	S	15	3	18	0.00000
SRR6145058	Alkalilimnicola ehrlichii	351052	S	18	0	18	0.00000
SRR6145058	Alcaligenes aquatilis	323284	S	12	6	18	0.00000
SRR6145058	Agrobacterium sp. RAC06	1842536	S	8	18	26	0.00000
SRR6145058	Actinoalloteichus fjordicus	1612552	S	2	16	18	0.00000
SRR6145058	[Ruminococcus] gnavus	33038	S	13	4	17	0.00000
SRR6145058	Verrucomicrobium spinosum	2736	S	17	0	17	0.00000
SRR6145058	Tepidiforma bonchosmolovskayae	2601677	S	17	0	17	0.00000
SRR6145058	Tatumella citrea	53336	S	17	0	17	0.00000
SRR6145058	Sulfitobacter sp. THAF37	2587855	S	32	17	49	0.00001
SRR6145058	Streptomyces sp. SGAir0924	2109593	S	8	17	25	0.00000
SRR6145058	Streptomyces sp. MOE7	1961713	S	13	17	30	0.00000
SRR6145058	Streptomyces sp. DUT11	1914992	S	5	17	22	0.00000
SRR6145058	Streptomyces sp. 11-1-2	1851167	S	6	17	23	0.00000
SRR6145058	Stenotrophomonas sp. ZAC14D2_NAIMI4_6	2072406	S	14	17	31	0.00000
SRR6145058	Stenotrophomonas sp. WZN-1	2005046	S	26	17	43	0.00000
SRR6145058	Staphylococcus carnosus	1281	S	16	1	17	0.00000
SRR6145058	Sphingobium sp. MI1205	407020	S	23	17	40	0.00000
SRR6145058	Roseivivax sp. THAF40	2587858	S	1	17	18	0.00000
SRR6145058	Rhodanobacter glycinis	582702	S	17	0	17	0.00000
SRR6145058	Pseudomonas umsongensis	198618	S	16	1	17	0.00000
SRR6145058	Pseudomonas sp. FDAARGOS_761	2545800	S	1	17	18	0.00000
SRR6145058	Pseudomonas sp. CFSAN084952	2664899	S	6	17	23	0.00000
SRR6145058	Pseudomonas extremaustralis	359110	S	16	1	17	0.00000
SRR6145058	Pseudomonas antarctica	219572	S	15	2	17	0.00000
SRR6145058	Propionibacterium virus Wizzo	1982308	S	25	17	42	0.00000
SRR6145058	Propionibacterium virus P91	1982260	S	16	17	33	0.00000
SRR6145058	Propionibacterium virus Ouroboros	1982259	S	58	17	75	0.00001
SRR6145058	Propionibacterium virus Lauchelly	1982257	S	74	17	91	0.00001
SRR6145058	Porphyromonas cangingivalis	36874	S	17	0	17	0.00000
SRR6145058	Polynucleobacter necessarius	576610	S	16	1	17	0.00000
SRR6145058	Pantoea rwandensis	1076550	S	17	0	17	0.00000
SRR6145058	Pandoraea norimbergensis	93219	S	16	1	17	0.00000
SRR6145058	Pandoraea faecigallinarum	656179	S	15	2	17	0.00000
SRR6145058	Paenibacillus larvae	1464	S	3	14	17	0.00000
SRR6145058	Oceanithermus profundus	187137	S	17	0	17	0.00000
SRR6145058	Ndongobacter massiliensis	1871025	S	16	1	17	0.00000
SRR6145058	Microcoleus sp. PCC 7113	1173027	S	17	1	18	0.00000
SRR6145058	Mesorhizobium sp. M2A.F.Ca.ET.043.02.1.1	2493670	S	7	17	24	0.00000
SRR6145058	Mesorhizobium sp. M1D.F.Ca.ET.043.01.1.1	2493669	S	32	17	49	0.00001
SRR6145058	Meiothermus ruber	277	S	17	0	17	0.00000
SRR6145058	Marinobacter hydrocarbonoclasticus	2743	S	15	2	17	0.00000
SRR6145058	Lactococcus virus sk1	31532	S	1	17	18	0.00000
SRR6145058	Klebsiella sp. FDAARGOS_511	2488567	S	32	17	49	0.00001
SRR6145058	Gordonia sp. 1D	1737359	S	181	17	198	0.00002
SRR6145058	Gloeocapsa sp. PCC 7428	1173026	S	17	1	18	0.00000
SRR6145058	Flavobacterium commune	1306519	S	17	0	17	0.00000
SRR6145058	Flavobacterium branchiophilum	55197	S	17	0	17	0.00000
SRR6145058	Exiguobacterium sp. ZWU0009	1224749	S	8	17	25	0.00000
SRR6145058	Cytophaga hutchinsonii	985	S	17	0	17	0.00000
SRR6145058	Clostridium isatidis	182773	S	17	0	17	0.00000
SRR6145058	Cedecea neteri	158822	S	16	1	17	0.00000
SRR6145058	Burkholderia vietnamiensis	60552	S	4	13	17	0.00000
SRR6145058	Bradyrhizobium sp. LCT2	2493093	S	5	17	22	0.00000
SRR6145058	Bradyrhizobium sp. 58S1	1404864	S	8	17	25	0.00000
SRR6145058	Brachybacterium sp. P6-10-X1	1903186	S	228	17	245	0.00003
SRR6145058	Anaerostipes hadrus	649756	S	16	1	17	0.00000
SRR6145058	Actinomyces sp. 299	2057743	S	83	17	100	0.00001
SRR6145058	Actinomyces sp. 2129	2321394	S	84	17	101	0.00001
SRR6145058	Acidihalobacter prosperus	160660	S	17	0	17	0.00000
SRR6145058	Xanthomonas arboricola	56448	S	12	4	16	0.00000
SRR6145058	Thiocystis violascens	73141	S	16	0	16	0.00000
SRR6145058	Thermobacillus composti	377615	S	16	0	16	0.00000
SRR6145058	Streptococcus respiraculi	2021971	S	16	0	16	0.00000
SRR6145058	Streptococcus iniae	1346	S	16	0	16	0.00000
SRR6145058	Stenotrophomonas sp. YAU14A_MKIMI4_1	2072408	S	4	16	20	0.00000
SRR6145058	Staphylococcus schleiferi	1295	S	15	1	16	0.00000
SRR6145058	Staphylococcus piscifermentans	70258	S	15	1	16	0.00000
SRR6145058	Roseburia hominis	301301	S	12	4	16	0.00000
SRR6145058	Rhizobium sp. Khangiran2	1435607	S	13	16	29	0.00000
SRR6145058	Pseudomonas veronii	76761	S	8	8	16	0.00000
SRR6145058	Pseudomonas reinekei	395598	S	15	1	16	0.00000
SRR6145058	Pseudomonas frederiksbergensis	104087	S	14	2	16	0.00000
SRR6145058	Propionibacterium virus SKKY	1982305	S	15	16	31	0.00000
SRR6145058	Propionibacterium virus Procrass1	1982304	S	22	16	38	0.00000
SRR6145058	Propionibacterium virus PHL152M00	1982295	S	60	16	76	0.00001
SRR6145058	Propionibacterium virus PA6	1982269	S	20	16	36	0.00000
SRR6145058	Propionibacterium virus Attacne	1982254	S	29	16	45	0.00000
SRR6145058	Planctomycetes bacterium Enr10	2527978	S	3	16	19	0.00000
SRR6145058	Phycicoccus sp. HDW14	2714941	S	209	16	225	0.00002
SRR6145058	Novosphingobium sp. PP1Y	702113	S	22	16	38	0.00000
SRR6145058	Nocardioides sp. JS614	196162	S	156	16	172	0.00002
SRR6145058	Mixta gaviniae	665914	S	13	3	16	0.00000
SRR6145058	Microbacterium sp. Y-01	2048898	S	129	16	145	0.00002
SRR6145058	Methanococcus aeolicus	42879	S	16	0	16	0.00000
SRR6145058	Mesorhizobium sp. M2A.F.Ca.ET.043.05.1.1	2493671	S	24	16	40	0.00000
SRR6145058	Lelliottia amnigena	61646	S	16	0	16	0.00000
SRR6145058	Lactococcus raffinolactis	1366	S	15	1	16	0.00000
SRR6145058	Lactobacillus jensenii	109790	S	15	1	16	0.00000
SRR6145058	Kerstersia gyiorum	206506	S	15	1	16	0.00000
SRR6145058	Hymenobacter sedentarius	1411621	S	16	0	16	0.00000
SRR6145058	Haloterrigena turkmenica	62320	S	16	0	16	0.00000
SRR6145058	Haloterrigena daqingensis	588898	S	16	0	16	0.00000
SRR6145058	Halalkalicoccus jeotgali	413810	S	16	0	16	0.00000
SRR6145058	Glycocaulis alkaliphilus	1434191	S	16	0	16	0.00000
SRR6145058	Gilliamella apicola	1196095	S	15	1	16	0.00000
SRR6145058	Gemmatimonas phototrophica	1379270	S	16	0	16	0.00000
SRR6145058	Fimbriimonas ginsengisoli	1005039	S	15	1	16	0.00000
SRR6145058	Exiguobacterium sp. AT1b	360911	S	946	16	962	0.00011
SRR6145058	Chryseobacterium sp. G0162	2487063	S	28	16	44	0.00000
SRR6145058	Chitinophaga pinensis	79329	S	15	1	16	0.00000
SRR6145058	Chitinolyticbacter meiyuanensis	682798	S	16	0	16	0.00000
SRR6145058	Caballeronia sp. SBC1	2705548	S	4	16	20	0.00000
SRR6145058	Butyricimonas faecalis	2093856	S	12	4	16	0.00000
SRR6145058	Bifidobacterium gallinarum	78344	S	16	0	16	0.00000
SRR6145058	Arthrospira platensis	118562	S	14	2	16	0.00000
SRR6145058	Anoxybacillus flavithermus	33934	S	15	1	16	0.00000
SRR6145058	Ancylobacter sp. TS-1	1850374	S	63	16	79	0.00001
SRR6145058	Aggregatibacter phage S1249	683735	S	1	16	17	0.00000
SRR6145058	Acinetobacter larvae	1789224	S	16	0	16	0.00000
SRR6145058	[Haemophilus] ducreyi	730	S	15	0	15	0.00000
SRR6145058	Zunongwangia profunda	398743	S	14	1	15	0.00000
SRR6145058	Zoogloeaceae bacteirum Par-f-2	2080469	S	9	15	24	0.00000
SRR6145058	Xylanimicrobium sp. FW10M-9	2509457	S	67	15	82	0.00001
SRR6145058	Vibrio cholerae	666	S	11	4	15	0.00000
SRR6145058	Vibrio alginolyticus	663	S	7	8	15	0.00000
SRR6145058	Variovorax sp. PMC12	2126319	S	67	15	82	0.00001
SRR6145058	Thiohalobacter thiocyanaticus	585455	S	15	0	15	0.00000
SRR6145058	Thioalkalivibrio paradoxus	108010	S	13	2	15	0.00000
SRR6145058	Streptomyces sp. 604F	1476754	S	4	15	19	0.00000
SRR6145058	Streptococcus acidominimus	1326	S	14	1	15	0.00000
SRR6145058	Stenotrophomonas sp. G4	2303750	S	18	15	33	0.00000
SRR6145058	Stenotrophomonas sp. DAIF1	2546450	S	5	15	20	0.00000
SRR6145058	Staphylococcus phage St 134	1958922	S	15	2	17	0.00000
SRR6145058	Spirosoma aerolatum	1211326	S	15	0	15	0.00000
SRR6145058	Sphingomonas sp. AAP5	1523415	S	223	15	238	0.00003
SRR6145058	Serratia sp. SCBI	488142	S	5	15	20	0.00000
SRR6145058	Salinigranum rubrum	755307	S	15	0	15	0.00000
SRR6145058	Roseimaritima ulvae	980254	S	15	0	15	0.00000
SRR6145058	Rhodovulum sp. MB263	308754	S	45	15	60	0.00001
SRR6145058	Pseudomonas coronafaciens	53409	S	14	1	15	0.00000
SRR6145058	Pseudolysobacter antarcticus	2511995	S	15	0	15	0.00000
SRR6145058	Propionibacterium virus PHL095N00	1982283	S	13	15	28	0.00000
SRR6145058	Propionibacterium phage Enoki	1654780	S	20	15	35	0.00000
SRR6145058	Pistricoccus aurantiacus	1883414	S	15	0	15	0.00000
SRR6145058	Pectobacterium brasiliense	180957	S	10	5	15	0.00000
SRR6145058	Paraprevotella xylaniphila	454155	S	13	2	15	0.00000
SRR6145058	Ornithobacterium rhinotracheale	28251	S	15	0	15	0.00000
SRR6145058	Nostoc linckia	92942	S	13	2	15	0.00000
SRR6145058	Nocardioides sp. R-3366	2712223	S	134	15	149	0.00002
SRR6145058	Natronococcus occultus	29288	S	15	0	15	0.00000
SRR6145058	Mycoplasma salivarium	2124	S	5	10	15	0.00000
SRR6145058	Methanosarcina barkeri	2208	S	13	2	15	0.00000
SRR6145058	Megamonas funiformis	437897	S	14	1	15	0.00000
SRR6145058	Mannheimia haemolytica	75985	S	8	7	15	0.00000
SRR6145058	Macrococcus canis	1855823	S	15	0	15	0.00000
SRR6145058	Limnospira indica	147322	S	1	14	15	0.00000
SRR6145058	Leclercia sp. 1106151	2681309	S	3	15	18	0.00000
SRR6145058	Lactobacillus johnsonii	33959	S	12	3	15	0.00000
SRR6145058	Kordia antarctica	1218801	S	14	1	15	0.00000
SRR6145058	Halobacterium salinarum	2242	S	13	2	15	0.00000
SRR6145058	Geobacter sulfurreducens	35554	S	9	6	15	0.00000
SRR6145058	Flavonifractor plautii	292800	S	14	1	15	0.00000
SRR6145058	Flavobacterium sediminis	2201181	S	13	2	15	0.00000
SRR6145058	Flavobacterium indicum	312277	S	15	0	15	0.00000
SRR6145058	Erwinia gerundensis	1619313	S	15	0	15	0.00000
SRR6145058	Diaphorobacter sp. HDW4A	2714924	S	53	15	68	0.00001
SRR6145058	Desulfomicrobium orale	132132	S	15	0	15	0.00000
SRR6145058	Clostridium baratii	1561	S	15	0	15	0.00000
SRR6145058	Cellulomonas sp. PSBB021	2003551	S	72	15	87	0.00001
SRR6145058	Caulobacter sp. K31	366602	S	92	15	107	0.00001
SRR6145058	Burkholderia pseudomultivorans	1207504	S	7	8	15	0.00000
SRR6145058	Burkholderia mallei	13373	S	2	13	15	0.00000
SRR6145058	Bifidobacterium animalis	28025	S	15	0	15	0.00000
SRR6145058	Anaeromyxobacter sp. K	447217	S	14	15	29	0.00000
SRR6145058	Aminobacter sp. MSH1	374606	S	47	15	62	0.00001
SRR6145058	Altererythrobacter sp. NS1	2338327	S	97	15	112	0.00001
SRR6145058	Alistipes onderdonkii	328813	S	13	2	15	0.00000
SRR6145058	Alicyclobacillus acidocaldarius	405212	S	15	0	15	0.00000
SRR6145058	Agrococcus sp. SGAir0287	2070347	S	88	15	103	0.00001
SRR6145058	Agrobacterium sp. H13-3	861208	S	4	15	19	0.00000
SRR6145058	Aeromonas schubertii	652	S	15	0	15	0.00000
SRR6145058	Actinomyces tangfeifanii	1912795	S	15	0	15	0.00000
SRR6145058	Acidovorax sp. 1608163	2478662	S	166	15	181	0.00002
SRR6145058	Acetobacter ghanensis	431306	S	15	0	15	0.00000
SRR6145058	Zymomonas mobilis	542	S	11	3	14	0.00000
SRR6145058	Xanthomonas fragariae	48664	S	14	0	14	0.00000
SRR6145058	Treponema pedis	409322	S	14	0	14	0.00000
SRR6145058	Tardiphaga sp. vice154	2592814	S	2	14	16	0.00000
SRR6145058	Symbiobacterium thermophilum	2734	S	14	0	14	0.00000
SRR6145058	Sulfuriferula plumbiphila	171865	S	13	1	14	0.00000
SRR6145058	Stenotrophomonas sp. ZAC14A_NAIMI4_1	2072412	S	12	14	26	0.00000
SRR6145058	Staphylococcus virus G1	292029	S	2	14	16	0.00000
SRR6145058	Staphylococcus felis	46127	S	14	0	14	0.00000
SRR6145058	Sphingobacterium sp. CZ-2	2557994	S	131	14	145	0.00002
SRR6145058	Shewanella baltica	62322	S	9	5	14	0.00000
SRR6145058	Rouxiella badensis	1646377	S	14	0	14	0.00000
SRR6145058	Rathayibacter toxicus	145458	S	14	0	14	0.00000
SRR6145058	Raoultella electrica	1259973	S	12	2	14	0.00000
SRR6145058	Pseudonocardia sp. HH130630-07	1690815	S	82	14	96	0.00001
SRR6145058	Pseudomonas sp. THAF7b	2587845	S	15	14	29	0.00000
SRR6145058	Pseudomonas sp. J380	2605424	S	13	14	27	0.00000
SRR6145058	Pseudomonas pelagia	553151	S	14	0	14	0.00000
SRR6145058	Pseudomonas cichorii	36746	S	14	0	14	0.00000
SRR6145058	Pseudomonas asturiensis	1190415	S	14	0	14	0.00000
SRR6145058	Pseudarthrobacter sp. NIBRBAC000502770	2590785	S	7	14	21	0.00000
SRR6145058	Propionibacterium virus PHL111M01	1982284	S	15	14	29	0.00000
SRR6145058	Pirellula staleyi	125	S	14	0	14	0.00000
SRR6145058	Phytobacter ursingii	1972431	S	9	5	14	0.00000
SRR6145058	Pelobacter propionicus	29543	S	14	0	14	0.00000
SRR6145058	Pedobacter suwonensis	332999	S	14	0	14	0.00000
SRR6145058	Parvularcula bermudensis	208216	S	14	0	14	0.00000
SRR6145058	Nocardioides sp. dk3136	2575373	S	62	14	76	0.00001
SRR6145058	Niabella ginsenosidivorans	1176587	S	14	0	14	0.00000
SRR6145058	Neoasaia chiangmaiensis	320497	S	14	0	14	0.00000
SRR6145058	Mycobacterium sp. MOTT36Y	1168287	S	4	14	18	0.00000
SRR6145058	Mycobacterium sp. DL90	2487344	S	103	14	117	0.00001
SRR6145058	Methylocaldum marinum	1432792	S	14	0	14	0.00000
SRR6145058	Marinobacterium aestuarii	1821621	S	14	0	14	0.00000
SRR6145058	Maricaulis maris	74318	S	14	0	14	0.00000
SRR6145058	Komagataeibacter medellinensis	1177712	S	12	2	14	0.00000
SRR6145058	Klebsiella quasivariicola	2026240	S	2	12	14	0.00000
SRR6145058	Hydrogenophaga sp. RAC07	1842537	S	59	14	73	0.00001
SRR6145058	Haloferax gibbonsii	35746	S	13	1	14	0.00000
SRR6145058	Gordonibacter pamelaeae	471189	S	9	5	14	0.00000
SRR6145058	Glaesserella parasuis	738	S	13	1	14	0.00000
SRR6145058	Geobacter lovleyi	313985	S	14	0	14	0.00000
SRR6145058	Escherichia fergusonii	564	S	8	6	14	0.00000
SRR6145058	Enterobacter cancerogenus	69218	S	14	0	14	0.00000
SRR6145058	Curtobacterium sp. BH-2-1-1	1905847	S	55	14	69	0.00001
SRR6145058	Campylobacter hominis	76517	S	14	0	14	0.00000
SRR6145058	Burkholderia ambifaria	152480	S	7	7	14	0.00000
SRR6145058	Bremerella volcania	2527984	S	14	0	14	0.00000
SRR6145058	Altererythrobacter sp. B11	2060312	S	60	14	74	0.00001
SRR6145058	Ahniella affigens	2021234	S	14	0	14	0.00000
SRR6145058	Aerococcus urinae	1376	S	14	0	14	0.00000
SRR6145058	Acinetobacter chinensis	2004650	S	11	3	14	0.00000
SRR6145058	[Enterobacter] lignolyticus	1334193	S	13	0	13	0.00000
SRR6145058	Yersinia pestis	632	S	4	9	13	0.00000
SRR6145058	Yersinia enterocolitica	630	S	8	5	13	0.00000
SRR6145058	Thioflavicoccus mobilis	80679	S	13	0	13	0.00000
SRR6145058	Thermaerobacter marianensis	73919	S	12	1	13	0.00000
SRR6145058	Tardiphaga sp. vice352	2592816	S	1	13	14	0.00000
SRR6145058	Streptomyces sp. WAC6273	2588707	S	6	13	19	0.00000
SRR6145058	Streptococcus marmotae	1825069	S	13	0	13	0.00000
SRR6145058	Snodgrassella alvi	1196083	S	13	0	13	0.00000
SRR6145058	Serinicoccus sp. W204	2593973	S	88	13	101	0.00001
SRR6145058	Salicibibacter kimchii	2099786	S	13	0	13	0.00000
SRR6145058	Rhodococcus sp. WAY2	2663121	S	24	13	37	0.00000
SRR6145058	Rhizobium gallicum	56730	S	12	1	13	0.00000
SRR6145058	Raoultella planticola	575	S	11	2	13	0.00000
SRR6145058	Pseudomonas xinjiangensis	487184	S	13	0	13	0.00000
SRR6145058	Pseudomonas sabulinigri	472181	S	13	0	13	0.00000
SRR6145058	Pseudomonas pohangensis	364197	S	13	0	13	0.00000
SRR6145058	Pseudomonas mosselii	78327	S	5	8	13	0.00000
SRR6145058	Propionibacterium virus PHL141N00	1982292	S	11	13	24	0.00000
SRR6145058	Propionibacterium virus PAS50	1982272	S	15	13	28	0.00000
SRR6145058	Phytobacter sp. SCO41	1756993	S	3	13	16	0.00000
SRR6145058	Phaeobacter porticola	1844006	S	11	2	13	0.00000
SRR6145058	Pedobacter sp. PACM 27299	1727164	S	13	0	13	0.00000
SRR6145058	Paraburkholderia phenoliruptrix	252970	S	6	7	13	0.00000
SRR6145058	Pandoraea apista	93218	S	10	3	13	0.00000
SRR6145058	Panacibacter ginsenosidivorans	1813871	S	13	0	13	0.00000
SRR6145058	Niabella soli	446683	S	13	0	13	0.00000
SRR6145058	Natrialbaceae archaeon XQ-INN 246	2419781	S	13	0	13	0.00000
SRR6145058	Muribaculaceae bacterium DSM 108610	2652307	S	13	0	13	0.00000
SRR6145058	Mucilaginibacter gotjawali	1550579	S	13	0	13	0.00000
SRR6145058	Methylobacterium sp. WL1	2603276	S	182	13	195	0.00002
SRR6145058	Lactobacillus vaginalis	1633	S	13	0	13	0.00000
SRR6145058	Labrenzia alexandrii	388408	S	12	1	13	0.00000
SRR6145058	Kosakonia sp. CCTCC M2018092	2492396	S	13	4	17	0.00000
SRR6145058	Intestinimonas butyriciproducens	1297617	S	1	12	13	0.00000
SRR6145058	Haloplanus aerogenes	660522	S	13	0	13	0.00000
SRR6145058	Halopiger xanaduensis	387343	S	13	0	13	0.00000
SRR6145058	Halomonas titanicae	664683	S	5	8	13	0.00000
SRR6145058	Halomonas chromatireducens	507626	S	13	0	13	0.00000
SRR6145058	Halioglobus maricola	2601894	S	13	0	13	0.00000
SRR6145058	Flavobacterium pallidum	2172098	S	13	0	13	0.00000
SRR6145058	Flavobacterium columnare	996	S	13	0	13	0.00000
SRR6145058	Flavisolibacter ginsenosidimutans	661481	S	13	0	13	0.00000
SRR6145058	Erwinia billingiae	182337	S	5	8	13	0.00000
SRR6145058	Ereboglobus luteus	1796921	S	13	0	13	0.00000
SRR6145058	Enterobacter chengduensis	2494701	S	11	2	13	0.00000
SRR6145058	Edwardsiella sp. LADL05-105	1650654	S	1	13	14	0.00000
SRR6145058	Desulfovibrio magneticus	184917	S	11	2	13	0.00000
SRR6145058	Desulfovibrio fairfieldensis	44742	S	13	0	13	0.00000
SRR6145058	Desulfarculus baarsii	453230	S	12	1	13	0.00000
SRR6145058	Corynebacterium sp. 2184	2079535	S	222	13	235	0.00003
SRR6145058	Clostridium sp. MF28	1702238	S	2	13	15	0.00000
SRR6145058	Clostridium saccharoperbutylacetonicum	36745	S	13	0	13	0.00000
SRR6145058	Clostridium beijerinckii	1520	S	8	5	13	0.00000
SRR6145058	Citromicrobium sp. JL477	1634516	S	57	13	70	0.00001
SRR6145058	Citrobacter portucalensis	1639133	S	6	7	13	0.00000
SRR6145058	Chromobacterium haemolyticum	394935	S	3	10	13	0.00000
SRR6145058	Bordetella pertussis	520	S	2	11	13	0.00000
SRR6145058	Bordetella genomosp. 13	463040	S	49	13	62	0.00001
SRR6145058	Blautia producta	33035	S	9	4	13	0.00000
SRR6145058	Bifidobacterium thermophilum	33905	S	13	0	13	0.00000
SRR6145058	Azospirillum sp. TSH100	652764	S	37	13	50	0.00001
SRR6145058	Azoarcus sp. BH72	62928	S	5	13	18	0.00000
SRR6145058	Arthrobacter sp. Rue61a	1118963	S	4	13	17	0.00000
SRR6145058	Alistipes finegoldii	214856	S	10	3	13	0.00000
SRR6145058	Advenella kashmirensis	310575	S	13	0	13	0.00000
SRR6145058	Acidithiobacillus caldus	33059	S	12	1	13	0.00000
SRR6145058	Acidaminococcus intestini	187327	S	13	0	13	0.00000
SRR6145058	Vibrio vulnificus	672	S	12	0	12	0.00000
SRR6145058	Thauera hydrothermalis	2184083	S	5	7	12	0.00000
SRR6145058	Sulfuricaulis limicola	1620215	S	12	0	12	0.00000
SRR6145058	Streptomyces sp. 769	1262452	S	22	12	34	0.00000
SRR6145058	Streptococcus infantarius	102684	S	8	4	12	0.00000
SRR6145058	Streptobacillus moniliformis	34105	S	12	0	12	0.00000
SRR6145058	Stenotrophomonas sp. LM091	1904944	S	69	12	81	0.00001
SRR6145058	Rummeliibacillus stabekisii	241244	S	12	0	12	0.00000
SRR6145058	Rubrobacter radiotolerans	42256	S	12	0	12	0.00000
SRR6145058	Rivularia sp. PCC 7116	373994	S	12	0	12	0.00000
SRR6145058	Rhizobium sp. Kim5	2020311	S	11	12	23	0.00000
SRR6145058	Pseudomonas sp. SWI44	2083053	S	2	12	14	0.00000
SRR6145058	Pseudomonas sp. S09G 359	2054919	S	12	1	13	0.00000
SRR6145058	Pseudomonas sp. 14181154	2662033	S	21	12	33	0.00000
SRR6145058	Pseudomonas poae	200451	S	10	2	12	0.00000
SRR6145058	Pseudomonas litoralis	797277	S	12	0	12	0.00000
SRR6145058	Pseudoalteromonas piscicida	43662	S	11	1	12	0.00000
SRR6145058	Propionibacterium phage QueenBey	1654782	S	39	12	51	0.00001
SRR6145058	Pasteurella dagmatis	754	S	12	0	12	0.00000
SRR6145058	Parolsenella catena	2003188	S	7	5	12	0.00000
SRR6145058	Pandoraea oxalativorans	573737	S	9	3	12	0.00000
SRR6145058	Oceanobacillus iheyensis	182710	S	12	0	12	0.00000
SRR6145058	Natronobacterium gregoryi	44930	S	12	0	12	0.00000
SRR6145058	Myroides phaeus	702745	S	12	0	12	0.00000
SRR6145058	Mycobacterium lepraemurium	64667	S	11	1	12	0.00000
SRR6145058	Methylomonas clara	417	S	12	0	12	0.00000
SRR6145058	Mesorhizobium sp. NIBRBAC000500504	2725666	S	67	12	79	0.00001
SRR6145058	Libanicoccus massiliensis	1871022	S	8	4	12	0.00000
SRR6145058	Legionella sainthelensi	28087	S	12	0	12	0.00000
SRR6145058	Komagataeibacter saccharivorans	265959	S	11	1	12	0.00000
SRR6145058	Kluyvera intermedia	61648	S	11	1	12	0.00000
SRR6145058	Hymenobacter jejuensis	2502781	S	12	0	12	0.00000
SRR6145058	Halostella pelagica	2583824	S	10	2	12	0.00000
SRR6145058	Granulosicoccus antarcticus	437505	S	12	0	12	0.00000
SRR6145058	Gloeobacter kilaueensis	1416614	S	11	1	12	0.00000
SRR6145058	Geobacter bemidjiensis	225194	S	10	2	12	0.00000
SRR6145058	Geobacter anodireducens	1340425	S	6	6	12	0.00000
SRR6145058	Fusobacterium varium	856	S	12	0	12	0.00000
SRR6145058	Frankia sp. QA3	710111	S	43	12	55	0.00001
SRR6145058	Filimonas lacunae	477680	S	12	0	12	0.00000
SRR6145058	Erwinia persicina	55211	S	12	0	12	0.00000
SRR6145058	Enterococcus cecorum	44008	S	12	0	12	0.00000
SRR6145058	Cronobacter malonaticus	413503	S	8	4	12	0.00000
SRR6145058	Cronobacter dublinensis	413497	S	11	1	12	0.00000
SRR6145058	Cobetia marina	28258	S	3	9	12	0.00000
SRR6145058	Citrobacter braakii	57706	S	4	8	12	0.00000
SRR6145058	Candidatus Gracilibacteria bacterium HOT-871	1540872	S	12	0	12	0.00000
SRR6145058	Burkholderia sp. RPE67	758796	S	6	12	18	0.00000
SRR6145058	Burkholderia sp. KK1	1855726	S	12	12	24	0.00000
SRR6145058	Burkholderia oklahomensis	342113	S	11	1	12	0.00000
SRR6145058	Burkholderia anthina	179879	S	8	4	12	0.00000
SRR6145058	Bordetella avium	521	S	12	0	12	0.00000
SRR6145058	Bifidobacterium scardovii	158787	S	12	0	12	0.00000
SRR6145058	Bifidobacterium choerinum	35760	S	12	0	12	0.00000
SRR6145058	Beijerinckiaceae bacterium	1978229	S	12	0	12	0.00000
SRR6145058	Beijerinckia indica	533	S	12	0	12	0.00000
SRR6145058	Barnesiella viscericola	397865	S	11	1	12	0.00000
SRR6145058	Azospirillum sp. M2T2B2	682998	S	27	12	39	0.00000
SRR6145058	Arabia massiliensis	1870985	S	12	0	12	0.00000
SRR6145058	Alcanivorax xenomutans	1094342	S	10	2	12	0.00000
SRR6145058	Acidothermus cellulolyticus	28049	S	12	0	12	0.00000
SRR6145058	Vibrio casei	673372	S	11	0	11	0.00000
SRR6145058	Trueperella bialowiezensis	312285	S	11	0	11	0.00000
SRR6145058	Thermomonas sp. HDW16	2714945	S	91	11	102	0.00001
SRR6145058	Thalassospira marina	2048283	S	11	0	11	0.00000
SRR6145058	Syntrophobacter fumaroxidans	119484	S	11	0	11	0.00000
SRR6145058	Sulfurivermis fontis	1972068	S	10	1	11	0.00000
SRR6145058	Streptomyces sp. RPA4-5	2721245	S	20	11	31	0.00000
SRR6145058	Streptomyces sp. CCM_MD2014	1561022	S	27	11	38	0.00000
SRR6145058	Spirosoma sp. KCTC 42546	2520506	S	11	0	11	0.00000
SRR6145058	Spirosoma montaniterrae	1178516	S	11	0	11	0.00000
SRR6145058	Sphingobium sp. SYK-6	627192	S	67	11	78	0.00001
SRR6145058	Simiduia agarivorans	447471	S	11	0	11	0.00000
SRR6145058	Sideroxydans lithotrophicus	63745	S	11	0	11	0.00000
SRR6145058	Serratia rubidaea	61652	S	8	3	11	0.00000
SRR6145058	Salegentibacter salegens	143223	S	11	0	11	0.00000
SRR6145058	Saccharibacillus brassicae	2583377	S	11	0	11	0.00000
SRR6145058	Runella slithyformis	106	S	11	0	11	0.00000
SRR6145058	Rhodoluna limnophila	232537	S	11	0	11	0.00000
SRR6145058	Rathayibacter sp. VKM Ac-2805	2609258	S	11	21	32	0.00000
SRR6145058	Pseudomonas yamanorum	515393	S	10	1	11	0.00000
SRR6145058	Pseudomonas sp. RU47	2005388	S	6	11	17	0.00000
SRR6145058	Pseudomonas saudiphocaensis	1499686	S	11	0	11	0.00000
SRR6145058	Pseudomonas rhizosphaerae	216142	S	11	0	11	0.00000
SRR6145058	Pseudomonas cedrina	651740	S	10	1	11	0.00000
SRR6145058	Pseudomonas arsenicoxydans	702115	S	11	0	11	0.00000
SRR6145058	Pseudoalteromonas agarivorans	176102	S	5	6	11	0.00000
SRR6145058	Pseudarthrobacter sp. NIBRBAC000502772	2590775	S	21	11	32	0.00000
SRR6145058	Propionibacterium virus PHL114L00	1982287	S	51	11	62	0.00001
SRR6145058	Propionibacterium virus PHL070N00	1982279	S	48	11	59	0.00001
SRR6145058	Polaribacter vadi	1774273	S	10	1	11	0.00000
SRR6145058	Permianibacter aggregans	1510150	S	11	0	11	0.00000
SRR6145058	Pectobacterium polaris	2042057	S	9	2	11	0.00000
SRR6145058	Paraflavitalea soli	2315862	S	11	0	11	0.00000
SRR6145058	Paraburkholderia sp. Msb3	2604047	S	51	11	62	0.00001
SRR6145058	Paraburkholderia dokdonella	2211211	S	11	0	11	0.00000
SRR6145058	Oscillibacter sp. PEA192	2109687	S	3	11	14	0.00000
SRR6145058	Oscillatoria nigro-viridis	482564	S	11	0	11	0.00000
SRR6145058	Ornithinimicrobium sp. AMA3305	2283195	S	130	11	141	0.00002
SRR6145058	Octadecabacter arcticus	53946	S	11	0	11	0.00000
SRR6145058	Ochrobactrum pseudogrignonense	419475	S	7	4	11	0.00000
SRR6145058	Nocardioides sp. HDW12B	2714939	S	111	11	122	0.00001
SRR6145058	Nitrosomonas communis	44574	S	11	0	11	0.00000
SRR6145058	Natronomonas moolapensis	416273	S	11	0	11	0.00000
SRR6145058	Natronolimnobius aegyptiacus	745377	S	11	0	11	0.00000
SRR6145058	Moorea producens	1155739	S	11	0	11	0.00000
SRR6145058	Mesorhizobium sp. M1E.F.Ca.ET.045.02.1.1	2493672	S	28	11	39	0.00000
SRR6145058	Megasphaera elsdenii	907	S	11	0	11	0.00000
SRR6145058	Lysinibacillus sphaericus	1421	S	5	6	11	0.00000
SRR6145058	Lactobacillus pentosus	1589	S	11	0	11	0.00000
SRR6145058	Lactobacillus curvatus	28038	S	10	1	11	0.00000
SRR6145058	Lactobacillus acidophilus	1579	S	9	2	11	0.00000
SRR6145058	Kosakonia sacchari	1158459	S	10	1	11	0.00000
SRR6145058	Klebsiella sp. PO552	1972757	S	2	11	13	0.00000
SRR6145058	Kiritimatiella glycovorans	1307763	S	9	2	11	0.00000
SRR6145058	Halopenitus persicus	1048396	S	11	0	11	0.00000
SRR6145058	Halomonas subglaciescola	29571	S	11	0	11	0.00000
SRR6145058	Halomonas sp. PGE1	2730360	S	24	11	35	0.00000
SRR6145058	Haloarcula sp. CBA1115	1592728	S	4	11	15	0.00000
SRR6145058	Flavobacterium sangjuense	2518177	S	11	0	11	0.00000
SRR6145058	Flavobacterium nackdongense	2547394	S	11	0	11	0.00000
SRR6145058	Flavobacterium arcticum	1784713	S	11	0	11	0.00000
SRR6145058	Erwinia tasmaniensis	338565	S	11	0	11	0.00000
SRR6145058	Dickeya paradisiaca	69223	S	7	4	11	0.00000
SRR6145058	Curtobacterium sp. Csp2	2495430	S	61	11	72	0.00001
SRR6145058	Clostridium septicum	1504	S	11	0	11	0.00000
SRR6145058	Clostridium butyricum	1492	S	11	0	11	0.00000
SRR6145058	Chryseolinea soli	2321403	S	11	0	11	0.00000
SRR6145058	Chloracidobacterium thermophilum	458033	S	11	0	11	0.00000
SRR6145058	Brevundimonas sp. M20	2591463	S	291	11	302	0.00003
SRR6145058	Brevibacillus laterosporus	1465	S	6	5	11	0.00000
SRR6145058	Bordetella holmesii	35814	S	10	1	11	0.00000
SRR6145058	Bacteroides caccae	47678	S	11	0	11	0.00000
SRR6145058	Bacillus pseudomycoides	64104	S	11	0	11	0.00000
SRR6145058	Bacillus oceanisediminis	665099	S	11	0	11	0.00000
SRR6145058	Bacillus cohnii	33932	S	11	0	11	0.00000
SRR6145058	Bacillus circulans	1397	S	11	0	11	0.00000
SRR6145058	Asaia bogorensis	91915	S	11	0	11	0.00000
SRR6145058	Arthrobacter sp. KBS0702	2578107	S	41	11	52	0.00001
SRR6145058	Arenibacter algicola	616991	S	11	0	11	0.00000
SRR6145058	Amycolatopsis sp. BJA-103	1911175	S	47	11	58	0.00001
SRR6145058	Agrobacterium sp. T29	2580515	S	19	11	30	0.00000
SRR6145058	Actinobacillus equuli	718	S	9	2	11	0.00000
SRR6145058	Weeksella virosa	1014	S	10	0	10	0.00000
SRR6145058	Vibrio metschnikovii	28172	S	10	0	10	0.00000
SRR6145058	Vibrio furnissii	29494	S	10	0	10	0.00000
SRR6145058	Vibrio fluvialis	676	S	10	0	10	0.00000
SRR6145058	Tuwongella immobilis	692036	S	10	0	10	0.00000
SRR6145058	Treponema phagedenis	162	S	10	0	10	0.00000
SRR6145058	Thiomonas sp. X19	1050370	S	30	10	40	0.00000
SRR6145058	Thermus scotoductus	37636	S	9	1	10	0.00000
SRR6145058	Thalassospira indica	1891279	S	10	0	10	0.00000
SRR6145058	Thalassolituus oleivorans	187493	S	10	0	10	0.00000
SRR6145058	Tenacibaculum mesophilum	104268	S	8	2	10	0.00000
SRR6145058	Sulfuriferula nivalis	2675298	S	10	0	10	0.00000
SRR6145058	Streptomyces sp. Tu6071	355249	S	7	10	17	0.00000
SRR6145058	Streptomyces sp. NEAU-S7GS2	2202000	S	16	10	26	0.00000
SRR6145058	Streptomyces sp. KPB2	2305221	S	24	10	34	0.00000
SRR6145058	Streptomyces sp. CNQ-509	444103	S	28	10	38	0.00000
SRR6145058	Streptomyces albidoflavus	1886	S	1	9	10	0.00000
SRR6145058	Streptococcus uberis	1349	S	10	0	10	0.00000
SRR6145058	Streptococcus phage SpSL1	1566990	S	5	10	15	0.00000
SRR6145058	Streptococcus phage EJ-1	12402	S	30	10	40	0.00000
SRR6145058	Staphylococcus stepanovicii	643214	S	10	0	10	0.00000
SRR6145058	Spirosoma radiotolerans	1379870	S	10	0	10	0.00000
SRR6145058	Sphaerospermopsis kisseleviana	289435	S	9	1	10	0.00000
SRR6145058	Sedimentisphaera cyanobacteriorum	1940790	S	8	2	10	0.00000
SRR6145058	Scytonema sp. NIES-4073	2005464	S	34	10	44	0.00000
SRR6145058	Salicibibacter halophilus	2502791	S	10	0	10	0.00000
SRR6145058	Salaquimonas pukyongi	2712698	S	10	0	10	0.00000
SRR6145058	Ruminococcus bicirculans	1160721	S	10	0	10	0.00000
SRR6145058	Roseobacter litoralis	42443	S	10	0	10	0.00000
SRR6145058	Roseburia intestinalis	166486	S	9	1	10	0.00000
SRR6145058	Romboutsia hominis	1507512	S	10	0	10	0.00000
SRR6145058	Robiginitalea biformata	252307	S	10	0	10	0.00000
SRR6145058	Rhodovulum sp. P5	1564506	S	48	10	58	0.00001
SRR6145058	Rhodopirellula baltica	265606	S	10	0	10	0.00000
SRR6145058	Rahnella sp. Y9602	741091	S	1	10	11	0.00000
SRR6145058	Pseudopedobacter saltans	151895	S	10	0	10	0.00000
SRR6145058	Pseudomonas xanthomarina	271420	S	10	0	10	0.00000
SRR6145058	Pseudomonas thivervalensis	86265	S	9	1	10	0.00000
SRR6145058	Pseudomonas sp. Os17	1500686	S	5	10	15	0.00000
SRR6145058	Pseudomonas sp. FGI182	1259844	S	12	10	22	0.00000
SRR6145058	Pseudomonas sp. CMR12a	658629	S	4	10	14	0.00000
SRR6145058	Pseudomonas sp. CCOS 191	1649877	S	10	3	13	0.00000
SRR6145058	Pseudomonas salegens	1434072	S	10	0	10	0.00000
SRR6145058	Pseudomonas mucidolens	46679	S	10	0	10	0.00000
SRR6145058	Pseudomonas kribbensis	1628086	S	9	1	10	0.00000
SRR6145058	Pseudomonas granadensis	1421430	S	7	3	10	0.00000
SRR6145058	Pseudomonas alkylphenolica	237609	S	10	0	10	0.00000
SRR6145058	Pseudodesulfovibrio aespoeensis	182210	S	9	1	10	0.00000
SRR6145058	Pseudescherichia vulneris	566	S	10	0	10	0.00000
SRR6145058	Propionibacterium virus PHL171M01	1982297	S	57	10	67	0.00001
SRR6145058	Propionibacterium virus P101A	1982267	S	7	10	17	0.00000
SRR6145058	Propionibacterium virus Kubed	1982256	S	28	10	38	0.00000
SRR6145058	Propionibacterium phage BruceLethal	1654740	S	52	10	62	0.00001
SRR6145058	Pasteurellaceae bacterium NI1060	1679001	S	6	10	16	0.00000
SRR6145058	Paraclostridium bifermentans	1490	S	10	0	10	0.00000
SRR6145058	Paeniclostridium sordellii	1505	S	10	0	10	0.00000
SRR6145058	Paenibacillus swuensis	1178515	S	10	0	10	0.00000
SRR6145058	Oligella urethralis	90245	S	10	0	10	0.00000
SRR6145058	Natronorubrum aibiense	348826	S	10	0	10	0.00000
SRR6145058	Myroides odoratus	256	S	10	0	10	0.00000
SRR6145058	Moraxella bovis	476	S	10	0	10	0.00000
SRR6145058	Miniimonas sp. S16	2171623	S	186	10	196	0.00002
SRR6145058	Microvirga sp. HR1	2651334	S	77	10	87	0.00001
SRR6145058	Micromonospora sp. B006	2201999	S	37	10	47	0.00001
SRR6145058	Microbacterium sp. 10M-3C3	2483401	S	98	10	108	0.00001
SRR6145058	Microbacteriaceae bacterium WY83	1804990	S	78	10	88	0.00001
SRR6145058	Methylovulum psychrotolerans	1704499	S	10	0	10	0.00000
SRR6145058	Methylococcus capsulatus	414	S	10	0	10	0.00000
SRR6145058	Methyloceanibacter caenitepidi	1384459	S	10	0	10	0.00000
SRR6145058	Mageeibacillus indolicus	884684	S	10	0	10	0.00000
SRR6145058	Leisingera sp. NJS201	2508306	S	6	10	16	0.00000
SRR6145058	Komagataeibacter nataicola	265960	S	9	1	10	0.00000
SRR6145058	Janthinobacterium sp. LM6	1938606	S	30	10	40	0.00000
SRR6145058	Hydrogenophaga sp. BPS33	2651974	S	77	10	87	0.00001
SRR6145058	Herminiimonas arsenicoxydans	204773	S	8	2	10	0.00000
SRR6145058	Halovivax ruber	387341	S	10	0	10	0.00000
SRR6145058	Halorubrum trapanicum	29284	S	8	2	10	0.00000
SRR6145058	Haloplanus rallus	1816183	S	10	0	10	0.00000
SRR6145058	Halioglobus japonicus	930805	S	10	0	10	0.00000
SRR6145058	Guyparkeria halophila	47960	S	10	0	10	0.00000
SRR6145058	Geobacter pickeringii	345632	S	10	0	10	0.00000
SRR6145058	Geobacillus sp. C56-T3	691437	S	4	10	14	0.00000
SRR6145058	Geitlerinema sp. PCC 7407	1173025	S	10	0	10	0.00000
SRR6145058	Fusobacterium ulcerans	861	S	10	0	10	0.00000
SRR6145058	Flavobacterium kingsejongi	1678728	S	10	0	10	0.00000
SRR6145058	Flavivirga eckloniae	1803846	S	10	0	10	0.00000
SRR6145058	Eubacterium limosum	1736	S	8	2	10	0.00000
SRR6145058	Dickeya fangzhongdai	1778540	S	3	7	10	0.00000
SRR6145058	Dickeya dadantii	204038	S	8	2	10	0.00000
SRR6145058	Desulfuromonas soudanensis	1603606	S	10	0	10	0.00000
SRR6145058	Desulfovibrio marinus	370038	S	10	0	10	0.00000
SRR6145058	Desulfatibacillum aliphaticivorans	218208	S	10	0	10	0.00000
SRR6145058	Deinococcus sp. NW-56	2080419	S	238	10	248	0.00003
SRR6145058	Deferribacter desulfuricans	197162	S	10	0	10	0.00000
SRR6145058	Corynebacterium sp. 2183	2080740	S	158	10	168	0.00002
SRR6145058	Comamonas sp. NLF-7-7	2597701	S	56	10	66	0.00001
SRR6145058	Clostridium taeniosporum	394958	S	10	0	10	0.00000
SRR6145058	Clostridium saccharobutylicum	169679	S	10	0	10	0.00000
SRR6145058	Clostridium argentinense	29341	S	10	0	10	0.00000
SRR6145058	Chryseobacterium sp. 6424	2039166	S	139	10	149	0.00002
SRR6145058	Chitinophaga sp. 1310	2725416	S	2	10	12	0.00000
SRR6145058	Cellvibrio sp. KY-GH-1	2303332	S	272	10	282	0.00003
SRR6145058	Cellulomonas sp. Y8	2591145	S	101	10	111	0.00001
SRR6145058	Celeribacter marinus	1397108	S	10	0	10	0.00000
SRR6145058	Brevundimonas sp. MF30-B	2561924	S	257	10	267	0.00003
SRR6145058	Brevibacterium sp. WO024	2697563	S	256	10	266	0.00003
SRR6145058	Brenneria goodwinii	1109412	S	7	3	10	0.00000
SRR6145058	Bifidobacterium angulatum	1683	S	10	0	10	0.00000
SRR6145058	Bifidobacterium actinocoloniiforme	638619	S	10	0	10	0.00000
SRR6145058	Bibersteinia trehalosi	47735	S	10	0	10	0.00000
SRR6145058	Bacillus filamentosus	1402861	S	10	0	10	0.00000
SRR6145058	Alistipes dispar	2585119	S	9	1	10	0.00000
SRR6145058	Aeromicrobium sp. 592	2079793	S	59	10	69	0.00001
SRR6145058	Aerococcus christensenii	87541	S	10	0	10	0.00000
SRR6145058	Actinobacillus porcitonsillarum	189834	S	9	1	10	0.00000
SRR6145058	Acinetobacter sp. 10FS3-1	2563897	S	47	10	57	0.00001
SRR6145058	Acetoanaerobium sticklandii	1511	S	10	0	10	0.00000
SRR6145058	[Clostridium] scindens	29347	S	9	0	9	0.00000
SRR6145058	[Clostridium] innocuum	1522	S	4	5	9	0.00000
SRR6145058	Zobellia galactanivorans	63186	S	9	0	9	0.00000
SRR6145058	Weissella paramesenteroides	1249	S	9	0	9	0.00000
SRR6145058	Victivallales bacterium CCUG 44730	2094242	S	9	0	9	0.00000
SRR6145058	Vibrio diabolicus	50719	S	5	4	9	0.00000
SRR6145058	Thalassospira xiamenensis	220697	S	9	0	9	0.00000
SRR6145058	Terriglobus roseus	392734	S	9	0	9	0.00000
SRR6145058	Sulfuriflexus mobilis	1811807	S	9	0	9	0.00000
SRR6145058	Streptomyces sp. SYP-A7193	2662065	S	29	9	38	0.00000
SRR6145058	Streptomyces sp. S8	1837283	S	13	9	22	0.00000
SRR6145058	Streptomyces sp. RLB1-33	2721243	S	25	9	34	0.00000
SRR6145058	Streptomyces sp. CB09001	2083284	S	20	9	29	0.00000
SRR6145058	Streptomyces cinereoruber	67260	S	1	8	9	0.00000
SRR6145058	Streptococcus ratti	1341	S	9	0	9	0.00000
SRR6145058	Staphylococcus phage phiRS7	1403390	S	5	9	14	0.00000
SRR6145058	Staphylococcus hyicus	1284	S	9	0	9	0.00000
SRR6145058	Stanieria cyanosphaera	102116	S	7	2	9	0.00000
SRR6145058	Shewanella sp. FDAARGOS_354	1930557	S	24	9	33	0.00000
SRR6145058	Shewanella algae	38313	S	8	1	9	0.00000
SRR6145058	Salinibaculum litoreum	1710541	S	7	2	9	0.00000
SRR6145058	Salimicrobium jeotgali	1230341	S	9	0	9	0.00000
SRR6145058	Roseobacter denitrificans	2434	S	9	0	9	0.00000
SRR6145058	Roseiflexus castenholzii	120962	S	9	0	9	0.00000
SRR6145058	Rodentibacter pneumotropicus	758	S	9	0	9	0.00000
SRR6145058	Rhodococcus sp. SGAir0479	2567884	S	101	9	110	0.00001
SRR6145058	Rhodobacteraceae bacterium SH-1	2605946	S	50	9	59	0.00001
SRR6145058	Rhizobium sp. IE4771	1301032	S	11	9	20	0.00000
SRR6145058	Psychrobacter cryohalolentis	330922	S	9	0	9	0.00000
SRR6145058	Pseudomonas trivialis	200450	S	8	1	9	0.00000
SRR6145058	Pseudomonas taetrolens	47884	S	9	0	9	0.00000
SRR6145058	Pseudomonas sp. Lz4W	1206777	S	5	9	14	0.00000
SRR6145058	Pseudomonas extremorientalis	169669	S	7	2	9	0.00000
SRR6145058	Pseudomonas asplenii	53407	S	6	3	9	0.00000
SRR6145058	Pseudoalteromonas nigrifaciens	28109	S	3	6	9	0.00000
SRR6145058	Pseudoalteromonas luteoviolacea	43657	S	9	0	9	0.00000
SRR6145058	Proteus vulgaris	585	S	8	1	9	0.00000
SRR6145058	Pontibacter actiniarum	323450	S	9	0	9	0.00000
SRR6145058	Polaribacter reichenbachii	996801	S	8	1	9	0.00000
SRR6145058	Pleurocapsa minor	54308	S	9	0	9	0.00000
SRR6145058	Plantibacter sp. PA-3-X8	2480625	S	13	9	22	0.00000
SRR6145058	Planctomycetes bacterium Pan258	2527981	S	7	9	16	0.00000
SRR6145058	Planctomycetes bacterium Mal52	2527995	S	7	9	16	0.00000
SRR6145058	Planctomycetes bacterium Mal35	2527993	S	1	9	10	0.00000
SRR6145058	Photobacterium damselae	38293	S	9	0	9	0.00000
SRR6145058	Pedobacter cryoconitis	188932	S	9	0	9	0.00000
SRR6145058	Pediococcus pentosaceus	1255	S	8	1	9	0.00000
SRR6145058	Parasedimentitalea marina	2483033	S	9	0	9	0.00000
SRR6145058	Pandoravirus dulcis	1349409	S	9	0	9	0.00000
SRR6145058	Paenibacillus durus	44251	S	9	0	9	0.00000
SRR6145058	Paenibacillus beijingensis	1126833	S	9	0	9	0.00000
SRR6145058	Olsenella umbonata	604330	S	9	0	9	0.00000
SRR6145058	Nostoc punctiforme	272131	S	4	5	9	0.00000
SRR6145058	Nostoc flagelliforme	1306274	S	6	3	9	0.00000
SRR6145058	Nitrospira moscoviensis	42253	S	9	0	9	0.00000
SRR6145058	Nitrospira japonica	1325564	S	9	0	9	0.00000
SRR6145058	Mycobacterium ulcerans	1809	S	5	4	9	0.00000
SRR6145058	Mucilaginibacter xinganensis	1234841	S	9	0	9	0.00000
SRR6145058	Micromonospora sp. WMMA2032	2039870	S	50	9	59	0.00001
SRR6145058	Methylophaga frappieri	754477	S	8	1	9	0.00000
SRR6145058	Methylobacterium sp. 4-46	426117	S	172	9	181	0.00002
SRR6145058	Marinobacter sp. CP1	1671721	S	7	9	16	0.00000
SRR6145058	Marinithermus hydrothermalis	186192	S	9	0	9	0.00000
SRR6145058	Mannheimia varigena	85404	S	8	1	9	0.00000
SRR6145058	Listeria monocytogenes	1639	S	7	2	9	0.00000
SRR6145058	Leptolyngbya boryana	1184	S	9	0	9	0.00000
SRR6145058	Lelliottia nimipressuralis	69220	S	8	1	9	0.00000
SRR6145058	Leisingera sp. NJS204	2508307	S	5	9	14	0.00000
SRR6145058	Leclercia sp. W6	2282310	S	5	9	14	0.00000
SRR6145058	Lactobacillus amylovorus	1604	S	8	1	9	0.00000
SRR6145058	Labrenzia sp. CP4	1674922	S	1	9	10	0.00000
SRR6145058	Kushneria marisflavi	157779	S	8	1	9	0.00000
SRR6145058	Jonesia denitrificans	43674	S	9	0	9	0.00000
SRR6145058	Jeotgalibacillus malaysiensis	1508404	S	9	0	9	0.00000
SRR6145058	Hungatella hathewayi	154046	S	9	0	9	0.00000
SRR6145058	Heliobacterium modesticaldum	35701	S	9	0	9	0.00000
SRR6145058	Halomonas venusta	44935	S	8	1	9	0.00000
SRR6145058	Gimesia sp. E7	2608982	S	4	9	13	0.00000
SRR6145058	Gibbsiella quercinecans	929813	S	9	0	9	0.00000
SRR6145058	Geosporobacter ferrireducens	1424294	S	9	0	9	0.00000
SRR6145058	Flavobacterium magnum	2162713	S	9	0	9	0.00000
SRR6145058	Flavobacterium faecale	1355330	S	9	0	9	0.00000
SRR6145058	Flammeovirga pectinis	2494373	S	9	0	9	0.00000
SRR6145058	Ferrimonas balearica	44012	S	9	0	9	0.00000
SRR6145058	Enterococcus saigonensis	1805431	S	8	1	9	0.00000
SRR6145058	Echinicola rosea	1807691	S	7	2	9	0.00000
SRR6145058	Desulfomicrobium baculatum	899	S	9	0	9	0.00000
SRR6145058	Desulfobulbus propionicus	894	S	9	0	9	0.00000
SRR6145058	Cryobacterium sp. GCJ02	2220095	S	24	9	33	0.00000
SRR6145058	Cronobacter condimenti	1163710	S	9	0	9	0.00000
SRR6145058	Crinalium epipsammum	241425	S	9	0	9	0.00000
SRR6145058	Cohnella candidum	2674991	S	9	0	9	0.00000
SRR6145058	Clostridium estertheticum	238834	S	9	0	9	0.00000
SRR6145058	Clostridium diolis	223919	S	1	8	9	0.00000
SRR6145058	Cloacibacillus porcorum	1197717	S	9	0	9	0.00000
SRR6145058	Chryseobacterium sp. POL2	2713414	S	78	9	87	0.00001
SRR6145058	Chryseobacterium sp. G0186	2487064	S	38	9	47	0.00001
SRR6145058	Chitinophaga caeni	2029983	S	9	0	9	0.00000
SRR6145058	Cellulomonas sp. JZ18	2654191	S	58	9	67	0.00001
SRR6145058	Calothrix sp. 336/3	1337936	S	9	9	18	0.00000
SRR6145058	Calothrix brevissima	938406	S	7	2	9	0.00000
SRR6145058	Burkholderia sp. MSMB1588	1636423	S	2	9	11	0.00000
SRR6145058	Brucella suis	29461	S	1	8	9	0.00000
SRR6145058	Bacillus thermoamylovorans	35841	S	9	0	9	0.00000
SRR6145058	Bacillus mesonae	1193713	S	9	0	9	0.00000
SRR6145058	Arcobacter peruensis	2320140	S	4	5	9	0.00000
SRR6145058	Arcobacter ellisii	913109	S	8	1	9	0.00000
SRR6145058	Arcobacter cryaerophilus	28198	S	8	1	9	0.00000
SRR6145058	Arcanobacterium phocae	131112	S	9	0	9	0.00000
SRR6145058	Altererythrobacter ishigakiensis	476157	S	9	0	9	0.00000
SRR6145058	Alkalitalea saponilacus	889453	S	9	0	9	0.00000
SRR6145058	Akkermansia muciniphila	239935	S	9	0	9	0.00000
SRR6145058	Aequorivita sublithincola	101385	S	9	0	9	0.00000
SRR6145058	Advenella mimigardefordensis	302406	S	9	0	9	0.00000
SRR6145058	Acidobacterium capsulatum	33075	S	9	0	9	0.00000
SRR6145058	Acidisarcina polymorpha	2211140	S	9	0	9	0.00000
SRR6145058	haloarchaeon 3A1-DGR	1071085	S	8	0	8	0.00000
SRR6145058	[Eubacterium] minutum	76124	S	8	0	8	0.00000
SRR6145058	Xanthomonas phaseoli	1985254	S	6	2	8	0.00000
SRR6145058	Tumebacillus avium	1903704	S	8	0	8	0.00000
SRR6145058	Terriglobus albidus	1592106	S	8	0	8	0.00000
SRR6145058	Tardiphaga sp. vice304	2592817	S	1	8	9	0.00000
SRR6145058	Synechocystis sp. PCC 6714	1147	S	8	4	12	0.00000
SRR6145058	Streptomyces sp. S1D4-11	2721246	S	22	8	30	0.00000
SRR6145058	Streptomyces sp. Go-475	2072505	S	36	8	44	0.00000
SRR6145058	Streptomyces sp. FR-008	206662	S	1	8	9	0.00000
SRR6145058	Streptococcus sp. NCTC 11567	2583584	S	8	56	64	0.00001
SRR6145058	Streptococcus sp. NCTC 10228	2583585	S	8	4	12	0.00000
SRR6145058	Streptococcus halotolerans	1814128	S	8	0	8	0.00000
SRR6145058	Stenotrophomonas sp. ZAC14D2_NAIMI4_7	2072405	S	14	8	22	0.00000
SRR6145058	Stenotrophomonas sp. SAU14A_NAIMI4_8	2072409	S	2	8	10	0.00000
SRR6145058	Stenotrophomonas sp. SAU14A_NAIMI4_5	2072413	S	27	8	35	0.00000
SRR6145058	Sphingobacterium psychroaquaticum	561061	S	8	0	8	0.00000
SRR6145058	Solibacillus silvestris	76853	S	8	0	8	0.00000
SRR6145058	Shigella flexneri	623	S	1	7	8	0.00000
SRR6145058	Shewanella loihica	359303	S	8	0	8	0.00000
SRR6145058	Sebaldella termitidis	826	S	8	0	8	0.00000
SRR6145058	Salinivirga cyanobacteriivorans	1307839	S	8	0	8	0.00000
SRR6145058	Roseovarius sp. TM1035	391613	S	8	8	16	0.00000
SRR6145058	Rhodoferax sp. BAB1	2741720	S	84	8	92	0.00001
SRR6145058	Rhizobium sp. JKLM12A2	2583231	S	4	8	12	0.00000
SRR6145058	Raphidiopsis curvata	312883	S	8	0	8	0.00000
SRR6145058	Psychrobacter sp. PRwf-1	349106	S	11	8	19	0.00000
SRR6145058	Psychrobacter arcticus	334543	S	8	0	8	0.00000
SRR6145058	Pseudonocardia sp. Gen01	2736640	S	174	8	182	0.00002
SRR6145058	Pseudomonas vancouverensis	95300	S	8	0	8	0.00000
SRR6145058	Pseudomonas sp. XWY-1	2069256	S	4	8	12	0.00000
SRR6145058	Pseudomonas sp. MRSN12121	1611770	S	8	8	16	0.00000
SRR6145058	Pseudomonas sp. LPH1	1898684	S	33	8	41	0.00000
SRR6145058	Pseudomonas sp. LG1D9	2083054	S	3	8	11	0.00000
SRR6145058	Pseudomonas sp. ADAK22	2730851	S	4	8	12	0.00000
SRR6145058	Pseudomonas corrugata	47879	S	8	0	8	0.00000
SRR6145058	Pseudomonas cerasi	1583341	S	3	5	8	0.00000
SRR6145058	Pseudohongiella spirulinae	1249552	S	8	0	8	0.00000
SRR6145058	Providencia rustigianii	158850	S	8	0	8	0.00000
SRR6145058	Providencia rettgeri	587	S	4	4	8	0.00000
SRR6145058	Proteiniphilum saccharofermentans	1642647	S	8	0	8	0.00000
SRR6145058	Propionibacterium virus Pacnes201215	1982270	S	50	8	58	0.00001
SRR6145058	Propionibacterium virus PAD20	1982271	S	10	8	18	0.00000
SRR6145058	Piscirickettsia salmonis	1238	S	8	0	8	0.00000
SRR6145058	Photorhabdus laumondii	2218628	S	8	0	8	0.00000
SRR6145058	Pedobacter ginsengisoli	363852	S	8	0	8	0.00000
SRR6145058	Paenibacillus thiaminolyticus	49283	S	8	0	8	0.00000
SRR6145058	Otariodibacter oris	1032623	S	8	0	8	0.00000
SRR6145058	Nocardioides sp. 78	2045452	S	67	8	75	0.00001
SRR6145058	Nitrospira defluvii	330214	S	8	0	8	0.00000
SRR6145058	Niastella koreensis	354356	S	8	0	8	0.00000
SRR6145058	Natrinema versiforme	88724	S	8	0	8	0.00000
SRR6145058	Mucilaginibacter paludis	423351	S	8	0	8	0.00000
SRR6145058	Mucilaginibacter ginsenosidivorax	862126	S	8	0	8	0.00000
SRR6145058	Moraxella cuniculi	34061	S	8	0	8	0.00000
SRR6145058	Mixta theicola	1458355	S	7	1	8	0.00000
SRR6145058	Methanococcus maripaludis	39152	S	8	0	8	0.00000
SRR6145058	Marivirga tractuosa	1006	S	7	1	8	0.00000
SRR6145058	Marinobacter fonticola	2603215	S	8	0	8	0.00000
SRR6145058	Marinirhabdus gelatinilytica	1703343	S	8	0	8	0.00000
SRR6145058	Mahella australiensis	252966	S	8	0	8	0.00000
SRR6145058	Lutibacter profundi	1622118	S	8	0	8	0.00000
SRR6145058	Listeria innocua	1642	S	3	5	8	0.00000
SRR6145058	Legionella fallonii	96230	S	8	0	8	0.00000
SRR6145058	Lactobacillus rossiae	231049	S	8	0	8	0.00000
SRR6145058	Lactobacillus parabuchneri	152331	S	8	0	8	0.00000
SRR6145058	Kushneria konosiri	698828	S	7	1	8	0.00000
SRR6145058	Ktedonosporobacter rubrisoli	2509675	S	8	0	8	0.00000
SRR6145058	Komagataeibacter europaeus	33995	S	7	1	8	0.00000
SRR6145058	Jeotgalibaca dankookensis	708126	S	8	0	8	0.00000
SRR6145058	Ilyobacter polytropus	167642	S	8	0	8	0.00000
SRR6145058	Hymenobacter sp. APR13	1356852	S	29	8	37	0.00000
SRR6145058	Histophilus somni	731	S	8	0	8	0.00000
SRR6145058	Halostagnicola larsenii	353800	S	8	0	8	0.00000
SRR6145058	Haloplanus sp. CBA1112	1547898	S	5	8	13	0.00000
SRR6145058	Halomonas campaniensis	213554	S	5	3	8	0.00000
SRR6145058	Halomicrobium mukohataei	57705	S	8	0	8	0.00000
SRR6145058	Halalkaliarchaeum desulfuricum	2055893	S	8	0	8	0.00000
SRR6145058	Gramella fulva	2126553	S	8	0	8	0.00000
SRR6145058	Gramella flava	1486245	S	8	0	8	0.00000
SRR6145058	Gordonibacter urolithinfaciens	1335613	S	6	2	8	0.00000
SRR6145058	Gordonia sp. X0973	2742602	S	107	8	115	0.00001
SRR6145058	Gloeothece citriformis	2546356	S	8	0	8	0.00000
SRR6145058	Gemmata sp. SH-PL17	1630693	S	22	8	30	0.00000
SRR6145058	Fusobacterium mortiferum	850	S	8	0	8	0.00000
SRR6145058	Fuerstia marisgermanicae	1891926	S	8	0	8	0.00000
SRR6145058	Fluoribacter dumoffii	463	S	8	0	8	0.00000
SRR6145058	Erysipelothrix rhusiopathiae	1648	S	7	1	8	0.00000
SRR6145058	Enterococcus sp. HSIEG1	1316414	S	1	8	9	0.00000
SRR6145058	Enterococcus sp. FDAARGOS_553	2420313	S	1	8	9	0.00000
SRR6145058	Enterocloster clostridioformis	1531	S	3	5	8	0.00000
SRR6145058	Enterobacter ludwigii	299767	S	3	5	8	0.00000
SRR6145058	Edwardsiella hoshinae	93378	S	8	0	8	0.00000
SRR6145058	Duncaniella dubosii	2518971	S	8	0	8	0.00000
SRR6145058	Dickeya solani	1089444	S	7	1	8	0.00000
SRR6145058	Desulfosarcina widdelii	947919	S	8	0	8	0.00000
SRR6145058	Crateriforma conspicua	2527996	S	8	0	8	0.00000
SRR6145058	Corynebacterium sp. 2019	2675218	S	87	8	95	0.00001
SRR6145058	Congregibacter litoralis	393662	S	8	0	8	0.00000
SRR6145058	Citrobacter werkmanii	67827	S	5	3	8	0.00000
SRR6145058	Citrobacter rodentium	67825	S	8	0	8	0.00000
SRR6145058	Cellulomonas sp. H30R-01	2704467	S	46	8	54	0.00001
SRR6145058	Cedecea lapagei	158823	S	8	0	8	0.00000
SRR6145058	Campylobacter blaseri	2042961	S	8	0	8	0.00000
SRR6145058	Caballeronia sp. SBC2	2705547	S	3	8	11	0.00000
SRR6145058	Burkholderiales bacterium JOSHI_001	864051	S	143	8	151	0.00002
SRR6145058	Burkholderia sp. PAMC 26561	1795043	S	8	8	16	0.00000
SRR6145058	Brucella melitensis	29459	S	1	7	8	0.00000
SRR6145058	Brevundimonas sp. LM2	1938605	S	222	8	230	0.00003
SRR6145058	Bernardetia litoralis	999	S	8	0	8	0.00000
SRR6145058	Belliella baltica	232259	S	8	0	8	0.00000
SRR6145058	Bartonella elizabethae	807	S	5	3	8	0.00000
SRR6145058	Bacteroides xylanisolvens	371601	S	5	3	8	0.00000
SRR6145058	Bacteroides intestinalis	329854	S	8	0	8	0.00000
SRR6145058	Bacillus pseudofirmus	79885	S	8	0	8	0.00000
SRR6145058	Bacillus licheniformis	1402	S	3	5	8	0.00000
SRR6145058	Bacillus coagulans	1398	S	8	0	8	0.00000
SRR6145058	Arthrobacter sp. UKPF54-2	2600159	S	30	8	38	0.00000
SRR6145058	Arsenophonus nasoniae	638	S	8	0	8	0.00000
SRR6145058	Arcobacter mytili	603050	S	8	0	8	0.00000
SRR6145058	Aquitalea denitrificans	519081	S	7	1	8	0.00000
SRR6145058	Aquiflexum balticum	280473	S	8	0	8	0.00000
SRR6145058	Anoxybacter fermentans	1323375	S	8	0	8	0.00000
SRR6145058	Aminomonas paucivorans	81412	S	8	0	8	0.00000
SRR6145058	Aliivibrio fischeri	668	S	8	0	8	0.00000
SRR6145058	Algoriphagus machipongonensis	388413	S	8	0	8	0.00000
SRR6145058	Aeromonas sp. ASNIH4	1636609	S	4	8	12	0.00000
SRR6145058	Aerococcus urinaehominis	128944	S	8	0	8	0.00000
SRR6145058	Actinomyces sp. Chiba101	1851395	S	165	8	173	0.00002
SRR6145058	Actinomyces sp. 432	2057798	S	89	8	97	0.00001
SRR6145058	Acinetobacter sp. ACNIH2	1758189	S	57	8	65	0.00001
SRR6145058	Acidovorax sp. HDW3	2714923	S	59	8	67	0.00001
SRR6145058	Acidihalobacter ferrooxidans	1765967	S	8	0	8	0.00000
SRR6145058	Acetobacter sp. KACC 21233	2592655	S	8	0	8	0.00000
SRR6145058	Yersinia kristensenii	28152	S	4	3	7	0.00000
SRR6145058	Yangia sp. CCB-MM3	1792508	S	50	7	57	0.00001
SRR6145058	Vibrio campbellii	680	S	6	1	7	0.00000
SRR6145058	Variovorax sp. PBS-H4	434008	S	43	7	50	0.00001
SRR6145058	Vagococcus teuberi	519472	S	7	0	7	0.00000
SRR6145058	Turneriella parva	29510	S	7	0	7	0.00000
SRR6145058	Treponema succinifaciens	167	S	7	0	7	0.00000
SRR6145058	Treponema azotonutricium	150829	S	7	0	7	0.00000
SRR6145058	Thiomicrospira cyclica	147268	S	7	0	7	0.00000
SRR6145058	Thiolapillus brandeum	1076588	S	7	0	7	0.00000
SRR6145058	Tenacibaculum jejuense	584609	S	7	0	7	0.00000
SRR6145058	Syntrophobotulus glycolicus	51197	S	7	0	7	0.00000
SRR6145058	Synechococcus sp. PCC 7336	195250	S	7	0	7	0.00000
SRR6145058	Sulfuricella denitrificans	649841	S	7	0	7	0.00000
SRR6145058	Sulfitobacter sp. SK025	1389011	S	23	7	30	0.00000
SRR6145058	Streptomyces sp. Sge12	1972846	S	10	7	17	0.00000
SRR6145058	Streptomyces sp. CFMR 7	1649184	S	7	15	22	0.00000
SRR6145058	Stenotrophomonas sp. YAU14D1_LEIMI4_1	2072407	S	7	7	14	0.00000
SRR6145058	Starkeya sp. ORNL1	2709380	S	68	7	75	0.00001
SRR6145058	Staphylococcus virus Sextaec	1922246	S	40	7	47	0.00001
SRR6145058	Staphylococcus virus BS1	2734046	S	3	7	10	0.00000
SRR6145058	Spiroplasma citri	2133	S	3	4	7	0.00000
SRR6145058	Spiribacter salinus	1335746	S	7	0	7	0.00000
SRR6145058	Spiribacter roseus	1855875	S	7	0	7	0.00000
SRR6145058	Spiribacter curvatus	1335757	S	7	0	7	0.00000
SRR6145058	Sphingopyxis sp. QXT-31	1357916	S	70	7	77	0.00001
SRR6145058	Sodalis glossinidius	63612	S	7	0	7	0.00000
SRR6145058	Shewanella woodyi	60961	S	7	0	7	0.00000
SRR6145058	Shewanella denitrificans	192073	S	7	0	7	0.00000
SRR6145058	Serratia sp. LS-1	2485839	S	1	7	8	0.00000
SRR6145058	Serratia sp. JKS000199	1938820	S	1	7	8	0.00000
SRR6145058	Serratia proteamaculans	28151	S	5	2	7	0.00000
SRR6145058	Sedimenticola thiotaurini	1543721	S	7	0	7	0.00000
SRR6145058	Rubinisphaera brasiliensis	119	S	7	0	7	0.00000
SRR6145058	Roseovarius sp. THAF9	2587847	S	30	7	37	0.00000
SRR6145058	Roseivivax sp. THAF30	2587852	S	37	7	44	0.00000
SRR6145058	Rickettsia amblyommatis	33989	S	5	2	7	0.00000
SRR6145058	Rhodococcus sp. MTM3W5.2	1805827	S	121	7	128	0.00001
SRR6145058	Rhizobium sp. TAL182	2020313	S	3	7	10	0.00000
SRR6145058	Pseudomonas sp. URMO17WK12:I11	1283291	S	11	7	18	0.00000
SRR6145058	Pseudomonas sp. S150	2559074	S	7	7	14	0.00000
SRR6145058	Pseudomonas sp. R2-7-07	658641	S	1	7	8	0.00000
SRR6145058	Pseudomonas sp. R2-37-08W	1173273	S	2	7	9	0.00000
SRR6145058	Pseudomonas silesiensis	1853130	S	7	0	7	0.00000
SRR6145058	Pseudomonas mediterranea	183795	S	7	0	7	0.00000
SRR6145058	Pseudomonas agarici	46677	S	7	0	7	0.00000
SRR6145058	Providencia stuartii	588	S	6	1	7	0.00000
SRR6145058	Propionibacterium virus PHL199M00	1982300	S	41	7	48	0.00001
SRR6145058	Propionibacterium virus P100A	1982265	S	50	7	57	0.00001
SRR6145058	Porphyrobacter sp. HT-58-2	2023229	S	48	7	55	0.00001
SRR6145058	Pontimonas salivibrio	1159327	S	7	0	7	0.00000
SRR6145058	Pontibacter korlensis	400092	S	7	0	7	0.00000
SRR6145058	Polynucleobacter wuianus	1743168	S	6	1	7	0.00000
SRR6145058	Polynucleobacter asymbioticus	576611	S	7	0	7	0.00000
SRR6145058	Polynucleobacter acidiphobus	556053	S	7	0	7	0.00000
SRR6145058	Planococcus plakortidis	1038856	S	7	0	7	0.00000
SRR6145058	Planococcus antarcticus	161360	S	7	0	7	0.00000
SRR6145058	Pelobacter acetylenicus	29542	S	7	0	7	0.00000
SRR6145058	Pectobacterium parmentieri	1905730	S	6	1	7	0.00000
SRR6145058	Paludibacter propionicigenes	185300	S	7	0	7	0.00000
SRR6145058	Paenisporosarcina antarctica	417367	S	7	0	7	0.00000
SRR6145058	Paenibacillus sp. FSL R7-0273	1536772	S	7	0	7	0.00000
SRR6145058	Paenibacillus bovis	1616788	S	7	0	7	0.00000
SRR6145058	Odoribacter splanchnicus	28118	S	7	0	7	0.00000
SRR6145058	Nostoc sp. PCC 7524	28072	S	7	0	7	0.00000
SRR6145058	Nostoc carneum	374162	S	3	4	7	0.00000
SRR6145058	Nonomuraea sp. WYY166	2656914	S	105	7	112	0.00001
SRR6145058	Nocardioides sp. HY056	2500546	S	53	7	60	0.00001
SRR6145058	Neisseriaceae bacterium DSM 100970	2052837	S	7	0	7	0.00000
SRR6145058	Natronorubrum bangense	61858	S	7	0	7	0.00000
SRR6145058	Natrinema pellirubrum	69525	S	6	1	7	0.00000
SRR6145058	Natrinema pallidum	69527	S	6	1	7	0.00000
SRR6145058	Mycobacterium sp. MS1601	1936029	S	128	7	135	0.00001
SRR6145058	Mycobacterium leprae	1769	S	7	0	7	0.00000
SRR6145058	Muricauda ruestringensis	111501	S	7	0	7	0.00000
SRR6145058	Microbulbifer hydrolyticus	48074	S	7	0	7	0.00000
SRR6145058	Microbacterium sp. PM5	2014534	S	159	7	166	0.00002
SRR6145058	Methylomonas koyamae	702114	S	5	2	7	0.00000
SRR6145058	Methylomicrobium album	39775	S	7	0	7	0.00000
SRR6145058	Mesorhizobium sp. M4B.F.Ca.ET.058.02.1.1	2493675	S	27	7	34	0.00000
SRR6145058	Mesorhizobium sp. M1B.F.Ca.ET.045.04.1.1	2493673	S	29	7	36	0.00000
SRR6145058	Megasphaera stantonii	2144175	S	7	0	7	0.00000
SRR6145058	Maritalea myrionectae	454601	S	7	0	7	0.00000
SRR6145058	Marinobacter salinus	1874317	S	7	0	7	0.00000
SRR6145058	Marinitoga piezophila	149715	S	1	6	7	0.00000
SRR6145058	Limnochorda pilosa	1555112	S	7	0	7	0.00000
SRR6145058	Leuconostoc kimchii	136609	S	1	6	7	0.00000
SRR6145058	Leuconostoc garlicum	255248	S	3	4	7	0.00000
SRR6145058	Lactococcus phage jm2	1262535	S	7	7	14	0.00000
SRR6145058	Lactobacillus reuteri	1598	S	7	0	7	0.00000
SRR6145058	Lactobacillus amylolyticus	83683	S	7	0	7	0.00000
SRR6145058	Labilibaculum antarcticum	1717717	S	7	0	7	0.00000
SRR6145058	Komagataeibacter oboediens	65958	S	7	0	7	0.00000
SRR6145058	Klebsiella sp. LY	2015795	S	1	7	8	0.00000
SRR6145058	Jonquetella anthropi	428712	S	7	0	7	0.00000
SRR6145058	Jeotgalibaca arthritidis	1868794	S	4	3	7	0.00000
SRR6145058	Hymenobacter sp. HDW8	2714932	S	6	7	13	0.00000
SRR6145058	Hathewaya histolytica	1498	S	7	0	7	0.00000
SRR6145058	Haloferax volcanii	2246	S	3	4	7	0.00000
SRR6145058	Haloferax mediterranei	2252	S	7	0	7	0.00000
SRR6145058	Haloferax alexandrinus	114529	S	3	4	7	0.00000
SRR6145058	Haliscomenobacter hydrossis	2350	S	7	0	7	0.00000
SRR6145058	Hafnia alvei	569	S	4	3	7	0.00000
SRR6145058	Granulicella tundricola	940615	S	7	0	7	0.00000
SRR6145058	Granulicella mallensis	940614	S	7	0	7	0.00000
SRR6145058	Gloeomargarita lithophora	1188228	S	7	0	7	0.00000
SRR6145058	Gloeobacter violaceus	33072	S	7	0	7	0.00000
SRR6145058	Geminocystis herdmanii	669359	S	7	0	7	0.00000
SRR6145058	Gammapapillomavirus 12	1513257	S	7	0	7	0.00000
SRR6145058	Fluviicola taffensis	191579	S	7	0	7	0.00000
SRR6145058	Flavobacterium psychrophilum	96345	S	7	0	7	0.00000
SRR6145058	Flavobacterium gilvum	1492737	S	7	0	7	0.00000
SRR6145058	Faecalibaculum rodentium	1702221	S	7	0	7	0.00000
SRR6145058	Exiguobacterium sibiricum	332410	S	7	0	7	0.00000
SRR6145058	Escherichia albertii	208962	S	6	1	7	0.00000
SRR6145058	Erwinia amylovora	552	S	5	2	7	0.00000
SRR6145058	Enterococcus sp. DA9	2603296	S	1	7	8	0.00000
SRR6145058	Enterococcus hirae	1354	S	7	0	7	0.00000
SRR6145058	Emcibacter congregatus	2043170	S	7	0	7	0.00000
SRR6145058	Ectothiorhodospira haloalkaliphila	421628	S	6	1	7	0.00000
SRR6145058	Dialister hominis	2582419	S	1	6	7	0.00000
SRR6145058	Desulfovibrio gigas	879	S	7	0	7	0.00000
SRR6145058	Desulfovibrio carbinolicus	296842	S	6	1	7	0.00000
SRR6145058	Cylindrospermum stagnale	142864	S	7	0	7	0.00000
SRR6145058	Cronobacter universalis	535744	S	5	2	7	0.00000
SRR6145058	Cronobacter turicensis	413502	S	6	1	7	0.00000
SRR6145058	Cronobacter muytjensii	413501	S	2	5	7	0.00000
SRR6145058	Clostridium sp. SYSU GA15002T	2587161	S	7	0	7	0.00000
SRR6145058	Clostridium novyi	1542	S	7	0	7	0.00000
SRR6145058	Clostridium bornimense	1216932	S	7	0	7	0.00000
SRR6145058	Citrobacter farmeri	67824	S	5	2	7	0.00000
SRR6145058	Chloroflexus aggregans	152260	S	6	1	7	0.00000
SRR6145058	Cellulophaga algicola	59600	S	7	0	7	0.00000
SRR6145058	Candidatus Saccharibacteria bacterium YM_S32_TM7_50_20	2056494	S	7	0	7	0.00000
SRR6145058	Burkholderia sp. JP2-270	2217913	S	14	7	21	0.00000
SRR6145058	Brevibacillus agri	51101	S	7	0	7	0.00000
SRR6145058	Bradyrhizobium sp. CCGE-LA001	1223566	S	44	7	51	0.00001
SRR6145058	Bordetella genomosp. 6	463024	S	4	7	11	0.00000
SRR6145058	Blattabacterium punctulatus	164514	S	4	3	7	0.00000
SRR6145058	Bacteroides cellulosilyticus	246787	S	7	0	7	0.00000
SRR6145058	Bacteroides caecimuris	1796613	S	6	1	7	0.00000
SRR6145058	Bacillus toyonensis	155322	S	1	6	7	0.00000
SRR6145058	Bacillus paralicheniformis	1648923	S	7	0	7	0.00000
SRR6145058	Bacillus halodurans	86665	S	7	0	7	0.00000
SRR6145058	Bacillus cytotoxicus	580165	S	7	0	7	0.00000
SRR6145058	Bacillus asahii	228899	S	7	0	7	0.00000
SRR6145058	Arcticibacterium luteifluviistationis	1784714	S	7	0	7	0.00000
SRR6145058	Alistipes megaguti	2364787	S	7	0	7	0.00000
SRR6145058	Alistipes communis	2585118	S	7	0	7	0.00000
SRR6145058	Algoriphagus sanaruensis	1727163	S	7	0	7	0.00000
SRR6145058	Aeromonas dhakensis	196024	S	4	3	7	0.00000
SRR6145058	Aerococcus sanguinicola	119206	S	7	0	7	0.00000
SRR6145058	Adlercreutzia equolifaciens	446660	S	4	3	7	0.00000
SRR6145058	Actinobacillus suis	716	S	5	2	7	0.00000
SRR6145058	Actinobacillus pleuropneumoniae	715	S	4	3	7	0.00000
SRR6145058	Acinetobacter sp. C16S1	2609668	S	31	7	38	0.00000
SRR6145058	Acidimicrobium ferrooxidans	53635	S	7	0	7	0.00000
SRR6145058	Acholeplasma axanthum	29552	S	7	0	7	0.00000
SRR6145058	[Brevibacterium] frigoritolerans	450367	S	6	0	6	0.00000
SRR6145058	[Bacillus] caldolyticus	1394	S	1	5	6	0.00000
SRR6145058	Xenorhabdus doucetiae	351671	S	6	0	6	0.00000
SRR6145058	Weissella viridescens	1629	S	6	0	6	0.00000
SRR6145058	Turicibacter sanguinis	154288	S	6	0	6	0.00000
SRR6145058	Treponema brennaborense	81028	S	6	0	6	0.00000
SRR6145058	Tolypothrix sp. PCC 7910	2099387	S	6	3	9	0.00000
SRR6145058	Thermoanaerobacter ethanolicus	1757	S	1	5	6	0.00000
SRR6145058	Thauera sp. K11	2005884	S	60	6	66	0.00001
SRR6145058	Tetrasphaera sp. HKS02	1813880	S	120	6	126	0.00001
SRR6145058	Terriglobus saanensis	870903	S	6	0	6	0.00000
SRR6145058	Tenacibaculum todarodis	1850252	S	6	0	6	0.00000
SRR6145058	Synechococcus sp. WH 7803	32051	S	6	0	6	0.00000
SRR6145058	Suicoccus acidiformans	2036206	S	6	0	6	0.00000
SRR6145058	Streptomyces sp. jing01	2726118	S	18	6	24	0.00000
SRR6145058	Streptomyces sp. fd1-xmd	1812480	S	38	6	44	0.00000
SRR6145058	Streptomyces sp. Z423-1	2730915	S	62	6	68	0.00001
SRR6145058	Streptomyces sp. Mg1	465541	S	15	6	21	0.00000
SRR6145058	Streptomyces sp. HF10	2692233	S	16	6	22	0.00000
SRR6145058	Streptomyces sp. CdTB01	1725411	S	53	6	59	0.00001
SRR6145058	Streptomyces sp. ADI95-16	1522758	S	17	6	23	0.00000
SRR6145058	Streptococcus troglodytae	1111760	S	6	0	6	0.00000
SRR6145058	Streptococcus pantholopis	1811193	S	6	0	6	0.00000
SRR6145058	Streptococcus lutetiensis	150055	S	1	5	6	0.00000
SRR6145058	Stenotrophomonas sp. ESTM1D_MKCIP4_1	2072414	S	33	6	39	0.00000
SRR6145058	Stenotrophomonas sp. 364	2691571	S	34	6	40	0.00000
SRR6145058	Staphylococcus virus SEP1	1980930	S	11	6	17	0.00000
SRR6145058	Sporosarcina ureae	1571	S	6	0	6	0.00000
SRR6145058	Solitalea canadensis	995	S	6	0	6	0.00000
SRR6145058	Slackia heliotrinireducens	84110	S	6	0	6	0.00000
SRR6145058	Shimwellia blattae	563	S	6	0	6	0.00000
SRR6145058	Shewanella khirikhana	1965282	S	6	0	6	0.00000
SRR6145058	Shewanella halifaxensis	271098	S	6	0	6	0.00000
SRR6145058	Serratia sp. SSNIH1	1758196	S	1	6	7	0.00000
SRR6145058	Serratia sp. FS14	1327989	S	3	6	9	0.00000
SRR6145058	Saprospira grandis	1008	S	6	0	6	0.00000
SRR6145058	Rhodococcus sp. W8901	2742603	S	79	6	85	0.00001
SRR6145058	Rhizobium sp. JKLM19E	2583232	S	3	6	9	0.00000
SRR6145058	Psychroflexus torquis	57029	S	6	0	6	0.00000
SRR6145058	Pseudomonas sp. SWI36	2083052	S	3	6	9	0.00000
SRR6145058	Pseudomonas sp. R2A2	2213057	S	10	6	16	0.00000
SRR6145058	Pseudomonas fuscovaginae	50340	S	4	2	6	0.00000
SRR6145058	Pseudodesulfovibrio indicus	1716143	S	6	0	6	0.00000
SRR6145058	Pseudoarcobacter acticola	1849015	S	6	0	6	0.00000
SRR6145058	Pseudoalteromonas translucida	166935	S	5	1	6	0.00000
SRR6145058	Pseudoalteromonas spongiae	298657	S	6	0	6	0.00000
SRR6145058	Pseudoalteromonas issachenkonii	152297	S	2	4	6	0.00000
SRR6145058	Providencia alcalifaciens	126385	S	6	0	6	0.00000
SRR6145058	Propioniciclava sp. HDW11	2714937	S	118	6	124	0.00001
SRR6145058	Pontibacter akesuensis	388950	S	6	0	6	0.00000
SRR6145058	Plesiomonas shigelloides	703	S	6	0	6	0.00000
SRR6145058	Planctopirus ephydatiae	2528019	S	6	0	6	0.00000
SRR6145058	Planctomycetes bacterium CA51	2527990	S	3	6	9	0.00000
SRR6145058	Photobacterium profundum	74109	S	6	0	6	0.00000
SRR6145058	Photobacterium gaetbulicola	1295392	S	6	0	6	0.00000
SRR6145058	Petrimonas mucosa	1642646	S	6	0	6	0.00000
SRR6145058	Paraglaciecola psychrophila	326544	S	6	0	6	0.00000
SRR6145058	Parageobacillus thermoglucosidasius	1426	S	6	0	6	0.00000
SRR6145058	Pandoravirus neocaledonia	2107708	S	6	0	6	0.00000
SRR6145058	Paenibacillus sp. FSL R7-0331	1536773	S	6	0	6	0.00000
SRR6145058	Paenibacillus naphthalenovorans	162209	S	6	0	6	0.00000
SRR6145058	Paenibacillus guangzhouensis	1473112	S	6	0	6	0.00000
SRR6145058	Paenibacillus glucanolyticus	59843	S	2	4	6	0.00000
SRR6145058	Paenibacillus cellulositrophicus	562959	S	6	0	6	0.00000
SRR6145058	Owenweeksia hongkongensis	253245	S	6	0	6	0.00000
SRR6145058	Oscillibacter valericigenes	351091	S	6	0	6	0.00000
SRR6145058	Oscillatoria acuminata	118323	S	6	0	6	0.00000
SRR6145058	Oleiphilus messinensis	141451	S	6	0	6	0.00000
SRR6145058	Novosphingobium sp. THN1	1016987	S	84	6	90	0.00001
SRR6145058	Mycoplasma hominis	2098	S	6	0	6	0.00000
SRR6145058	Mycoplasma gallinaceum	29556	S	6	0	6	0.00000
SRR6145058	Muribaculum intestinale	1796646	S	6	0	6	0.00000
SRR6145058	Mucilaginibacter mallensis	652787	S	6	0	6	0.00000
SRR6145058	Moraxella ovis	29433	S	4	2	6	0.00000
SRR6145058	Monaibacterium sp. ALG8	2715211	S	35	6	41	0.00000
SRR6145058	Micromonospora sp. HM134	2583243	S	45	6	51	0.00001
SRR6145058	Microbulbifer thermotolerans	252514	S	6	0	6	0.00000
SRR6145058	Microbulbifer aggregans	1769779	S	6	0	6	0.00000
SRR6145058	Microbulbifer agarilyticus	260552	S	6	0	6	0.00000
SRR6145058	Microbacterium sp. LKL04	912630	S	97	6	103	0.00001
SRR6145058	Methylomonas methanica	421	S	6	0	6	0.00000
SRR6145058	Mesorhizobium sp. M9A.F.Ca.ET.002.03.1.2	2493668	S	16	6	22	0.00000
SRR6145058	Mesorhizobium sp. M7D.F.Ca.US.005.01.1.1	2493678	S	19	6	25	0.00000
SRR6145058	Marinobacter sp. LQ44	1749259	S	9	6	15	0.00000
SRR6145058	Luteimonas sp. Gr-4	1176533	S	94	6	100	0.00001
SRR6145058	Listeria grayi	1641	S	6	0	6	0.00000
SRR6145058	Leifsonia sp. PS1209	2724914	S	57	6	63	0.00001
SRR6145058	Leadbetterella byssophila	316068	S	6	0	6	0.00000
SRR6145058	Lactobacillus mucosae	97478	S	6	0	6	0.00000
SRR6145058	Lactobacillus hordei	468911	S	6	0	6	0.00000
SRR6145058	Lactobacillus helveticus	1587	S	4	2	6	0.00000
SRR6145058	Lactobacillus coryniformis	1610	S	5	1	6	0.00000
SRR6145058	Lactobacillus backii	375175	S	5	1	6	0.00000
SRR6145058	Lacrimispora saccharolytica	84030	S	6	0	6	0.00000
SRR6145058	Lachnospira eligens	39485	S	6	0	6	0.00000
SRR6145058	Kosakonia arachidis	551989	S	6	0	6	0.00000
SRR6145058	Janthinobacterium sp. 1_2014MBL_MicDiv	1644131	S	30	6	36	0.00000
SRR6145058	Hymenobacter sp. DG01	2584940	S	34	6	40	0.00000
SRR6145058	Hydrocarboniclastica marina	2259620	S	6	0	6	0.00000
SRR6145058	Halorhabdus utahensis	146826	S	6	0	6	0.00000
SRR6145058	Halomonas huangheensis	1178482	S	6	0	6	0.00000
SRR6145058	Halogeometricum borinquense	60847	S	6	0	6	0.00000
SRR6145058	Halocynthiibacter arcticus	1579316	S	6	0	6	0.00000
SRR6145058	Halobacterium sp. DL1	751944	S	15	6	21	0.00000
SRR6145058	Halobacillus halophilus	1570	S	6	0	6	0.00000
SRR6145058	Hahella chejuensis	158327	S	6	0	6	0.00000
SRR6145058	Grimontia hollisae	673	S	6	0	6	0.00000
SRR6145058	Gramella forsetii	411153	S	6	0	6	0.00000
SRR6145058	Glaciecola nitratireducens	300231	S	6	0	6	0.00000
SRR6145058	Geobacter metallireducens	28232	S	6	0	6	0.00000
SRR6145058	Geobacillus virus GBSV1	2170221	S	1	6	7	0.00000
SRR6145058	Geobacillus thermocatenulatus	33938	S	5	1	6	0.00000
SRR6145058	Geobacillus subterraneus	129338	S	6	0	6	0.00000
SRR6145058	Gallaecimonas mangrovi	2291597	S	6	0	6	0.00000
SRR6145058	Frischella perrara	1267021	S	6	0	6	0.00000
SRR6145058	Francisella philomiragia	28110	S	3	3	6	0.00000
SRR6145058	Fischerella sp. NIES-3754	1752063	S	13	6	19	0.00000
SRR6145058	Fervidobacterium pennivorans	93466	S	5	1	6	0.00000
SRR6145058	Exiguobacterium sp. U13-1	1849031	S	3	6	9	0.00000
SRR6145058	Exiguobacterium sp. MH3	1399115	S	17	6	23	0.00000
SRR6145058	Euzebyella marina	1761453	S	6	0	6	0.00000
SRR6145058	Eubacterium maltosivorans	2041044	S	3	3	6	0.00000
SRR6145058	Erythrobacter sp. EB310	2739433	S	28	6	34	0.00000
SRR6145058	Enterococcus avium	33945	S	6	0	6	0.00000
SRR6145058	Enterobacteriaceae bacterium S05	2052938	S	2	6	8	0.00000
SRR6145058	Enterobacter cloacae complex sp.	2027919	S	6	8	14	0.00000
SRR6145058	Endozoicomonas montiporae	1027273	S	6	0	6	0.00000
SRR6145058	Desulfovibrio ferrophilus	241368	S	6	0	6	0.00000
SRR6145058	Desulfotomaculum ruminis	1564	S	6	0	6	0.00000
SRR6145058	Desulfoglaeba alkanexedens	361111	S	6	0	6	0.00000
SRR6145058	Desulfocurvibacter africanus	873	S	6	0	6	0.00000
SRR6145058	Denitratisoma sp. DHT3	1981880	S	21	6	27	0.00000
SRR6145058	Dactylococcopsis salina	292566	S	5	1	6	0.00000
SRR6145058	Clostridium formicaceticum	1497	S	6	0	6	0.00000
SRR6145058	Clostridium cochlearium	1494	S	6	0	6	0.00000
SRR6145058	Clostridium acetobutylicum	1488	S	6	0	6	0.00000
SRR6145058	Chamaesiphon minutus	1173032	S	6	0	6	0.00000
SRR6145058	Cellulophaga baltica	76594	S	6	0	6	0.00000
SRR6145058	Capnocytophaga sp. H4358	1945658	S	5	6	11	0.00000
SRR6145058	Calothrix parietina	32054	S	6	0	6	0.00000
SRR6145058	Burkholderia sp. YI23	1097668	S	3	6	9	0.00000
SRR6145058	Burkholderia sp. MSMB0266	1637837	S	5	6	11	0.00000
SRR6145058	Burkholderia sp. KBS0801	1179675	S	2	6	8	0.00000
SRR6145058	Burkholderia sp. IDO3	1705310	S	17	6	23	0.00000
SRR6145058	Brevibacillus sp. SCSIO 07484	2496837	S	6	0	6	0.00000
SRR6145058	Brevibacillus brevis	1393	S	6	0	6	0.00000
SRR6145058	Brenneria rubrifaciens	55213	S	3	3	6	0.00000
SRR6145058	Bradyrhizobium sp. BTAi1	288000	S	64	6	70	0.00001
SRR6145058	Bradyrhizobium sp. 1(2017)	1404888	S	37	6	43	0.00000
SRR6145058	Bacteroides salanitronis	376805	S	6	0	6	0.00000
SRR6145058	Bacteroides helcogenes	290053	S	6	0	6	0.00000
SRR6145058	Bacillus wiedmannii	1890302	S	6	0	6	0.00000
SRR6145058	Bacillus marisflavi	189381	S	6	0	6	0.00000
SRR6145058	Bacillus jeotgali	129985	S	6	0	6	0.00000
SRR6145058	Bacillus infantis	324767	S	6	0	6	0.00000
SRR6145058	Bacillus freudenreichii	1783501	S	6	0	6	0.00000
SRR6145058	Azoarcus sp. DD4	2027405	S	37	6	43	0.00000
SRR6145058	Arcobacter defluvii	873191	S	3	3	6	0.00000
SRR6145058	Arcobacter butzleri	28197	S	6	0	6	0.00000
SRR6145058	Arcanobacterium haemolyticum	28264	S	6	0	6	0.00000
SRR6145058	Apibacter sp. B2966	2656761	S	6	6	12	0.00000
SRR6145058	Antarcticibacterium sp. PAMC 28998	2585771	S	6	0	6	0.00000
SRR6145058	Amphibacillus xylanus	1449	S	6	0	6	0.00000
SRR6145058	Alteromonas mediterranea	314275	S	5	1	6	0.00000
SRR6145058	Agromyces sp. LHK192	2498704	S	58	6	64	0.00001
SRR6145058	Aeromonas sp. 2692-1	2560029	S	2	6	8	0.00000
SRR6145058	Aeromicrobium sp. MF47	2662028	S	38	6	44	0.00000
SRR6145058	Actinomadura sp. WMMA1423	2591108	S	76	6	82	0.00001
SRR6145058	Acidithiobacillus ferrivorans	160808	S	6	0	6	0.00000
SRR6145058	Yersinia frederiksenii	29484	S	5	0	5	0.00000
SRR6145058	Wenyingzhuangia fucanilytica	1790137	S	5	0	5	0.00000
SRR6145058	Weissella jogaejeotgali	1631871	S	5	0	5	0.00000
SRR6145058	Weissella hellenica	46256	S	5	0	5	0.00000
SRR6145058	Vibrio mimicus	674	S	5	0	5	0.00000
SRR6145058	Variovorax sp. HW608	1034889	S	86	5	91	0.00001
SRR6145058	Vagococcus penaei	633807	S	5	0	5	0.00000
SRR6145058	Ureibacillus thermosphaericus	51173	S	5	0	5	0.00000
SRR6145058	Tumebacillus algifaecis	1214604	S	5	0	5	0.00000
SRR6145058	Trichormus variabilis	264691	S	1	4	5	0.00000
SRR6145058	Trichodesmium erythraeum	1206	S	5	0	5	0.00000
SRR6145058	Thermosulfidibacter takaii	412593	S	5	0	5	0.00000
SRR6145058	Thermoproteus uzoniensis	184117	S	5	0	5	0.00000
SRR6145058	Thermomicrobium roseum	500	S	5	0	5	0.00000
SRR6145058	Thermodesulfobacterium geofontis	1295609	S	5	0	5	0.00000
SRR6145058	Thermoanaerobacterium aotearoense	47490	S	5	0	5	0.00000
SRR6145058	Tepidanaerobacter acetatoxydans	499229	S	5	0	5	0.00000
SRR6145058	Tenacibaculum sp. DSM 106434	2358479	S	5	1	6	0.00000
SRR6145058	Taylorella asinigenitalis	84590	S	3	2	5	0.00000
SRR6145058	Syntrophus aciditrophicus	316277	S	5	0	5	0.00000
SRR6145058	Sutterella faecalis	2584944	S	5	0	5	0.00000
SRR6145058	Sulfitobacter sp. D7	1968541	S	19	5	24	0.00000
SRR6145058	Streptomyces sp. endophyte_N2	2153485	S	7	5	12	0.00000
SRR6145058	Streptomyces sp. Z022	1442032	S	44	5	49	0.00001
SRR6145058	Streptomyces sp. SAT1	1849967	S	42	5	47	0.00001
SRR6145058	Streptomyces sp. S1A1-7	2594459	S	1	5	6	0.00000
SRR6145058	Streptomyces sp. P3	2135430	S	61	5	66	0.00001
SRR6145058	Streptomyces sp. JB150	2714844	S	31	5	36	0.00000
SRR6145058	Streptomyces sp. GS7	2692234	S	50	5	55	0.00001
SRR6145058	Streptomyces sp. 3211	1964449	S	9	5	14	0.00000
SRR6145058	Streptococcus sp. DAT741	1940319	S	4	5	9	0.00000
SRR6145058	Sterolibacteriaceae bacterium M52	2496847	S	11	5	16	0.00000
SRR6145058	Stenotrophomonas sp. MYb57	1827305	S	2	5	7	0.00000
SRR6145058	Staphylococcus virus SEP9	1922247	S	28	5	33	0.00000
SRR6145058	Staphylococcus virus IPLAC1C	1980931	S	9	5	14	0.00000
SRR6145058	Staphylococcus lutrae	155085	S	5	0	5	0.00000
SRR6145058	Sporolactobacillus terrae	269673	S	5	0	5	0.00000
SRR6145058	Sphingomonas sp. LM7	1938607	S	104	5	109	0.00001
SRR6145058	Sphingomonas sp. C33	2698679	S	120	5	125	0.00001
SRR6145058	Sphingobium sp. RAC03	1843368	S	54	5	59	0.00001
SRR6145058	Shewanella sp. W3-18-1	351745	S	1	5	6	0.00000
SRR6145058	Shewanella marisflavi	260364	S	5	0	5	0.00000
SRR6145058	Serratia sp. FDAARGOS_506	2420306	S	17	5	22	0.00000
SRR6145058	Selenomonas ruminantium	971	S	5	0	5	0.00000
SRR6145058	Scytonema sp. HK-05	1137095	S	24	5	29	0.00000
SRR6145058	Scandinavium goeteborgense	1851514	S	5	0	5	0.00000
SRR6145058	Salinivibrio kushneri	1908198	S	5	0	5	0.00000
SRR6145058	Saccharospirillum mangrovi	2161747	S	5	0	5	0.00000
SRR6145058	Rodentibacter heylii	1906744	S	2	3	5	0.00000
SRR6145058	Rhodococcus sp. X156	2499145	S	102	5	107	0.00001
SRR6145058	Rhodococcus sp. H-CA8f	1727214	S	1	5	6	0.00000
SRR6145058	Rathayibacter sp. VKM Ac-2762	2609254	S	5	9	14	0.00000
SRR6145058	Raoultella sp. NCTC 9189	2583577	S	5	9	14	0.00000
SRR6145058	Psychrobacter urativorans	45610	S	5	0	5	0.00000
SRR6145058	Psychrobacter sp. YP14	2203895	S	7	5	12	0.00000
SRR6145058	Pseudomonas sp. S49	1573720	S	3	5	8	0.00000
SRR6145058	Pseudomonas sp. R2-60-08W	1173280	S	1	5	6	0.00000
SRR6145058	Pseudomonas sp. DTU12.1	2654238	S	2	5	7	0.00000
SRR6145058	Pseudomonas prosekii	1148509	S	5	0	5	0.00000
SRR6145058	Pseudobacter ginsenosidimutans	661488	S	5	0	5	0.00000
SRR6145058	Pseudoalteromonas tunicata	314281	S	5	0	5	0.00000
SRR6145058	Pseudoalteromonas phenolica	161398	S	5	0	5	0.00000
SRR6145058	Pseudoalteromonas donghaensis	621376	S	5	0	5	0.00000
SRR6145058	Providencia heimbachae	333962	S	5	0	5	0.00000
SRR6145058	Proteus hauseri	183417	S	5	0	5	0.00000
SRR6145058	Plautia stali symbiont	891974	S	31	5	36	0.00000
SRR6145058	Planktomarina temperata	1284658	S	5	0	5	0.00000
SRR6145058	Phytobacter diazotrophicus	395631	S	1	4	5	0.00000
SRR6145058	Petrotoga mobilis	69499	S	5	0	5	0.00000
SRR6145058	Pedobacter steynii	430522	S	5	0	5	0.00000
SRR6145058	Pedobacter heparinus	984	S	5	0	5	0.00000
SRR6145058	Pediococcus claussenii	187452	S	5	0	5	0.00000
SRR6145058	Pediococcus acidilactici	1254	S	5	0	5	0.00000
SRR6145058	Pectobacterium odoriferum	78398	S	4	1	5	0.00000
SRR6145058	Parachlamydia acanthamoebae	83552	S	5	0	5	0.00000
SRR6145058	Paraburkholderia rhizoxinica	412963	S	5	0	5	0.00000
SRR6145058	Paenibacillus stellifer	169760	S	5	0	5	0.00000
SRR6145058	Paenibacillus lutimineralis	2707005	S	5	0	5	0.00000
SRR6145058	Paenibacillus jilunlii	682956	S	5	0	5	0.00000
SRR6145058	Paenibacillus donghaensis	414771	S	5	0	5	0.00000
SRR6145058	Paenibacillus cellulosilyticus	375489	S	5	0	5	0.00000
SRR6145058	Paenibacillus borealis	160799	S	5	0	5	0.00000
SRR6145058	Paenibacillus baekrokdamisoli	1712516	S	5	0	5	0.00000
SRR6145058	Orientia tsutsugamushi	784	S	5	0	5	0.00000
SRR6145058	Oleispira antarctica	188908	S	5	0	5	0.00000
SRR6145058	Octadecabacter temperatus	1458307	S	5	0	5	0.00000
SRR6145058	Oceanicoccus sagamiensis	716816	S	5	0	5	0.00000
SRR6145058	Nostoc sphaeroides	446679	S	3	2	5	0.00000
SRR6145058	Nostoc sp. PCC 7107	317936	S	5	1	6	0.00000
SRR6145058	Nostoc sp. NIES-3756	1751286	S	3	5	8	0.00000
SRR6145058	Nocardioides sp. SB3-45	2558918	S	71	5	76	0.00001
SRR6145058	Nocardioides sp. JQ2195	2592334	S	79	5	84	0.00001
SRR6145058	Nitrosospira multiformis	1231	S	5	0	5	0.00000
SRR6145058	Nitrosospira briensis	35799	S	5	0	5	0.00000
SRR6145058	Nitrosomonas eutropha	916	S	5	0	5	0.00000
SRR6145058	Nitrosomonas europaea	915	S	5	0	5	0.00000
SRR6145058	Nitratireductor sp. SY7	2599600	S	48	5	53	0.00001
SRR6145058	Neptunomonas concharum	1031538	S	5	0	5	0.00000
SRR6145058	Natronolimnobius sulfurireducens	2044521	S	5	0	5	0.00000
SRR6145058	Mycoplasma canis	29555	S	5	0	5	0.00000
SRR6145058	Mycobacterium sp. DL440	2675523	S	71	5	76	0.00001
SRR6145058	Mycobacterium pseudoshottsii	265949	S	2	3	5	0.00000
SRR6145058	Mucinivorans hirudinis	1433126	S	5	0	5	0.00000
SRR6145058	Mucilaginibacter sp. PAMC 26640	1300914	S	5	1	6	0.00000
SRR6145058	Micromonospora sp. WMMC415	2675222	S	42	5	47	0.00001
SRR6145058	Microbacterium sp. CBA3102	2603598	S	80	5	85	0.00001
SRR6145058	Microbacterium sp. BH-3-3-3	1906742	S	97	5	102	0.00001
SRR6145058	Methylophilus medardicus	2588534	S	5	0	5	0.00000
SRR6145058	Methylocystis sp. SC2	187303	S	14	5	19	0.00000
SRR6145058	Mesorhizobium sp. Pch-S	2082387	S	72	5	77	0.00001
SRR6145058	Mesorhizobium sp. NZP2298	2483403	S	15	5	20	0.00000
SRR6145058	Mesorhizobium sp. M7A.F.Ce.TU.012.03.2.1	2493681	S	16	5	21	0.00000
SRR6145058	Mesorhizobium sp. M3A.F.Ca.ET.080.04.2.1	2493676	S	24	5	29	0.00000
SRR6145058	Mesorhizobium sp. 8	2584466	S	51	5	56	0.00001
SRR6145058	Mesoplasma chauliocola	216427	S	5	0	5	0.00000
SRR6145058	Martelella sp. AD-3	686597	S	21	5	26	0.00000
SRR6145058	Mariprofundus ferrinatatus	1921087	S	5	0	5	0.00000
SRR6145058	Marinobacter similis	1420916	S	5	0	5	0.00000
SRR6145058	Magnetospirillum sp. XM-1	1663591	S	20	5	25	0.00000
SRR6145058	Magnetospirillum sp. ME-1	1639348	S	19	5	24	0.00000
SRR6145058	Magnetococcus marinus	1124597	S	5	0	5	0.00000
SRR6145058	Litoricola lipolytica	418701	S	5	0	5	0.00000
SRR6145058	Listeria welshimeri	1643	S	5	0	5	0.00000
SRR6145058	Legionella adelaidensis	45056	S	5	0	5	0.00000
SRR6145058	Lactococcus petauri	1940789	S	5	0	5	0.00000
SRR6145058	Lactobacillus jinshani	1720083	S	5	0	5	0.00000
SRR6145058	Lactobacillus ginsenosidimutans	1007676	S	5	0	5	0.00000
SRR6145058	Lactobacillus fuchuensis	164393	S	5	0	5	0.00000
SRR6145058	Lacimicrobium alkaliphilum	1526571	S	5	0	5	0.00000
SRR6145058	Lachnoclostridium phocaeense	1871021	S	5	0	5	0.00000
SRR6145058	Laceyella sacchari	37482	S	5	0	5	0.00000
SRR6145058	Komagataeibacter hansenii	436	S	5	0	5	0.00000
SRR6145058	Ketobacter alkanivorans	1917421	S	5	0	5	0.00000
SRR6145058	Kangiella koreensis	261964	S	5	0	5	0.00000
SRR6145058	Jeotgalibaca ciconiae	2496265	S	5	0	5	0.00000
SRR6145058	Janthinobacterium sp. Marseille	375286	S	24	5	29	0.00000
SRR6145058	Isosphaera pallida	128	S	5	0	5	0.00000
SRR6145058	Hungateiclostridium clariflavum	288965	S	4	1	5	0.00000
SRR6145058	Herminiimonas arsenitoxidans	1809410	S	5	0	5	0.00000
SRR6145058	Helicobacter mustelae	217	S	5	0	5	0.00000
SRR6145058	Helicobacter canadensis	123841	S	5	0	5	0.00000
SRR6145058	Halorhabdus tiamatea	430914	S	5	0	5	0.00000
SRR6145058	Halobacteroides halobius	42422	S	5	0	5	0.00000
SRR6145058	Halobacteriovorax marinus	97084	S	5	0	5	0.00000
SRR6145058	Haloarcula marismortui	2238	S	4	1	5	0.00000
SRR6145058	Halioglobus pacificus	930806	S	5	0	5	0.00000
SRR6145058	Halapricum salinum	1457250	S	5	0	5	0.00000
SRR6145058	Haematospirillum jordaniae	1549855	S	5	0	5	0.00000
SRR6145058	Gynuella sunshinyii	1445505	S	5	0	5	0.00000
SRR6145058	Geobacter sp. DSM 9736	1277350	S	5	0	5	0.00000
SRR6145058	Geobacter daltonii	1203471	S	5	0	5	0.00000
SRR6145058	Geoalkalibacter subterraneus	483547	S	5	0	5	0.00000
SRR6145058	Gallionella capsiferriformans	370405	S	5	0	5	0.00000
SRR6145058	Fusobacterium gonidiaformans	849	S	5	0	5	0.00000
SRR6145058	Frederiksenia canicola	123824	S	5	0	5	0.00000
SRR6145058	Flavobacterium crassostreae	1763534	S	5	0	5	0.00000
SRR6145058	Flavisolibacter tropicus	1492898	S	5	0	5	0.00000
SRR6145058	Fictibacillus arsenicus	255247	S	5	0	5	0.00000
SRR6145058	Ferriphaselus amnicola	1188319	S	5	0	5	0.00000
SRR6145058	Erythrobacter sp. HL-111	1798193	S	56	5	61	0.00001
SRR6145058	Enterobacteriaceae bacterium ENNIH1	2066051	S	9	5	14	0.00000
SRR6145058	Enterobacter oligotrophica	2478464	S	5	0	5	0.00000
SRR6145058	Elizabethkingia sp. 2-6	2575699	S	7	5	12	0.00000
SRR6145058	Echinicola vietnamensis	390884	S	4	1	5	0.00000
SRR6145058	Draconibacterium orientale	1168034	S	5	0	5	0.00000
SRR6145058	Dickeya sp. NCPPB 569	568768	S	5	0	5	0.00000
SRR6145058	Dickeya sp. NCPPB 3274	568766	S	5	2	7	0.00000
SRR6145058	Dickeya chrysanthemi	556	S	5	0	5	0.00000
SRR6145058	Desulfovibrio sp. G11	631220	S	1	5	6	0.00000
SRR6145058	Desulfovibrio piger	901	S	5	0	5	0.00000
SRR6145058	Desulfotomaculum ferrireducens	1833852	S	5	0	5	0.00000
SRR6145058	Cytophagales bacterium TFI 002	1945892	S	5	0	5	0.00000
SRR6145058	Cyclobacterium amurskyense	320787	S	5	0	5	0.00000
SRR6145058	Cyanothece sp. PCC 7425	395961	S	5	0	5	0.00000
SRR6145058	Crocosphaera subtropica	2546360	S	5	0	5	0.00000
SRR6145058	Corynebacterium sp. LMM-1652	2487892	S	151	5	156	0.00002
SRR6145058	Corynebacterium sp. 1959	2675216	S	89	5	94	0.00001
SRR6145058	Colwellia sp. PAMC 21821	1816219	S	5	1	6	0.00000
SRR6145058	Clostridium kluyveri	1534	S	5	0	5	0.00000
SRR6145058	Clostridium cellulovorans	1493	S	5	0	5	0.00000
SRR6145058	Clostridium aceticum	84022	S	5	0	5	0.00000
SRR6145058	Citrobacter amalonaticus	35703	S	5	0	5	0.00000
SRR6145058	Chthonomonas calidirosea	454171	S	5	0	5	0.00000
SRR6145058	Chryseobacterium sp. 3008163	2478663	S	75	5	80	0.00001
SRR6145058	Chloroherpeton thalassium	100716	S	5	0	5	0.00000
SRR6145058	Cellulosimicrobium sp. BI34T	2587808	S	49	5	54	0.00001
SRR6145058	Cellulophaga lytica	979	S	5	0	5	0.00000
SRR6145058	Carnobacterium inhibens	147709	S	5	0	5	0.00000
SRR6145058	Capnocytophaga cynodegmi	28189	S	5	0	5	0.00000
SRR6145058	Candidatus Aquiluna sp. UB-MaderosW2red	1855377	S	5	0	5	0.00000
SRR6145058	Campylobacter pinnipediorum	1965231	S	5	0	5	0.00000
SRR6145058	Campylobacter lari	201	S	5	0	5	0.00000
SRR6145058	Campylobacter hyointestinalis	198	S	5	0	5	0.00000
SRR6145058	Campylobacter curvus	200	S	5	0	5	0.00000
SRR6145058	Caminibacter mediatlanticus	291048	S	5	0	5	0.00000
SRR6145058	Calothrix parasitica	1973486	S	5	0	5	0.00000
SRR6145058	Caldithrix abyssi	187145	S	5	0	5	0.00000
SRR6145058	Buttiauxella agrestis	82977	S	5	0	5	0.00000
SRR6145058	Burkholderia sp. MSMB0856	1637869	S	10	5	15	0.00000
SRR6145058	Burkholderia diffusa	488732	S	4	1	5	0.00000
SRR6145058	Brevibacillus formosus	54913	S	4	1	5	0.00000
SRR6145058	Brachyspira hyodysenteriae	159	S	5	0	5	0.00000
SRR6145058	Bifidobacterium indicum	1691	S	3	2	5	0.00000
SRR6145058	Betapapillomavirus 6	1172193	S	5	0	5	0.00000
SRR6145058	Basilea psittacipulmonis	1472345	S	5	0	5	0.00000
SRR6145058	Bartonella bacilliformis	774	S	5	0	5	0.00000
SRR6145058	Bacillus vietnamensis	218284	S	5	0	5	0.00000
SRR6145058	Bacillus luti	2026191	S	5	0	5	0.00000
SRR6145058	Bacillus lentus	1467	S	5	0	5	0.00000
SRR6145058	Bacillus anthracis	1392	S	3	2	5	0.00000
SRR6145058	Azoarcus sp. DN11	356837	S	25	5	30	0.00000
SRR6145058	Avibacterium volantium	762	S	5	0	5	0.00000
SRR6145058	Arthrobacter sp. FB24	290399	S	37	5	42	0.00000
SRR6145058	Arcobacter skirrowii	28200	S	4	1	5	0.00000
SRR6145058	Arcobacter nitrofigilis	28199	S	5	0	5	0.00000
SRR6145058	Arcobacter lekithochrous	1904463	S	5	0	5	0.00000
SRR6145058	Arcobacter canalis	1912871	S	3	2	5	0.00000
SRR6145058	Antarcticibacterium flavum	2058175	S	5	0	5	0.00000
SRR6145058	Anaerolinea thermophila	167964	S	5	0	5	0.00000
SRR6145058	Anabaenopsis circularis	109266	S	4	1	5	0.00000
SRR6145058	Aminipila butyrica	433296	S	5	0	5	0.00000
SRR6145058	Algibacter alginicilyticus	1736674	S	5	0	5	0.00000
SRR6145058	Akkermansia glycaniphila	1679444	S	5	0	5	0.00000
SRR6145058	Agromyces sp. MF30-A	2080742	S	41	5	46	0.00001
SRR6145058	Agarilytica rhodophyticola	1737490	S	5	0	5	0.00000
SRR6145058	Actinomadura sp. WMMB499	2650775	S	67	5	72	0.00001
SRR6145058	Acidithiobacillus thiooxidans	930	S	5	0	5	0.00000
SRR6145058	Acetobacter oryzoeni	2500548	S	3	2	5	0.00000
SRR6145058	Acaryochloris marina	155978	S	5	0	5	0.00000
SRR6145058	Absiella sp. 9CBEGH2	2583452	S	1	5	6	0.00000
SRR6145058	Xylella taiwanensis	1444770	S	4	0	4	0.00000
SRR6145058	Xenorhabdus hominickii	351679	S	4	0	4	0.00000
SRR6145058	Woeseia oceani	1548547	S	4	0	4	0.00000
SRR6145058	Wigglesworthia glossinidia	51229	S	4	0	4	0.00000
SRR6145058	Virgibacillus dokdonensis	302167	S	3	1	4	0.00000
SRR6145058	Vibrio taketomensis	2572923	S	4	0	4	0.00000
SRR6145058	Vibrio natriegens	691	S	2	2	4	0.00000
SRR6145058	Vagococcus sp. MN-17	2571750	S	7	4	11	0.00000
SRR6145058	Urechidicola croceus	1850246	S	4	0	4	0.00000
SRR6145058	Ureaplasma parvum	134821	S	3	1	4	0.00000
SRR6145058	Treponema primitia	88058	S	4	0	4	0.00000
SRR6145058	Tolumonas auensis	43948	S	4	0	4	0.00000
SRR6145058	Thermus brockianus	56956	S	4	0	4	0.00000
SRR6145058	Thermus aquaticus	271	S	4	0	4	0.00000
SRR6145058	Thermochromatium tepidum	1050	S	4	0	4	0.00000
SRR6145058	Thermoanaerobacterium thermosaccharolyticum	1517	S	4	0	4	0.00000
SRR6145058	Thermoanaerobacter kivui	2325	S	3	1	4	0.00000
SRR6145058	Thermacetogenium phaeum	85874	S	4	0	4	0.00000
SRR6145058	Tessaracoccus sp. T2.5-30	1909732	S	94	4	98	0.00001
SRR6145058	Tenacibaculum maritimum	107401	S	4	0	4	0.00000
SRR6145058	Tenacibaculum dicentrarchi	669041	S	4	0	4	0.00000
SRR6145058	Synechococcus sp. PCC 7502	1173263	S	4	0	4	0.00000
SRR6145058	Sulfurospirillum cavolei	366522	S	4	0	4	0.00000
SRR6145058	Sulfurihydrogenibium azorense	309806	S	4	0	4	0.00000
SRR6145058	Streptomyces sp. W1SF4	2305220	S	33	4	37	0.00000
SRR6145058	Streptomyces sp. T44	2686304	S	34	4	38	0.00000
SRR6145058	Streptomyces sp. SS52	2563602	S	2	4	6	0.00000
SRR6145058	Streptomyces sp. SM18	1736046	S	50	4	54	0.00001
SRR6145058	Streptomyces sp. S4.7	2705439	S	21	4	25	0.00000
SRR6145058	Streptomyces sp. S063	2005885	S	11	4	15	0.00000
SRR6145058	Streptomyces sp. M2	646637	S	38	4	42	0.00000
SRR6145058	Streptomyces sp. HM190	2695266	S	37	4	41	0.00000
SRR6145058	Streptomyces sp. GY16	2653200	S	52	4	56	0.00001
SRR6145058	Streptomyces sp. CMB-StM0423	2059884	S	32	4	36	0.00000
SRR6145058	Streptomyces sp. 3214.6	1882757	S	35	4	39	0.00000
SRR6145058	Streptomonospora sp. M2	2498135	S	69	4	73	0.00001
SRR6145058	Streptococcus macedonicus	59310	S	1	3	4	0.00000
SRR6145058	Staphylococcus sp. MI 10-1553	1912064	S	4	0	4	0.00000
SRR6145058	Staphylococcus muscae	1294	S	4	0	4	0.00000
SRR6145058	Staphylococcus fleurettii	150056	S	4	0	4	0.00000
SRR6145058	Staphylococcus delphini	53344	S	4	0	4	0.00000
SRR6145058	Sporosarcina psychrophila	1476	S	4	0	4	0.00000
SRR6145058	Sporomusa termitida	2377	S	4	0	4	0.00000
SRR6145058	Spirochaeta thermophila	154	S	4	0	4	0.00000
SRR6145058	Sphingorhabdus sp. YGSMI21	2077182	S	23	4	27	0.00000
SRR6145058	Sphingomonas sp. PAMC26645	2565555	S	139	4	143	0.00002
SRR6145058	Sphingomonas sp. LMO-1	2681549	S	144	4	148	0.00002
SRR6145058	Sinorhizobium sp. RAC02	1842534	S	42	4	46	0.00001
SRR6145058	Silvanigrella aquatica	1915309	S	4	0	4	0.00000
SRR6145058	Shewanella sp. MR-7	60481	S	6	4	10	0.00000
SRR6145058	Shewanella sediminis	271097	S	4	0	4	0.00000
SRR6145058	Shewanella pealeana	70864	S	4	0	4	0.00000
SRR6145058	Shewanella oneidensis	70863	S	4	0	4	0.00000
SRR6145058	Shewanella bicestrii	2018305	S	2	2	4	0.00000
SRR6145058	Shewanella amazonensis	60478	S	4	0	4	0.00000
SRR6145058	Shewanella aestuarii	1028752	S	4	0	4	0.00000
SRR6145058	Serratia symbiotica	138074	S	4	0	4	0.00000
SRR6145058	Sediminispirochaeta smaragdinae	55206	S	4	0	4	0.00000
SRR6145058	Salmonella bongori	54736	S	4	0	4	0.00000
SRR6145058	Salinivibrio costicola	51367	S	2	2	4	0.00000
SRR6145058	Salinimonas sediminis	2303538	S	4	0	4	0.00000
SRR6145058	Salinimonas lutimaris	914153	S	4	0	4	0.00000
SRR6145058	Saccharophagus degradans	86304	S	4	0	4	0.00000
SRR6145058	Ruthenibacterium lactatiformans	1550024	S	4	0	4	0.00000
SRR6145058	Ruminococcus albus	1264	S	4	0	4	0.00000
SRR6145058	Rufibacter tibetensis	512763	S	4	0	4	0.00000
SRR6145058	Ruegeria sp. THAF33	2587853	S	14	4	18	0.00000
SRR6145058	Rhodothermaceae bacterium RA	1779382	S	6	4	10	0.00000
SRR6145058	Rhodoluna lacicola	529884	S	4	0	4	0.00000
SRR6145058	Rhizobium sp. JKLM13E	2582918	S	2	4	6	0.00000
SRR6145058	Rhizobium sp. ACO-34A	1571470	S	46	4	50	0.00001
SRR6145058	Reinekea forsetii	1336806	S	4	0	4	0.00000
SRR6145058	Pseudomonas sp. SGAir0191	2217867	S	9	4	13	0.00000
SRR6145058	Pseudomonas sp. R4-39-08	1173288	S	1	4	5	0.00000
SRR6145058	Pseudomonas sp. R4-34-07	658642	S	1	4	5	0.00000
SRR6145058	Pseudomonas sp. R3-18-08	1173283	S	2	4	6	0.00000
SRR6145058	Pseudomonas sp. R1-43-08	1173270	S	1	4	5	0.00000
SRR6145058	Pseudomonas brenneri	129817	S	4	0	4	0.00000
SRR6145058	Pseudomonas amygdali	47877	S	2	2	4	0.00000
SRR6145058	Pseudomonadaceae bacterium SI-3	2079806	S	10	4	14	0.00000
SRR6145058	Pseudodesulfovibrio profundus	57320	S	4	0	4	0.00000
SRR6145058	Pseudoclostridium thermosuccinogenes	84032	S	4	0	4	0.00000
SRR6145058	Pseudoalteromonas rubra	43658	S	4	0	4	0.00000
SRR6145058	Pseudoalteromonas atlantica	288	S	4	0	4	0.00000
SRR6145058	Pseudoalteromonas aliena	247523	S	4	0	4	0.00000
SRR6145058	Pseudanabaena sp. PCC 7367	82654	S	4	0	4	0.00000
SRR6145058	Proteus phage VB_PmiS-Isfahan	1969841	S	35	4	39	0.00000
SRR6145058	Polynucleobacter difficilis	556054	S	4	0	4	0.00000
SRR6145058	Planococcus sp. PAMC 21323	1526927	S	4	0	4	0.00000
SRR6145058	Planococcus rifietoensis	200991	S	4	0	4	0.00000
SRR6145058	Planococcus kocurii	1374	S	2	2	4	0.00000
SRR6145058	Planococcus faecalis	1598147	S	2	2	4	0.00000
SRR6145058	Planctomycetes bacterium Pan153	2528029	S	3	4	7	0.00000
SRR6145058	Photorhabdus asymbiotica	291112	S	4	0	4	0.00000
SRR6145058	Peptoclostridium acidaminophilum	1731	S	4	0	4	0.00000
SRR6145058	Peptacetobacter hiranonis	89152	S	4	0	4	0.00000
SRR6145058	Pelosinus fermentans	365349	S	4	0	4	0.00000
SRR6145058	Pelobacter carbinolicus	19	S	4	0	4	0.00000
SRR6145058	Pantoea alhagi	1891675	S	4	0	4	0.00000
SRR6145058	Pandoravirus macleodensis	2107707	S	4	0	4	0.00000
SRR6145058	Pandoraea sp. XY-2	2518599	S	21	4	25	0.00000
SRR6145058	Paenibacillus xylanilyticus	248903	S	4	0	4	0.00000
SRR6145058	Paenibacillus ihbetae	1870820	S	4	0	4	0.00000
SRR6145058	Paenibacillus chitinolyticus	79263	S	4	0	4	0.00000
SRR6145058	Paenibacillus barcinonensis	198119	S	4	0	4	0.00000
SRR6145058	Oenococcus sicerae	2203724	S	4	0	4	0.00000
SRR6145058	Oceanobacillus kimchii	746691	S	4	0	4	0.00000
SRR6145058	Novibacillus thermophilus	1471761	S	4	0	4	0.00000
SRR6145058	Nonlabens marinus	930802	S	4	0	4	0.00000
SRR6145058	Nonlabens dokdonensis	328515	S	4	0	4	0.00000
SRR6145058	Nitrosospira lacus	1288494	S	4	0	4	0.00000
SRR6145058	Nitrosopumilus piranensis	1582439	S	3	1	4	0.00000
SRR6145058	Nitrosomonas ureae	44577	S	2	2	4	0.00000
SRR6145058	Nitrosococcus oceani	1229	S	3	1	4	0.00000
SRR6145058	Nitrosococcus halophilus	133539	S	4	0	4	0.00000
SRR6145058	Nitratifractor salsuginis	269261	S	4	0	4	0.00000
SRR6145058	Neisseria sp. KEM232	655307	S	171	4	175	0.00002
SRR6145058	Natronomonas pharaonis	2257	S	4	0	4	0.00000
SRR6145058	Natrialba magadii	13769	S	4	0	4	0.00000
SRR6145058	Mycoplasma hyopneumoniae	2099	S	4	0	4	0.00000
SRR6145058	Mycobacterium sp. EPa45	1545728	S	61	4	65	0.00001
SRR6145058	Mycobacterium sp. DL592	2675524	S	98	4	102	0.00001
SRR6145058	Moritella viscosa	80854	S	4	0	4	0.00000
SRR6145058	Microbacterium sp. L-031	2614639	S	74	4	78	0.00001
SRR6145058	Methylomicrobium alcaliphilum	271065	S	4	0	4	0.00000
SRR6145058	Methanosarcina siciliae	38027	S	4	0	4	0.00000
SRR6145058	Methanoculleus marisnigri	2198	S	4	0	4	0.00000
SRR6145058	Methanococcus vannielii	2187	S	4	0	4	0.00000
SRR6145058	Methanocella paludicola	570267	S	4	0	4	0.00000
SRR6145058	Methanobrevibacter millerae	230361	S	4	0	4	0.00000
SRR6145058	Mesorhizobium sp. M6A.T.Cr.TU.016.01.1.1	2493677	S	17	4	21	0.00000
SRR6145058	Mesorhizobium sp. DCY119	2108445	S	36	4	40	0.00000
SRR6145058	Megamonas hypermegale	158847	S	4	0	4	0.00000
SRR6145058	Mariprofundus aestuarium	1921086	S	4	0	4	0.00000
SRR6145058	Marinobacter psychrophilus	330734	S	3	1	4	0.00000
SRR6145058	Mariniblastus fucicola	980251	S	4	0	4	0.00000
SRR6145058	Mannheimia granulomatis	85402	S	4	0	4	0.00000
SRR6145058	Macaca mulatta papillomavirus 5	2364645	S	4	0	4	0.00000
SRR6145058	Luteimonas sp. 100111	2006110	S	105	4	109	0.00001
SRR6145058	Lonsdalea britannica	1082704	S	4	0	4	0.00000
SRR6145058	Lentibacillus amyloliquefaciens	1472767	S	4	0	4	0.00000
SRR6145058	Lelliottia jeotgali	1907578	S	4	0	4	0.00000
SRR6145058	Legionella longbeachae	450	S	4	0	4	0.00000
SRR6145058	Legionella cherrii	28084	S	4	0	4	0.00000
SRR6145058	Lactococcus virus ASCC273	1165135	S	3	4	7	0.00000
SRR6145058	Lactobacillus zymae	267363	S	4	0	4	0.00000
SRR6145058	Lactobacillus nagelii	82688	S	4	0	4	0.00000
SRR6145058	Lactobacillus lindneri	53444	S	4	0	4	0.00000
SRR6145058	Lactobacillus kunkeei	148814	S	4	0	4	0.00000
SRR6145058	Lactobacillus kefiri	33962	S	4	0	4	0.00000
SRR6145058	Lactobacillus hokkaidonensis	1193095	S	4	0	4	0.00000
SRR6145058	Lactobacillus bifermentans	1607	S	4	0	4	0.00000
SRR6145058	Lactobacillus apis	303541	S	4	0	4	0.00000
SRR6145058	Lactobacillus amylophilus	1603	S	4	0	4	0.00000
SRR6145058	Lactobacillus alimentarius	1602	S	4	0	4	0.00000
SRR6145058	Lactobacillus acidipiscis	89059	S	4	0	4	0.00000
SRR6145058	Lacinutrix venerupis	1486034	S	4	0	4	0.00000
SRR6145058	Kurthia zopfii	1650	S	4	0	4	0.00000
SRR6145058	Kangiella sediminilitoris	1144748	S	4	0	4	0.00000
SRR6145058	Kangiella profundi	1561924	S	4	0	4	0.00000
SRR6145058	Idiomarina piscisalsi	1096243	S	3	1	4	0.00000
SRR6145058	Hymenobacter sp. 17J36-26	2496028	S	3	4	7	0.00000
SRR6145058	Hydrogenovibrio crunogenus	39765	S	3	1	4	0.00000
SRR6145058	Humibacter sp. WJ7-1	2599293	S	57	4	61	0.00001
SRR6145058	Herbiconiux sp. SALV-R1	2735133	S	68	4	72	0.00001
SRR6145058	Helicobacter cholecystus	45498	S	4	0	4	0.00000
SRR6145058	Haloplanus sp. CBA1113	1547899	S	2	4	6	0.00000
SRR6145058	Halomonas sp. PA16-9	2576841	S	7	4	11	0.00000
SRR6145058	Halomicronema hongdechloris	1209493	S	4	0	4	0.00000
SRR6145058	Gottschalkia acidurici	1556	S	4	0	4	0.00000
SRR6145058	Gordonia virus Phistory	2734203	S	1	4	5	0.00000
SRR6145058	Gordonia virus Apricot	2734216	S	2	4	6	0.00000
SRR6145058	Gemmobacter sp. HYN0069	2169400	S	61	4	65	0.00001
SRR6145058	Gammapapillomavirus 18	1513263	S	4	0	4	0.00000
SRR6145058	Frondihabitans sp. 762G35	1446794	S	47	4	51	0.00001
SRR6145058	Formosa agariphila	320324	S	4	0	4	0.00000
SRR6145058	Flavobacteriaceae bacterium	1871037	S	4	0	4	0.00000
SRR6145058	Fibrobacter succinogenes	833	S	4	0	4	0.00000
SRR6145058	Ferroglobus placidus	54261	S	4	0	4	0.00000
SRR6145058	Fabibacter pacificus	1267423	S	4	0	4	0.00000
SRR6145058	Exiguobacterium antarcticum	132920	S	4	0	4	0.00000
SRR6145058	Ethanoligenens harbinense	253239	S	4	0	4	0.00000
SRR6145058	Escherichia virus ID52	1910968	S	3	4	7	0.00000
SRR6145058	Erythrobacter sp. THAF29	2587851	S	20	4	24	0.00000
SRR6145058	Erwinia sp. Ejp617	215689	S	3	4	7	0.00000
SRR6145058	Enterococcus wangshanyuanii	2005703	S	4	0	4	0.00000
SRR6145058	Enterococcus sp. FDAARGOS_375	2060307	S	6	4	10	0.00000
SRR6145058	Enterococcus gilvus	160453	S	4	0	4	0.00000
SRR6145058	Enterococcus durans	53345	S	4	0	4	0.00000
SRR6145058	Enterobacteriaceae bacterium A-F18	2045202	S	1	4	5	0.00000
SRR6145058	Enterobacter sichuanensis	2071710	S	3	1	4	0.00000
SRR6145058	Echinicola strongylocentroti	1795355	S	4	0	4	0.00000
SRR6145058	Duganella sp. AF9R3	2728021	S	50	4	54	0.00001
SRR6145058	Dictyoglomus thermophilum	14	S	4	0	4	0.00000
SRR6145058	Dickeya dianthicola	204039	S	4	0	4	0.00000
SRR6145058	Devosia sp. A16	1736675	S	63	4	67	0.00001
SRR6145058	Desulfococcus oleovorans	181663	S	4	0	4	0.00000
SRR6145058	Desulfococcus multivorans	897	S	4	0	4	0.00000
SRR6145058	Desulfobacter hydrogenophilus	2291	S	4	0	4	0.00000
SRR6145058	Desulfitobacterium hafniense	49338	S	4	0	4	0.00000
SRR6145058	Dehalobacter restrictus	55583	S	1	3	4	0.00000
SRR6145058	Cronobacter sp. JZ38	1906275	S	2	4	6	0.00000
SRR6145058	Colwellia sp. PAMC 20917	1816218	S	4	0	4	0.00000
SRR6145058	Colwellia psychrerythraea	28229	S	4	0	4	0.00000
SRR6145058	Clostridium scatologenes	1548	S	3	1	4	0.00000
SRR6145058	Clostridium drakei	332101	S	3	1	4	0.00000
SRR6145058	Clostridium chauvoei	46867	S	4	0	4	0.00000
SRR6145058	Citrobacter sp. CFNIH10	1920110	S	1	4	5	0.00000
SRR6145058	Chryseobacterium sp. StRB126	878220	S	48	4	52	0.00001
SRR6145058	Chryseobacterium sp. G0201	2487065	S	48	4	52	0.00001
SRR6145058	Chromobacterium sp. IIBBL 112-1	2202141	S	4	10	14	0.00000
SRR6145058	Chlorobium phaeovibrioides	1094	S	4	0	4	0.00000
SRR6145058	Chlorobaculum limnaeum	274537	S	4	0	4	0.00000
SRR6145058	Changchengzhania lutea	2049305	S	4	0	4	0.00000
SRR6145058	Cellulosilyticum sp. WCF-2	2497860	S	2	4	6	0.00000
SRR6145058	Catenovulum sediminis	1740262	S	4	0	4	0.00000
SRR6145058	Carboxydocella thermautotrophica	178899	S	4	0	4	0.00000
SRR6145058	Candidatus Sodalis pierantonius	1486991	S	5	4	9	0.00000
SRR6145058	Candidatus Pelagibacter sp. RS40	1977865	S	4	0	4	0.00000
SRR6145058	Candidatus Izimaplasma sp. HR1	1541959	S	4	0	4	0.00000
SRR6145058	Campylobacter iguaniorum	1244531	S	4	0	4	0.00000
SRR6145058	Caloranaerobacter azorensis	116090	S	4	0	4	0.00000
SRR6145058	Caldilinea aerophila	133453	S	4	0	4	0.00000
SRR6145058	Caldicellulosiruptor kristjanssonii	52765	S	2	2	4	0.00000
SRR6145058	Bythopirellula goksoyri	1400387	S	4	0	4	0.00000
SRR6145058	Burkholderia sp. CCGE1001	640510	S	4	4	8	0.00000
SRR6145058	Bradyrhizobiaceae bacterium SG-6C	709797	S	40	4	44	0.00000
SRR6145058	Brachyspira murdochii	84378	S	4	0	4	0.00000
SRR6145058	Borrelia crocidurae	29520	S	1	3	4	0.00000
SRR6145058	Betapapillomavirus 1	337051	S	4	0	4	0.00000
SRR6145058	Basfia succiniciproducens	653940	S	2	2	4	0.00000
SRR6145058	Bartonella kosoyi	2133959	S	2	2	4	0.00000
SRR6145058	Bartonella apis	1686310	S	4	0	4	0.00000
SRR6145058	Bacteroides sp. A1C1	2528203	S	8	4	12	0.00000
SRR6145058	Bacillus weihaiensis	1547283	S	4	0	4	0.00000
SRR6145058	Bacillus vallismortis	72361	S	4	0	4	0.00000
SRR6145058	Bacillus sp. L13 (2020)	2728853	S	4	0	4	0.00000
SRR6145058	Bacillus sonorensis	119858	S	4	0	4	0.00000
SRR6145058	Bacillus safensis	561879	S	4	0	4	0.00000
SRR6145058	Bacillus mycoides	1405	S	4	0	4	0.00000
SRR6145058	Bacillus methanolicus	1471	S	4	0	4	0.00000
SRR6145058	Bacillus kochii	859143	S	4	0	4	0.00000
SRR6145058	Bacillus clausii	79880	S	4	0	4	0.00000
SRR6145058	Bacillus albus	2026189	S	4	0	4	0.00000
SRR6145058	Azoarcus sp. CIB	198107	S	23	4	27	0.00000
SRR6145058	Aurantimicrobium minutum	708131	S	4	0	4	0.00000
SRR6145058	Arthrobacter citreus	1670	S	4	0	4	0.00000
SRR6145058	Arcobacter suis	1278212	S	4	0	4	0.00000
SRR6145058	Arcobacter cibarius	255507	S	4	0	4	0.00000
SRR6145058	Arachidicoccus ginsenosidivorans	496057	S	4	0	4	0.00000
SRR6145058	Anoxybacillus kamchatkensis	196180	S	1	3	4	0.00000
SRR6145058	Anoxybacillus amylolyticus	294699	S	4	0	4	0.00000
SRR6145058	Amycolatopsis sp. AA4	1896961	S	82	4	86	0.00001
SRR6145058	Altererythrobacter sp. TH136	2067415	S	48	4	52	0.00001
SRR6145058	Alloactinosynnema sp. L-07	1653480	S	67	4	71	0.00001
SRR6145058	Agromyces sp. HY052	2585717	S	46	4	50	0.00001
SRR6145058	Aeromonas sp. 1805	2560028	S	2	4	6	0.00000
SRR6145058	Actinobacillus succinogenes	67854	S	4	0	4	0.00000
SRR6145058	Actinobacillus lignieresii	720	S	2	2	4	0.00000
SRR6145058	Acidithiobacillus ferrooxidans	920	S	1	3	4	0.00000
SRR6145058	Acidilobus saccharovorans	242703	S	4	0	4	0.00000
SRR6145058	Acidaminococcus fermentans	905	S	4	0	4	0.00000
SRR6145058	Acholeplasma palmae	38986	S	4	0	4	0.00000
SRR6145058	Acetobacter ascendens	481146	S	3	1	4	0.00000
SRR6145058	bacterium BFN5	2717699	S	3	0	3	0.00000
SRR6145058	[Pasteurella] aerogenes	749	S	3	0	3	0.00000
SRR6145058	[Eubacterium] cellulosolvens	29322	S	3	0	3	0.00000
SRR6145058	[Clostridium] ultunense	45497	S	3	0	3	0.00000
SRR6145058	[Bacillus] selenitireducens	85683	S	3	0	3	0.00000
SRR6145058	Zhongshania aliphaticivorans	1470434	S	3	0	3	0.00000
SRR6145058	Yokenella regensburgei	158877	S	3	0	3	0.00000
SRR6145058	Yersinia similis	367190	S	3	0	3	0.00000
SRR6145058	Yersinia rohdei	29485	S	3	0	3	0.00000
SRR6145058	Yersinia entomophaga	935293	S	3	0	3	0.00000
SRR6145058	Xenorhabdus bovienii	40576	S	3	0	3	0.00000
SRR6145058	Xanthomonas gardneri	90270	S	1	2	3	0.00000
SRR6145058	Weissella ceti	759620	S	3	0	3	0.00000
SRR6145058	Virgibacillus halodenitrificans	1482	S	3	0	3	0.00000
SRR6145058	Vibrio sp. dhg	2163016	S	2	3	5	0.00000
SRR6145058	Vibrio rumoiensis	76258	S	3	0	3	0.00000
SRR6145058	Vibrio nigripulchritudo	28173	S	3	0	3	0.00000
SRR6145058	Vibrio jasicida	766224	S	2	1	3	0.00000
SRR6145058	Vibrio cincinnatiensis	675	S	3	0	3	0.00000
SRR6145058	Vibrio astriarenae	1481923	S	3	0	3	0.00000
SRR6145058	Vibrio aphrogenes	1891186	S	3	0	3	0.00000
SRR6145058	Vibrio anguillarum	55601	S	3	0	3	0.00000
SRR6145058	Vibrio alfacsensis	1074311	S	3	0	3	0.00000
SRR6145058	Undibacterium sp. KW1	2058624	S	6	3	9	0.00000
SRR6145058	Undibacterium parvum	401471	S	3	0	3	0.00000
SRR6145058	Thermosynechococcus sp. NK55a	1394889	S	1	3	4	0.00000
SRR6145058	Thermosulfurimonas marina	2047767	S	3	0	3	0.00000
SRR6145058	Thermosipho melanesiensis	46541	S	3	0	3	0.00000
SRR6145058	Thermosipho africanus	2421	S	3	0	3	0.00000
SRR6145058	Thermosediminibacter oceani	291990	S	3	0	3	0.00000
SRR6145058	Thermogutta terrifontis	1331910	S	3	0	3	0.00000
SRR6145058	Thermogladius calderae	1200300	S	3	0	3	0.00000
SRR6145058	Thermococcus celer	2264	S	3	0	3	0.00000
SRR6145058	Thermoanaerobacter italicus	108150	S	1	2	3	0.00000
SRR6145058	Thermoactinomyces vulgaris	2026	S	3	0	3	0.00000
SRR6145058	Thermanaerovibrio acidaminovorans	81462	S	3	0	3	0.00000
SRR6145058	Thalassotalea sp. HSM 43	2552945	S	3	0	3	0.00000
SRR6145058	Tetragenococcus koreensis	290335	S	3	0	3	0.00000
SRR6145058	Terribacillus goriensis	386490	S	3	0	3	0.00000
SRR6145058	Teredinibacter turnerae	2426	S	3	0	3	0.00000
SRR6145058	Synechococcus sp. PCC 6312	195253	S	3	0	3	0.00000
SRR6145058	Synechococcus elongatus	32046	S	1	2	3	0.00000
SRR6145058	Sutterella megalosphaeroides	2494234	S	3	0	3	0.00000
SRR6145058	Sulfurisphaera ohwakuensis	69656	S	2	1	3	0.00000
SRR6145058	Sulfurimonas autotrophica	202747	S	3	0	3	0.00000
SRR6145058	Streptosporangium sp. 'caverna'	2202249	S	60	3	63	0.00001
SRR6145058	Streptomyces sp. ZFG47	2184053	S	47	3	50	0.00001
SRR6145058	Streptomyces sp. TN58	234612	S	24	3	27	0.00000
SRR6145058	Streptomyces sp. TLI_053	1855352	S	67	3	70	0.00001
SRR6145058	Streptomyces sp. RPA4-2	2721244	S	32	3	35	0.00000
SRR6145058	Streptomyces sp. QMT-28	2662397	S	30	3	33	0.00000
SRR6145058	Streptomyces sp. QHH-9511	2684468	S	34	3	37	0.00000
SRR6145058	Streptomyces sp. PAMC 26508	1265601	S	3	21	24	0.00000
SRR6145058	Streptomyces sp. CLI2509	1984801	S	2	3	5	0.00000
SRR6145058	Streptomyces sp. C8S0	2585716	S	48	3	51	0.00001
SRR6145058	Streptomyces sp. 2323.1	1938841	S	29	3	32	0.00000
SRR6145058	Streptococcus sp. CNU G3	2698804	S	3	5	8	0.00000
SRR6145058	Sterolibacteriaceae bacterium J5B	2211108	S	13	3	16	0.00000
SRR6145058	Staphylospora marina	2490858	S	3	0	3	0.00000
SRR6145058	Staphylococcus virus Stau2	2042206	S	1	3	4	0.00000
SRR6145058	Spiroplasma tabanidicola	324079	S	3	0	3	0.00000
SRR6145058	Spiroplasma monobiae	2136	S	3	0	3	0.00000
SRR6145058	Spiroplasma litorale	216942	S	3	0	3	0.00000
SRR6145058	Spirochaeta perfilievii	252967	S	3	0	3	0.00000
SRR6145058	Sphingorhabdus sp. SMR4y	2584094	S	18	3	21	0.00000
SRR6145058	Sphingomonas sp. XS-10	2599297	S	130	3	133	0.00001
SRR6145058	Sphingomonas sp. HKS19	1813879	S	115	3	118	0.00001
SRR6145058	Sphingomonas sp. Cra20	1327635	S	99	3	102	0.00001
SRR6145058	Sphingomonas sp. AP4-R1	2735134	S	121	3	124	0.00001
SRR6145058	Sphingobium sp. EP60837	1855519	S	30	3	33	0.00000
SRR6145058	Sphingobacterium sp. DR205	2713573	S	171	3	174	0.00002
SRR6145058	Sodalis praecaptivus	1239307	S	2	1	3	0.00000
SRR6145058	Shewanella sp. SNU WT4	2590015	S	3	0	3	0.00000
SRR6145058	Shewanella sp. MR-4	60480	S	4	3	7	0.00000
SRR6145058	Shewanella psychrophila	225848	S	3	0	3	0.00000
SRR6145058	Shewanella japonica	93973	S	3	0	3	0.00000
SRR6145058	Shewanella donghaensis	238836	S	3	0	3	0.00000
SRR6145058	Serratia sp. P2ACOL2	2482769	S	3	3	6	0.00000
SRR6145058	Serratia sp. ATCC 39006	104623	S	3	0	3	0.00000
SRR6145058	Serratia sp. 1D1416	2447890	S	2	3	5	0.00000
SRR6145058	Serratia ficaria	61651	S	1	2	3	0.00000
SRR6145058	Scardovia inopinata	78259	S	3	0	3	0.00000
SRR6145058	Ruminococcus champanellensis	1161942	S	3	0	3	0.00000
SRR6145058	Rickettsia typhi	785	S	3	0	3	0.00000
SRR6145058	Rickettsia raoultii	369822	S	2	1	3	0.00000
SRR6145058	Rickettsia peacockii	47589	S	1	2	3	0.00000
SRR6145058	Rhodoplanes sp. Z2-YC6860	674703	S	65	3	68	0.00001
SRR6145058	Rhodococcus sp. B7740	1564114	S	56	3	59	0.00001
SRR6145058	Rhodococcus sp. ABRD24	2507582	S	68	3	71	0.00001
SRR6145058	Rhodobacteraceae bacterium QY30	2033435	S	86	3	89	0.00001
SRR6145058	Rhizobium sp. WL3	2603277	S	53	3	56	0.00001
SRR6145058	Rhizobium sp. CIAT894	2020312	S	15	3	18	0.00000
SRR6145058	Pyrobaculum aerophilum	13773	S	3	0	3	0.00000
SRR6145058	Psychrobacillus glaciei	2283160	S	3	0	3	0.00000
SRR6145058	Pseudomonas sp. s211(2017)	2045200	S	1	3	4	0.00000
SRR6145058	Pseudomonas sp. TMW 2.1634	1886807	S	3	9	12	0.00000
SRR6145058	Pseudomonas sp. SXM-1	2169583	S	2	3	5	0.00000
SRR6145058	Pseudomonas sp. NIBRBAC000502773	2590776	S	8	3	11	0.00000
SRR6145058	Pseudomonas sp. MYb193	1827300	S	4	3	7	0.00000
SRR6145058	Pseudomonas sp. GR 6-02	1659194	S	3	6	9	0.00000
SRR6145058	Pseudomonas sp. CMR5c	658630	S	17	3	20	0.00000
SRR6145058	Pseudomonas sp. B10	118613	S	9	3	12	0.00000
SRR6145058	Pseudomonas sp. 09C 129	2054915	S	3	3	6	0.00000
SRR6145058	Pseudomonas soli	1306993	S	1	2	3	0.00000
SRR6145058	Pseudolabrys sp. FHR47	2562284	S	40	3	43	0.00000
SRR6145058	Pseudobutyrivibrio xylanivorans	185007	S	3	0	3	0.00000
SRR6145058	Pseudoalteromonas ruthenica	151081	S	2	1	3	0.00000
SRR6145058	Pseudarthrobacter sp. YJ56	2697569	S	24	3	27	0.00000
SRR6145058	Polaromonas vacuolata	37448	S	3	0	3	0.00000
SRR6145058	Polaribacter sp. BM10	1529069	S	2	3	5	0.00000
SRR6145058	Plantactinospora sp. KBS50	2024580	S	54	3	57	0.00001
SRR6145058	Planococcus versutus	1302659	S	3	0	3	0.00000
SRR6145058	Planococcus halocryophilus	1215089	S	3	0	3	0.00000
SRR6145058	Planctopirus limnophila	120	S	3	0	3	0.00000
SRR6145058	Planctomycetes bacterium V6	2528030	S	3	3	6	0.00000
SRR6145058	Planctomycetes bacterium HG66A1	2527967	S	1	3	4	0.00000
SRR6145058	Planctomycetes bacterium EC9	1930277	S	5	3	8	0.00000
SRR6145058	Photorhabdus thracensis	230089	S	3	0	3	0.00000
SRR6145058	Pediococcus inopinatus	114090	S	2	1	3	0.00000
SRR6145058	Pectobacterium wasabiae	55208	S	3	0	3	0.00000
SRR6145058	Paracoccus sp. BM15	1529068	S	124	3	127	0.00001
SRR6145058	Pantoea eucalypti	470933	S	1	2	3	0.00000
SRR6145058	Pandoravirus salinus	1349410	S	3	0	3	0.00000
SRR6145058	Pandoravirus quercus	2107709	S	3	0	3	0.00000
SRR6145058	Paenibacillus sp. UniB2	2726185	S	14	3	17	0.00000
SRR6145058	Paenibacillus sp. IHBB 10380	1566358	S	3	0	3	0.00000
SRR6145058	Paenibacillus sp. FSL R5-0345	1536770	S	3	1	4	0.00000
SRR6145058	Paenibacillus sp. FSL P4-0081	1536769	S	3	1	4	0.00000
SRR6145058	Paenibacillus sp. B01	2660554	S	19	3	22	0.00000
SRR6145058	Paenibacillus sabinae	365617	S	3	0	3	0.00000
SRR6145058	Paenibacillus riograndensis	483937	S	3	0	3	0.00000
SRR6145058	Paenibacillus protaetiae	2509456	S	3	0	3	0.00000
SRR6145058	Paenibacillus graminis	189425	S	3	0	3	0.00000
SRR6145058	Paenibacillus alvei	44250	S	3	0	3	0.00000
SRR6145058	Oxalobacter formigenes	847	S	3	0	3	0.00000
SRR6145058	Ornithinimicrobium sp. H23M54	2594265	S	82	3	85	0.00001
SRR6145058	Oenococcus sp. UCMA 16435	2259623	S	3	0	3	0.00000
SRR6145058	Octadecabacter sp. SW4	2602067	S	21	3	24	0.00000
SRR6145058	Oblitimonas alkaliphila	1697053	S	3	0	3	0.00000
SRR6145058	Novosphingobium sp. P6W	1609758	S	79	3	82	0.00001
SRR6145058	Nostoc sp. TCL240-02	2572090	S	5	3	8	0.00000
SRR6145058	Nostoc sp. ATCC 53789	76335	S	3	3	6	0.00000
SRR6145058	Nostoc piscinale	224012	S	3	0	3	0.00000
SRR6145058	Nonlabens spongiae	331648	S	3	0	3	0.00000
SRR6145058	Nonlabens sp. MIC269	1476901	S	1	3	4	0.00000
SRR6145058	Nonlabens sediminis	319236	S	1	2	3	0.00000
SRR6145058	Nitrosomonas stercoris	1444684	S	3	0	3	0.00000
SRR6145058	Neorhizobium sp. SOG26	2060726	S	35	3	38	0.00000
SRR6145058	Neorhizobium sp. NCHU2750	1825976	S	30	3	33	0.00000
SRR6145058	Natranaerobius thermophilus	375929	S	3	0	3	0.00000
SRR6145058	Mycoplasma sp. Mirounga ES2806-NAS	754516	S	3	0	3	0.00000
SRR6145058	Mycoplasma pullorum	48003	S	3	0	3	0.00000
SRR6145058	Mycoplasma penetrans	28227	S	3	0	3	0.00000
SRR6145058	Mycoplasma neurolyticum	2120	S	3	0	3	0.00000
SRR6145058	Mycoplasma cynos	171284	S	3	0	3	0.00000
SRR6145058	Mycoplasma citelli	171281	S	3	0	3	0.00000
SRR6145058	Mycoplasma bovis	28903	S	3	0	3	0.00000
SRR6145058	Mycoplasma anserisalpingitidis	519450	S	3	0	3	0.00000
SRR6145058	Mycoplasma agalactiae	2110	S	3	0	3	0.00000
SRR6145058	Moorella glycerini	55779	S	3	0	3	0.00000
SRR6145058	Mixta intestinalis	1615494	S	3	0	3	0.00000
SRR6145058	Microlunatus sp. KUDC0627	2596828	S	75	3	78	0.00001
SRR6145058	Microcystis panniformis	513223	S	2	1	3	0.00000
SRR6145058	Microbacterium sp. RG1	2489212	S	83	3	86	0.00001
SRR6145058	Microbacterium sp. 4R-513	2567934	S	80	3	83	0.00001
SRR6145058	Methylovorus glucosotrophus	266009	S	1	2	3	0.00000
SRR6145058	Methylotenera versatilis	1055487	S	3	0	3	0.00000
SRR6145058	Methylosinus sp. C49	2699395	S	31	3	34	0.00000
SRR6145058	Methylophaga nitratireducenticrescens	754476	S	3	0	3	0.00000
SRR6145058	Methylomusa anaerophila	1930071	S	3	0	3	0.00000
SRR6145058	Methanotorris igneus	2189	S	3	0	3	0.00000
SRR6145058	Methanospirillum hungatei	2203	S	3	0	3	0.00000
SRR6145058	Methanosphaerula palustris	475088	S	3	0	3	0.00000
SRR6145058	Methanosarcina mazei	2209	S	3	0	3	0.00000
SRR6145058	Methanoculleus bourgensis	83986	S	1	2	3	0.00000
SRR6145058	Methanococcoides burtonii	29291	S	3	0	3	0.00000
SRR6145058	Methanocaldococcus jannaschii	2190	S	3	0	3	0.00000
SRR6145058	Methanobrevibacter smithii	2173	S	3	0	3	0.00000
SRR6145058	Methanobrevibacter ruminantium	83816	S	3	0	3	0.00000
SRR6145058	Mesorhizobium sp. NZP2077	2483404	S	16	3	19	0.00000
SRR6145058	Marinomonas posidonica	936476	S	3	0	3	0.00000
SRR6145058	Listeria weihenstephanensis	1006155	S	3	0	3	0.00000
SRR6145058	Leptospira weilii	28184	S	3	0	3	0.00000
SRR6145058	Leptospira interrogans	173	S	4	-1	3	0.00000
SRR6145058	Legionella oakridgensis	29423	S	3	0	3	0.00000
SRR6145058	Legionella clemsonensis	1867846	S	3	0	3	0.00000
SRR6145058	Lactobacillus zhachilii	2304606	S	3	0	3	0.00000
SRR6145058	Lactobacillus terrae	2269374	S	3	0	3	0.00000
SRR6145058	Lactobacillus ruminis	1623	S	3	0	3	0.00000
SRR6145058	Lactobacillus paraplantarum	60520	S	3	0	3	0.00000
SRR6145058	Lactobacillus murinus	1622	S	3	0	3	0.00000
SRR6145058	Lactobacillus harbinensis	304207	S	3	0	3	0.00000
SRR6145058	Lactobacillus graminis	60519	S	3	0	3	0.00000
SRR6145058	Lactobacillus frumenti	104955	S	3	0	3	0.00000
SRR6145058	Lactobacillus dextrinicus	51664	S	3	0	3	0.00000
SRR6145058	Lactobacillus curieae	1138822	S	3	0	3	0.00000
SRR6145058	Lactobacillus crustorum	392416	S	3	0	3	0.00000
SRR6145058	Lactobacillus acetotolerans	1600	S	3	0	3	0.00000
SRR6145058	Lacrimispora sphenoides	29370	S	3	0	3	0.00000
SRR6145058	Lachnoclostridium phytofermentans	66219	S	3	0	3	0.00000
SRR6145058	Kyrpidia spormannii	2055160	S	3	0	3	0.00000
SRR6145058	Kosakonia radicincitans	283686	S	1	2	3	0.00000
SRR6145058	Kitasatospora sp. MMS16-BH015	2018025	S	78	3	81	0.00001
SRR6145058	Intestinibaculum porci	2487118	S	3	0	3	0.00000
SRR6145058	Idiomarina andamanensis	1940690	S	3	0	3	0.00000
SRR6145058	Hungateiclostridium saccincola	1677857	S	3	0	3	0.00000
SRR6145058	Helicobacter cinaedi	213	S	3	0	3	0.00000
SRR6145058	Helicobacter bilis	37372	S	3	0	3	0.00000
SRR6145058	Halothiobacillus neapolitanus	927	S	3	0	3	0.00000
SRR6145058	Halorubrum sp. RHB-C	2739057	S	14	3	17	0.00000
SRR6145058	Halomonas sp. THAF12	2587849	S	22	3	25	0.00000
SRR6145058	Halomonas sp. SF2003	2136172	S	6	3	9	0.00000
SRR6145058	Halomonas sp. NBT06E8	2609667	S	51	3	54	0.00001
SRR6145058	Halomonas sp. HL-93	1666906	S	1	3	4	0.00000
SRR6145058	Halomonas sp. AM6	2661553	S	6	3	9	0.00000
SRR6145058	Halohasta litchfieldiae	1073996	S	3	0	3	0.00000
SRR6145058	Haloarcula taiwanensis	1932004	S	3	0	3	0.00000
SRR6145058	Halarcobacter ebronensis	1462615	S	3	0	3	0.00000
SRR6145058	Halarcobacter bivalviorum	663364	S	3	0	3	0.00000
SRR6145058	Halanaerobium praevalens	2331	S	3	0	3	0.00000
SRR6145058	Hafnia paralvei	546367	S	3	0	3	0.00000
SRR6145058	Gramella salexigens	1913577	S	3	0	3	0.00000
SRR6145058	Georgenia sp. Z294	2585135	S	89	3	92	0.00001
SRR6145058	Geobacter uraniireducens	351604	S	3	0	3	0.00000
SRR6145058	Geobacillus thermodenitrificans	33940	S	3	0	3	0.00000
SRR6145058	Geobacillus sp. GHH01	1233873	S	1	3	4	0.00000
SRR6145058	Gammapapillomavirus sp.	2049444	S	3	0	3	0.00000
SRR6145058	Gallibacterium anatis	750	S	3	0	3	0.00000
SRR6145058	Francisella tularensis	263	S	2	1	3	0.00000
SRR6145058	Francisella halioticida	549298	S	3	0	3	0.00000
SRR6145058	Francisella adeliensis	2007306	S	3	0	3	0.00000
SRR6145058	Flagellimonas maritima	1383885	S	3	0	3	0.00000
SRR6145058	Fermentimonas caenicola	1562970	S	3	0	3	0.00000
SRR6145058	Faecalitalea cylindroides	39483	S	3	0	3	0.00000
SRR6145058	Euhalothece natronophila	577489	S	3	0	3	0.00000
SRR6145058	Eubacterium callanderi	53442	S	3	0	3	0.00000
SRR6145058	Erythrobacter sp. HKB08	2502843	S	37	3	40	0.00000
SRR6145058	Ephemeroptericola cinctiostellae	2268024	S	3	0	3	0.00000
SRR6145058	Enterococcus gallinarum	1353	S	1	2	3	0.00000
SRR6145058	Enterobacter sp. E76	2596949	S	10	3	13	0.00000
SRR6145058	Ehrlichia muris	35795	S	3	0	3	0.00000
SRR6145058	Edwardsiella tarda	636	S	3	0	3	0.00000
SRR6145058	Edwardsiella piscicida	1263550	S	1	2	3	0.00000
SRR6145058	Edwardsiella ictaluri	67780	S	3	0	3	0.00000
SRR6145058	Ectothiorhodospira sp. BSL-9	1442136	S	14	3	17	0.00000
SRR6145058	Dysgonomonas sp. HDW5A	2714926	S	2	3	5	0.00000
SRR6145058	Diaphorobacter sp. HDW4B	2714925	S	45	3	48	0.00001
SRR6145058	Desulfurispirillum indicum	936456	S	3	0	3	0.00000
SRR6145058	Desulfotomaculum reducens	59610	S	3	0	3	0.00000
SRR6145058	Desulfotomaculum nigrificans	1565	S	3	0	3	0.00000
SRR6145058	Desulfosporosinus meridiei	79209	S	3	0	3	0.00000
SRR6145058	Desulfobacula toluolica	28223	S	3	0	3	0.00000
SRR6145058	Desulfobacterium autotrophicum	2296	S	3	0	3	0.00000
SRR6145058	Desulfitobacterium dichloroeliminans	233055	S	3	0	3	0.00000
SRR6145058	Desulfallas gibsoniae	102134	S	3	0	3	0.00000
SRR6145058	Deinococcus sp. AJ005	2652443	S	123	3	126	0.00001
SRR6145058	Dehalogenimonas lykanthroporepellens	552810	S	3	0	3	0.00000
SRR6145058	Cyclobacterium marinum	104	S	3	0	3	0.00000
SRR6145058	Cryobacterium sp. LW097	1978566	S	34	3	37	0.00000
SRR6145058	Croceibacter atlanticus	313588	S	3	0	3	0.00000
SRR6145058	Coxiella burnetii	777	S	2	1	3	0.00000
SRR6145058	Corynebacterium sp. 2039	2675219	S	81	3	84	0.00001
SRR6145058	Coraliomargarita akajimensis	395922	S	3	0	3	0.00000
SRR6145058	Cohnella abietis	2507935	S	3	0	3	0.00000
SRR6145058	Chlorobium phaeobacteroides	1096	S	3	0	3	0.00000
SRR6145058	Chlorobium limicola	1092	S	3	0	3	0.00000
SRR6145058	Chlamydia avium	1457141	S	3	0	3	0.00000
SRR6145058	Capnocytophaga stomatis	1848904	S	3	0	3	0.00000
SRR6145058	Candidatus Pelagibacter sp. IMCC9063	1002672	S	3	0	3	0.00000
SRR6145058	Candidatus Arthromitus sp. SFB-rat-Yit	1041504	S	3	0	3	0.00000
SRR6145058	Campylobacter volucris	1031542	S	3	0	3	0.00000
SRR6145058	Campylobacter geochelonis	1780362	S	3	0	3	0.00000
SRR6145058	Campylobacter fetus	196	S	3	0	3	0.00000
SRR6145058	Campylobacter armoricus	2505970	S	3	0	3	0.00000
SRR6145058	Calothrix sp. PCC 7507	99598	S	3	5	8	0.00000
SRR6145058	Caldanaerobacter subterraneus	911092	S	3	0	3	0.00000
SRR6145058	Butyrivibrio proteoclasticus	43305	S	3	0	3	0.00000
SRR6145058	Butyrivibrio fibrisolvens	831	S	3	0	3	0.00000
SRR6145058	Burkholderia sp. NRF60-BP8	1637853	S	7	3	10	0.00000
SRR6145058	Burkholderia sp. MSMB617WGS	1637831	S	2	3	5	0.00000
SRR6145058	Burkholderia sp. MSMB0852	1637841	S	2	3	5	0.00000
SRR6145058	Burkholderia sp. LA-2-3-30-S1-D2	1637862	S	7	3	10	0.00000
SRR6145058	Brachyspira intermedia	84377	S	3	0	3	0.00000
SRR6145058	Borrelia turcica	229155	S	3	0	3	0.00000
SRR6145058	Borrelia miyamotoi	47466	S	3	0	3	0.00000
SRR6145058	Blautia sp. SC05B48	2479767	S	21	3	24	0.00000
SRR6145058	Blattabacterium sp. (Nauphoeta cinerea)	1316444	S	3	0	3	0.00000
SRR6145058	Blattabacterium sp. (Mastotermes darwiniensis)	39768	S	3	0	3	0.00000
SRR6145058	Beggiatoa leptomitoformis	288004	S	3	0	3	0.00000
SRR6145058	Bdellovibrio exovorus	453816	S	3	0	3	0.00000
SRR6145058	Bartonella vinsonii	33047	S	3	0	3	0.00000
SRR6145058	Bartonella quintana	803	S	3	0	3	0.00000
SRR6145058	Bartonella henselae	38323	S	3	0	3	0.00000
SRR6145058	Bacterioplanes sanyensis	1249553	S	3	0	3	0.00000
SRR6145058	Bacillus muralis	264697	S	3	0	3	0.00000
SRR6145058	Bacillus lehensis	300825	S	3	0	3	0.00000
SRR6145058	Bacillus krulwichiae	199441	S	3	0	3	0.00000
SRR6145058	Bacillus horikoshii	79883	S	3	0	3	0.00000
SRR6145058	Bacillus halotolerans	260554	S	1	2	3	0.00000
SRR6145058	Bacillus gobiensis	1441095	S	3	0	3	0.00000
SRR6145058	Bacillus ciccensis	1670641	S	3	0	3	0.00000
SRR6145058	Bacillus atrophaeus	1452	S	3	0	3	0.00000
SRR6145058	Avibacterium paragallinarum	728	S	3	0	3	0.00000
SRR6145058	Aureimonas sp. AU20	1349819	S	71	3	74	0.00001
SRR6145058	Arthrobacter sp. U41	1849032	S	36	3	39	0.00000
SRR6145058	Arthrobacter sp. 24S4-2	2575374	S	37	3	40	0.00000
SRR6145058	Arcobacter venerupis	1054033	S	3	0	3	0.00000
SRR6145058	Arcobacter sp. L	944547	S	3	3	6	0.00000
SRR6145058	Arcobacter pacificus	1080223	S	3	0	3	0.00000
SRR6145058	Arcobacter molluscorum	1032072	S	3	0	3	0.00000
SRR6145058	Arcobacter marinus	505249	S	2	1	3	0.00000
SRR6145058	Arcobacter anaerophilus	877500	S	3	0	3	0.00000
SRR6145058	Anoxybacillus sp. PDR2	1636720	S	2	3	5	0.00000
SRR6145058	Anaplasma platys	949	S	1	2	3	0.00000
SRR6145058	Anaerotignum propionicum	28446	S	3	0	3	0.00000
SRR6145058	Anaerostipes rhamnosivorans	1229621	S	3	0	3	0.00000
SRR6145058	Anabaena sp. WA102	1647413	S	3	3	6	0.00000
SRR6145058	Anabaena cylindrica	1165	S	3	0	3	0.00000
SRR6145058	Ammonifex degensii	42838	S	3	0	3	0.00000
SRR6145058	Alteromonas naphthalenivorans	715451	S	3	0	3	0.00000
SRR6145058	Aliivibrio wodanis	80852	S	3	0	3	0.00000
SRR6145058	Agarivorans gilvus	680279	S	3	0	3	0.00000
SRR6145058	Actinobacillus delphinicola	51161	S	3	0	3	0.00000
SRR6145058	Acidianus brierleyi	41673	S	3	0	3	0.00000
SRR6145058	Acholeplasma hippikon	264636	S	3	0	3	0.00000
SRR6145058	Acholeplasma brassicae	61635	S	3	0	3	0.00000
SRR6145058	halophilic archaeon DL31	756883	S	9	2	11	0.00000
SRR6145058	bacterium 2013Arg42i	1561003	S	2	0	2	0.00000
SRR6145058	[Mannheimia] succiniciproducens	157673	S	1	1	2	0.00000
SRR6145058	[Clostridium] hylemonae	89153	S	2	0	2	0.00000
SRR6145058	[Clostridium] cellulosi	29343	S	2	0	2	0.00000
SRR6145058	[Arcobacter] porcinus	1935204	S	2	0	2	0.00000
SRR6145058	Yersinia ruckeri	29486	S	2	0	2	0.00000
SRR6145058	Yersinia pseudotuberculosis	633	S	2	0	2	0.00000
SRR6145058	Yersinia aldovae	29483	S	2	0	2	0.00000
SRR6145058	Xylella fastidiosa	2371	S	2	0	2	0.00000
SRR6145058	Wolinella succinogenes	844	S	2	0	2	0.00000
SRR6145058	White spot syndrome virus	342409	S	2	0	2	0.00000
SRR6145058	Weissella soli	155866	S	2	0	2	0.00000
SRR6145058	Weissella koreensis	165096	S	2	0	2	0.00000
SRR6145058	Vogesella sp. LIG4	1192162	S	35	2	37	0.00000
SRR6145058	Virgibacillus phasianinus	2017483	S	2	0	2	0.00000
SRR6145058	Virgibacillus necropolis	163877	S	2	0	2	0.00000
SRR6145058	Vibrio tritonius	1435069	S	2	0	2	0.00000
SRR6145058	Vibrio tapetis	52443	S	2	0	2	0.00000
SRR6145058	Vibrio splendidus	29497	S	2	0	2	0.00000
SRR6145058	Vibrio rotiferianus	190895	S	2	0	2	0.00000
SRR6145058	Vibrio ponticus	265668	S	2	0	2	0.00000
SRR6145058	Vibrio owensii	696485	S	2	0	2	0.00000
SRR6145058	Vibrio navarrensis	29495	S	2	0	2	0.00000
SRR6145058	Vibrio metoecus	1481663	S	2	0	2	0.00000
SRR6145058	Vibrio mediterranei	689	S	2	0	2	0.00000
SRR6145058	Vibrio hyugaensis	1534743	S	2	0	2	0.00000
SRR6145058	Vibrio harveyi	669	S	2	0	2	0.00000
SRR6145058	Vibrio gazogenes	687	S	2	0	2	0.00000
SRR6145058	Vibrio coralliilyticus	190893	S	2	0	2	0.00000
SRR6145058	Vibrio chagasii	170679	S	2	0	2	0.00000
SRR6145058	Ureaplasma urealyticum	2130	S	2	0	2	0.00000
SRR6145058	Trichormus azollae	1164	S	2	0	2	0.00000
SRR6145058	Treponema caldarium	215591	S	2	0	2	0.00000
SRR6145058	Tomitella sp. HY188	2597660	S	85	2	87	0.00001
SRR6145058	Thioploca ingrica	40754	S	2	0	2	0.00000
SRR6145058	Thiomicrorhabdus aquaedulcis	2211106	S	2	0	2	0.00000
SRR6145058	Thermus oshimai	56957	S	2	0	2	0.00000
SRR6145058	Thermus caldilimi	2483360	S	2	0	2	0.00000
SRR6145058	Thermofilum pendens	2269	S	2	0	2	0.00000
SRR6145058	Thermodesulfobium narugense	184064	S	2	0	2	0.00000
SRR6145058	Thermococcus litoralis	2265	S	2	0	2	0.00000
SRR6145058	Thermococcus eurythermalis	1505907	S	2	0	2	0.00000
SRR6145058	Thermobaculum terrenum	166501	S	2	0	2	0.00000
SRR6145058	Thalassotalea crassostreae	1763536	S	2	0	2	0.00000
SRR6145058	Tatlockia micdadei	451	S	2	0	2	0.00000
SRR6145058	Syntrophothermus lipocalidus	86170	S	2	0	2	0.00000
SRR6145058	Synechococcus phage S-RIM2 R1_1999	869662	S	2	0	2	0.00000
SRR6145058	Synechococcus lividus	33070	S	2	0	2	0.00000
SRR6145058	Swingsia samuiensis	1293412	S	2	0	2	0.00000
SRR6145058	Sulfurimonas gotlandica	1176482	S	2	0	2	0.00000
SRR6145058	Sulfurimonas denitrificans	39766	S	2	0	2	0.00000
SRR6145058	Sulfuricurvum kujiense	148813	S	2	0	2	0.00000
SRR6145058	Streptomyces virus Izzy	1982888	S	1	2	3	0.00000
SRR6145058	Streptomyces sp. SirexAA-E	862751	S	28	2	30	0.00000
SRR6145058	Streptomyces sp. RTd22	1841249	S	60	2	62	0.00001
SRR6145058	Streptomyces sp. QMT-12	2717324	S	42	2	44	0.00000
SRR6145058	Streptomyces sp. GSSD-12	2282738	S	42	2	44	0.00000
SRR6145058	Streptomyces sp. GBA 94-10	1218177	S	2	17	19	0.00000
SRR6145058	Streptococcus sp. CNU 77-61	2684658	S	2	4	6	0.00000
SRR6145058	Streptococcus phage SM1	157924	S	13	2	15	0.00000
SRR6145058	Streptococcus phage PH10	644007	S	9	2	11	0.00000
SRR6145058	Staphylothermus hellenicus	84599	S	2	0	2	0.00000
SRR6145058	Squirrelpox virus	240426	S	2	0	2	0.00000
SRR6145058	Sporosarcina pasteurii	1474	S	2	0	2	0.00000
SRR6145058	Spirosoma sp. I-24	2666025	S	9	2	11	0.00000
SRR6145058	Spirosoma sp. BT328	2692134	S	6	2	8	0.00000
SRR6145058	Spiroplasma turonicum	216946	S	2	0	2	0.00000
SRR6145058	Spiroplasma gladiatoris	2143	S	2	0	2	0.00000
SRR6145058	Spiroplasma floricola	216937	S	2	0	2	0.00000
SRR6145058	Spirochaeta africana	46355	S	2	0	2	0.00000
SRR6145058	Sphingomonas sp. MK52	2711156	S	74	2	76	0.00001
SRR6145058	Sphaerochaeta pleomorpha	1131707	S	2	0	2	0.00000
SRR6145058	Sphaerochaeta coccoides	273376	S	2	0	2	0.00000
SRR6145058	Solimonas sp. K1W22B-7	2303331	S	76	2	78	0.00001
SRR6145058	Shewanella sp. ANA-3	94122	S	4	2	6	0.00000
SRR6145058	Shewanella piezotolerans	404011	S	2	0	2	0.00000
SRR6145058	Shewanella maritima	2520507	S	2	0	2	0.00000
SRR6145058	Shewanella frigidimarina	56812	S	2	0	2	0.00000
SRR6145058	Serratia sp. YD25	1759437	S	12	2	14	0.00000
SRR6145058	Serratia sp. FGI94	671990	S	5	2	7	0.00000
SRR6145058	Serratia phage Moabite	2587814	S	1	2	3	0.00000
SRR6145058	Sedimentisphaera salicampi	1941349	S	2	0	2	0.00000
SRR6145058	Salinispira pacifica	1307761	S	2	0	2	0.00000
SRR6145058	Saliniradius amylolyticus	2183582	S	2	0	2	0.00000
SRR6145058	Salinibacterium sp. dk2585	2603292	S	31	2	33	0.00000
SRR6145058	Saccharopolyspora sp. ASAGF58	2719023	S	61	2	63	0.00001
SRR6145058	Saccharomonospora sp. 31sw	2528243	S	31	2	33	0.00000
SRR6145058	Saccharolobus solfataricus	2287	S	2	0	2	0.00000
SRR6145058	Ruminiclostridium cellulolyticum	1521	S	2	0	2	0.00000
SRR6145058	Rufibacter sp. DG31D	1379910	S	7	2	9	0.00000
SRR6145058	Rufibacter sp. DG15C	1379909	S	3	2	5	0.00000
SRR6145058	Ruegeria sp. TM1040	292414	S	18	2	20	0.00000
SRR6145058	Rippkaea orientalis	2546366	S	2	0	2	0.00000
SRR6145058	Rickettsia canadensis	788	S	2	0	2	0.00000
SRR6145058	Rickettsia akari	786	S	2	0	2	0.00000
SRR6145058	Rhodospirillaceae bacterium B3	2728875	S	38	2	40	0.00000
SRR6145058	Rhizobium sp. NXC14	1981173	S	15	2	17	0.00000
SRR6145058	Rhizobium sp. NIBRBAC000502774	2590777	S	2	2	4	0.00000
SRR6145058	Pyrobaculum neutrophilum	70771	S	2	0	2	0.00000
SRR6145058	Pyrobaculum ferrireducens	1104324	S	2	0	2	0.00000
SRR6145058	Pyrobaculum arsenaticum	121277	S	2	0	2	0.00000
SRR6145058	Psychromonas ingrahamii	357794	S	2	0	2	0.00000
SRR6145058	Pseudomonas sp. SK	2729423	S	20	2	22	0.00000
SRR6145058	Pseudomonas sp. SCB32	2653853	S	32	2	34	0.00000
SRR6145058	Pseudomonas sp. R76	1573711	S	13	2	15	0.00000
SRR6145058	Pseudomonas sp. NS1(2017)	2025658	S	13	2	15	0.00000
SRR6145058	Pseudomonas sp. NC02	2067572	S	1	2	3	0.00000
SRR6145058	Pseudomonas sp. LH1G9	2083055	S	1	2	3	0.00000
SRR6145058	Pseudodesulfovibrio piezophilus	879567	S	2	0	2	0.00000
SRR6145058	Pseudoalteromonas espejiana	28107	S	2	0	2	0.00000
SRR6145058	Prosthecochloris aestuarii	1102	S	2	0	2	0.00000
SRR6145058	Propionimicrobium sp. Marseille-P3275	1871034	S	83	2	85	0.00001
SRR6145058	Prochlorococcus sp. MIT 0604	1501268	S	2	2	4	0.00000
SRR6145058	Pragia fontium	82985	S	2	0	2	0.00000
SRR6145058	Polynucleobacter paneuropaeus	2527775	S	2	0	2	0.00000
SRR6145058	Planococcus donghaensis	414778	S	2	0	2	0.00000
SRR6145058	Planktothrix agardhii	1160	S	2	0	2	0.00000
SRR6145058	Planctomycetes bacterium Pan161	2527971	S	10	2	12	0.00000
SRR6145058	Planctomycetes bacterium Mal33	2527992	S	1	2	3	0.00000
SRR6145058	Planctomyces sp. SH-PL62	1636152	S	53	2	55	0.00001
SRR6145058	Pigmentiphaga sp. H8	2488560	S	57	2	59	0.00001
SRR6145058	Phreatobacter sp. NMCR1094	2570229	S	53	2	55	0.00001
SRR6145058	Phaeobacter sp. LSS9	681157	S	2	2	4	0.00000
SRR6145058	Pelolinea submarina	913107	S	2	0	2	0.00000
SRR6145058	Pelodictyon phaeoclathratiforme	34090	S	2	0	2	0.00000
SRR6145058	Pelodictyon luteolum	1100	S	2	0	2	0.00000
SRR6145058	Pectobacterium punjabense	2108399	S	2	0	2	0.00000
SRR6145058	Paraphotobacterium marinum	1755811	S	2	0	2	0.00000
SRR6145058	Paraburkholderia sp. 7Q-K02	2571747	S	34	2	36	0.00000
SRR6145058	Paraburkholderia sp. 7MH5	2547399	S	51	2	53	0.00001
SRR6145058	Pantoea sp. SO10	2575375	S	30	2	32	0.00000
SRR6145058	Paenibacillus yonginensis	1462996	S	2	0	2	0.00000
SRR6145058	Paenibacillus xylanexedens	528191	S	2	0	2	0.00000
SRR6145058	Paenibacillus terrae	159743	S	2	0	2	0.00000
SRR6145058	Paenibacillus sp. FSL R5-0912	1536771	S	2	1	3	0.00000
SRR6145058	Paenibacillus sp. FSL H7-0357	1536774	S	2	0	2	0.00000
SRR6145058	Paenibacillus sp. Cedars	1980674	S	1	2	3	0.00000
SRR6145058	Paenibacillus physcomitrellae	1619311	S	2	0	2	0.00000
SRR6145058	Paenibacillus odorifer	189426	S	2	0	2	0.00000
SRR6145058	Paenibacillus lautus	1401	S	2	0	2	0.00000
SRR6145058	Paenibacillus crassostreae	1763538	S	2	0	2	0.00000
SRR6145058	Paenibacillus brasilensis	128574	S	2	0	2	0.00000
SRR6145058	Paenibacillus antarcticus	253703	S	2	0	2	0.00000
SRR6145058	Paenibacillus albus	2495582	S	2	0	2	0.00000
SRR6145058	Olleya aquimaris	639310	S	2	0	2	0.00000
SRR6145058	Oerskovia sp. KBS0722	1179673	S	56	2	58	0.00001
SRR6145058	Oenococcus oeni	1247	S	2	0	2	0.00000
SRR6145058	Oceanisphaera profunda	1416627	S	2	0	2	0.00000
SRR6145058	Oceanisphaera avium	1903694	S	2	0	2	0.00000
SRR6145058	Nostoc sp. NIES-2111	1973475	S	2	2	4	0.00000
SRR6145058	Nitrososphaera viennensis	1034015	S	2	0	2	0.00000
SRR6145058	Nitrosococcus wardiae	1814290	S	2	0	2	0.00000
SRR6145058	Nitratireductor sp. OM-1	1756988	S	27	2	29	0.00000
SRR6145058	Nautilia profundicola	244787	S	2	0	2	0.00000
SRR6145058	Mycoplasma yeatsii	51365	S	2	0	2	0.00000
SRR6145058	Mycoplasma putrefaciens	2123	S	2	0	2	0.00000
SRR6145058	Mycoplasma pulmonis	2107	S	2	0	2	0.00000
SRR6145058	Mycoplasma iowae	2116	S	2	0	2	0.00000
SRR6145058	Mycoplasma haemofelis	29501	S	2	0	2	0.00000
SRR6145058	Mycoplasma conjunctivae	45361	S	1	1	2	0.00000
SRR6145058	Mycoplasma californicum	2113	S	2	0	2	0.00000
SRR6145058	Mycoplasma bovigenitalium	2112	S	2	0	2	0.00000
SRR6145058	Mycoplasma arthritidis	2111	S	2	0	2	0.00000
SRR6145058	Mycobacterium virus Trixie	1993867	S	1	2	3	0.00000
SRR6145058	Mycobacterium sp. JS623	212767	S	138	2	140	0.00002
SRR6145058	Mucilaginibacter ginsenosidivorans	398053	S	2	0	2	0.00000
SRR6145058	Moritella yayanosii	69539	S	2	0	2	0.00000
SRR6145058	Moorella thermoacetica	1525	S	2	0	2	0.00000
SRR6145058	Mimivirus terra2	1128151	S	2	0	2	0.00000
SRR6145058	Microbacterium sp. XT11	367477	S	56	2	58	0.00001
SRR6145058	Microbacterium sp. ST-M6	2614638	S	58	2	60	0.00001
SRR6145058	Microbacterium sp. ABRD_28	2268461	S	73	2	75	0.00001
SRR6145058	Methylotenera mobilis	359408	S	2	0	2	0.00000
SRR6145058	Methylomonas denitrificans	1538553	S	2	0	2	0.00000
SRR6145058	Methylomicrobium buryatense	95641	S	2	0	2	0.00000
SRR6145058	Methylacidiphilum fumariolicum	591154	S	2	0	2	0.00000
SRR6145058	Methanothermococcus okinawensis	155863	S	2	0	2	0.00000
SRR6145058	Methanosphaera stadtmanae	2317	S	2	0	2	0.00000
SRR6145058	Methanosarcina lacustris	170861	S	2	0	2	0.00000
SRR6145058	Methanohalobium evestigatum	2322	S	2	0	2	0.00000
SRR6145058	Methanococcus voltae	2188	S	2	0	2	0.00000
SRR6145058	Methanococcoides methylutens	2226	S	2	0	2	0.00000
SRR6145058	Methanocella conradii	1175444	S	1	1	2	0.00000
SRR6145058	Methanocaldococcus vulcanius	73913	S	2	0	2	0.00000
SRR6145058	Methanocaldococcus infernus	67760	S	2	0	2	0.00000
SRR6145058	Methanocaldococcus bathoardescens	1301915	S	2	0	2	0.00000
SRR6145058	Methanobrevibacter olleyae	294671	S	2	0	2	0.00000
SRR6145058	Methanobacterium formicicum	2162	S	2	0	2	0.00000
SRR6145058	Mesotoga prima	1184387	S	2	0	2	0.00000
SRR6145058	Mesorhizobium sp. AA22	1854057	S	3	2	5	0.00000
SRR6145058	Massilistercora timonensis	2086584	S	2	0	2	0.00000
SRR6145058	Marivivens sp. JLT3646	1920883	S	7	2	9	0.00000
SRR6145058	Marinomonas primoryensis	178399	S	2	0	2	0.00000
SRR6145058	Maribacter sp. MAR_2009_60	1250153	S	3	2	5	0.00000
SRR6145058	Lysobacter sp. TY2-98	2290922	S	62	2	64	0.00001
SRR6145058	Lysinibacillus timonensis	2086577	S	2	0	2	0.00000
SRR6145058	Lymantria dispar multiple nucleopolyhedrovirus	10449	S	2	0	2	0.00000
SRR6145058	Luteimonas sp. JM171	1896164	S	63	2	65	0.00001
SRR6145058	Longibaculum sp. KGMB06250	2584943	S	7	2	9	0.00000
SRR6145058	Listeria ivanovii	1638	S	2	0	2	0.00000
SRR6145058	Leptospira borgpetersenii	174	S	2	0	2	0.00000
SRR6145058	Leptolyngbya sp. PCC 7376	111781	S	2	0	2	0.00000
SRR6145058	Legionella spiritensis	452	S	2	0	2	0.00000
SRR6145058	Legionella israelensis	454	S	2	0	2	0.00000
SRR6145058	Legionella hackeliae	449	S	2	0	2	0.00000
SRR6145058	Legionella geestiana	45065	S	2	0	2	0.00000
SRR6145058	Legionella anisa	28082	S	2	0	2	0.00000
SRR6145058	Leclercia sp. W17	2282309	S	1	2	3	0.00000
SRR6145058	Lactococcus sp. KACC 19320	2592653	S	2	3	5	0.00000
SRR6145058	Lactococcus phage 340	1262533	S	3	2	5	0.00000
SRR6145058	Lactobacillus sp. C25	2692757	S	1	2	3	0.00000
SRR6145058	Lactobacillus rhamnosus	47715	S	2	0	2	0.00000
SRR6145058	Lactobacillus pontis	35787	S	2	0	2	0.00000
SRR6145058	Lactobacillus nenjiangensis	1296540	S	2	0	2	0.00000
SRR6145058	Lactobacillus allii	1847728	S	2	0	2	0.00000
SRR6145058	Lachnospiraceae bacterium GAM79	2109691	S	7	2	9	0.00000
SRR6145058	Kyrpidia tusciae	33943	S	2	0	2	0.00000
SRR6145058	Kroppenstedtia eburnea	714067	S	2	0	2	0.00000
SRR6145058	Jeotgalibaca sp. PTS2502	1903686	S	3	2	5	0.00000
SRR6145058	Ignavibacterium album	591197	S	1	1	2	0.00000
SRR6145058	Ichthyobacterium seriolicida	242600	S	2	0	2	0.00000
SRR6145058	Hymenobacter sp. DG25B	1385664	S	12	2	14	0.00000
SRR6145058	Hymenobacter sp. DG25A	1385663	S	11	2	13	0.00000
SRR6145058	Hymenobacter sp. BRD72	2615203	S	7	2	9	0.00000
SRR6145058	Hydrogenovibrio marinus	28885	S	2	0	2	0.00000
SRR6145058	Hydrogenobacter thermophilus	940	S	2	0	2	0.00000
SRR6145058	Hippea maritima	84405	S	2	0	2	0.00000
SRR6145058	Herbinix luporum	1679721	S	2	0	2	0.00000
SRR6145058	Heliorestis convoluta	356322	S	2	0	2	0.00000
SRR6145058	Helicobacter felis	214	S	2	0	2	0.00000
SRR6145058	Helicobacter cetorum	138563	S	2	0	2	0.00000
SRR6145058	Helicobacter canis	29419	S	2	0	2	0.00000
SRR6145058	Helicobacter bizzozeronii	56877	S	2	0	2	0.00000
SRR6145058	Halothermothrix orenii	31909	S	2	0	2	0.00000
SRR6145058	Halorhodospira halochloris	1052	S	2	0	2	0.00000
SRR6145058	Halomonas sp. KO116	1504981	S	30	2	32	0.00000
SRR6145058	Halodesulfurarchaeum formicicum	1873524	S	2	0	2	0.00000
SRR6145058	Halanaerobium hydrogeniformans	656519	S	2	0	2	0.00000
SRR6145058	Gudongella oleilytica	1582259	S	2	0	2	0.00000
SRR6145058	Gryllotalpicola sp. 2DFW10M-5	2419771	S	52	2	54	0.00001
SRR6145058	Gordonia sp. HY186	2597659	S	70	2	72	0.00001
SRR6145058	Gloeothece verrucosa	2546359	S	2	0	2	0.00000
SRR6145058	Georgenia sp. ZLJ0423	2483799	S	82	2	84	0.00001
SRR6145058	Geobacter sp. M21	443144	S	11	2	13	0.00000
SRR6145058	Gemella sp. ND 6198	2040624	S	2	5	7	0.00000
SRR6145058	Gammapapillomavirus 3	333929	S	2	0	2	0.00000
SRR6145058	Gammapapillomavirus 19	1513264	S	2	0	2	0.00000
SRR6145058	Francisella uliginis	573570	S	2	0	2	0.00000
SRR6145058	Francisella hispaniensis	622488	S	2	0	2	0.00000
SRR6145058	Francisella frigiditurris	1542390	S	2	0	2	0.00000
SRR6145058	Formosa sediminum	2594004	S	2	0	2	0.00000
SRR6145058	Flexistipes sinusarabici	2352	S	2	0	2	0.00000
SRR6145058	Flavobacterium sp. KBS0721	1179672	S	17	2	19	0.00000
SRR6145058	Flavobacterium sp. HYN0086	2249356	S	12	2	14	0.00000
SRR6145058	Escherichia virus ID21	1945584	S	2	2	4	0.00000
SRR6145058	Escherichia marmotae	1499973	S	2	0	2	0.00000
SRR6145058	Erysipelothrix larvae	1514105	S	2	0	2	0.00000
SRR6145058	Erwinia pyrifoliae	79967	S	1	1	2	0.00000
SRR6145058	Enterococcus thailandicus	417368	S	2	0	2	0.00000
SRR6145058	Endomicrobium proavitum	1408281	S	1	1	2	0.00000
SRR6145058	Devosia sp. I507	2083786	S	34	2	36	0.00000
SRR6145058	Devosia sp. 1566	2499144	S	32	2	34	0.00000
SRR6145058	Desulfurobacterium thermolithotrophum	64160	S	2	0	2	0.00000
SRR6145058	Desulfurivibrio alkaliphilus	427923	S	2	0	2	0.00000
SRR6145058	Desulfurella acetivorans	33002	S	2	0	2	0.00000
SRR6145058	Desulfovibrio hydrothermalis	191026	S	2	0	2	0.00000
SRR6145058	Desulfovibrio alaskensis	58180	S	2	0	2	0.00000
SRR6145058	Desulfotalea psychrophila	84980	S	2	0	2	0.00000
SRR6145058	Desulfosporosinus orientis	1563	S	2	0	2	0.00000
SRR6145058	Desulfosporosinus acidiphilus	885581	S	2	0	2	0.00000
SRR6145058	Desulfosarcina alkanivorans	571177	S	2	0	2	0.00000
SRR6145058	Desulfomonile tiedjei	2358	S	2	0	2	0.00000
SRR6145058	Desulfofarcimen acetoxidans	58138	S	2	0	2	0.00000
SRR6145058	Desulfocapsa sulfexigens	65555	S	2	0	2	0.00000
SRR6145058	Desulfobacter postgatei	2293	S	2	0	2	0.00000
SRR6145058	Desulfobacca acetoxidans	60893	S	2	0	2	0.00000
SRR6145058	Desulfitobacterium metallireducens	142877	S	2	0	2	0.00000
SRR6145058	Denitrovibrio acetiphilus	118000	S	2	0	2	0.00000
SRR6145058	Denitrobacterium detoxificans	79604	S	2	0	2	0.00000
SRR6145058	Dehalococcoides mccartyi	61435	S	2	0	2	0.00000
SRR6145058	Defluviitoga tunisiensis	1006576	S	2	0	2	0.00000
SRR6145058	Cyanobacterium aponinum	379064	S	2	0	2	0.00000
SRR6145058	Cryptobacterium curtum	84163	S	2	0	2	0.00000
SRR6145058	Colwellia beringensis	1967665	S	2	0	2	0.00000
SRR6145058	Clostridium tyrobutyricum	1519	S	2	0	2	0.00000
SRR6145058	Clostridium carboxidivorans	217159	S	2	0	2	0.00000
SRR6145058	Clostridiales bacterium CCNA10	2109688	S	7	2	9	0.00000
SRR6145058	Citrobacter sp. FDAARGOS_156	1702170	S	1	2	3	0.00000
SRR6145058	Chromobacterium sp. IIBBL 274-1	2202142	S	2	5	7	0.00000
SRR6145058	Chromobacterium sp. 257-1	2605945	S	16	2	18	0.00000
SRR6145058	Christensenella minuta	626937	S	2	0	2	0.00000
SRR6145058	Chlorobaculum tepidum	1097	S	2	0	2	0.00000
SRR6145058	Chlorobaculum parvum	274539	S	2	0	2	0.00000
SRR6145058	Chlamydia abortus	83555	S	2	0	2	0.00000
SRR6145058	Chelativorans sp. BNC1	266779	S	43	2	45	0.00000
SRR6145058	Chania multitudinisentens	1639108	S	2	0	2	0.00000
SRR6145058	Cetia pacifica	1424653	S	2	0	2	0.00000
SRR6145058	Cellulomonas sp. 40-2	2729175	S	49	2	51	0.00001
SRR6145058	Candidatus Pelagibacter sp. RS39	1977864	S	2	0	2	0.00000
SRR6145058	Candidatus Nitrotoga sp. AM1P	2559597	S	2	0	2	0.00000
SRR6145058	Campylobacter sputorum	206	S	2	0	2	0.00000
SRR6145058	Campylobacter coli	195	S	2	0	2	0.00000
SRR6145058	Calditerrivibrio nitroreducens	477976	S	2	0	2	0.00000
SRR6145058	Caldisphaera lagunensis	200415	S	2	0	2	0.00000
SRR6145058	Caldicellulosiruptor owensensis	55205	S	2	0	2	0.00000
SRR6145058	Caldicellulosiruptor obsidiansis	717609	S	2	0	2	0.00000
SRR6145058	Caldicellulosiruptor kronotskyensis	413889	S	2	0	2	0.00000
SRR6145058	Butyrivibrio hungatei	185008	S	2	0	2	0.00000
SRR6145058	Brucella sp. 09RB8910	1844051	S	4	2	6	0.00000
SRR6145058	Brevefilum fermentans	1986204	S	2	0	2	0.00000
SRR6145058	Breoghania sp. L-A4	2304600	S	57	2	59	0.00001
SRR6145058	Bordetella genomosp. 9	1416803	S	22	2	24	0.00000
SRR6145058	Blattabacterium sp. (Blattella germanica)	624186	S	2	0	2	0.00000
SRR6145058	Betapapillomavirus 5	334209	S	2	0	2	0.00000
SRR6145058	Betapapillomavirus 4	334208	S	2	0	2	0.00000
SRR6145058	Bdellovibrio sp. ZAP7	2231053	S	14	2	16	0.00000
SRR6145058	Bartonella sp. 1-1C	515256	S	2	2	4	0.00000
SRR6145058	Bartonella schoenbuchensis	165694	S	2	0	2	0.00000
SRR6145058	Bartonella grahamii	33045	S	2	0	2	0.00000
SRR6145058	Bacteroides coprosuis	151276	S	2	0	2	0.00000
SRR6145058	Bacteriophage vB_NpeS-2AV2	1777122	S	1	1	2	0.00000
SRR6145058	Bacillus sp. BS98	2608254	S	1	2	3	0.00000
SRR6145058	Bacillus smithii	1479	S	2	0	2	0.00000
SRR6145058	Bacillus simplex	1478	S	2	0	2	0.00000
SRR6145058	Bacillus glycinifermentans	1664069	S	2	0	2	0.00000
SRR6145058	Bacillus cellulosilyticus	1413	S	2	0	2	0.00000
SRR6145058	Bacillus butanolivorans	421767	S	2	0	2	0.00000
SRR6145058	Arthrobacter sp. ZXY-2	1806905	S	38	2	40	0.00000
SRR6145058	Arthrobacter sp. YC-RL1	1652545	S	62	2	64	0.00001
SRR6145058	Arthrobacter sp. QXT-31	1357915	S	43	2	45	0.00000
SRR6145058	Arthrobacter sp. PAMC25564	2565366	S	34	2	36	0.00000
SRR6145058	Arcobacter cloacae	1054034	S	2	0	2	0.00000
SRR6145058	Arcobacter aquimarinus	1315211	S	2	0	2	0.00000
SRR6145058	Aquitalea sp. USM4	1590041	S	14	2	16	0.00000
SRR6145058	Aquicella lusitana	254246	S	2	0	2	0.00000
SRR6145058	Apibacter sp. B3706	2656760	S	2	2	4	0.00000
SRR6145058	Anseongella ginsenosidimutans	496056	S	2	0	2	0.00000
SRR6145058	Aneurinibacillus soli	1500254	S	2	0	2	0.00000
SRR6145058	Anaerohalosphaera lusitana	1936003	S	2	0	2	0.00000
SRR6145058	Alteromonas stellipolaris	233316	S	1	1	2	0.00000
SRR6145058	Alteromonas sp. MB-3u-76	2058133	S	1	2	3	0.00000
SRR6145058	Alteromonas australica	589873	S	2	0	2	0.00000
SRR6145058	Alteromonas addita	287094	S	1	1	2	0.00000
SRR6145058	Allopseudarcicella aquatilis	998844	S	2	0	2	0.00000
SRR6145058	Allofrancisella guangzhouensis	594679	S	2	0	2	0.00000
SRR6145058	Alkaliphilus metalliredigens	208226	S	2	0	2	0.00000
SRR6145058	Aliivibrio salmonicida	40269	S	2	0	2	0.00000
SRR6145058	Aliiarcobacter faecis	1564138	S	2	0	2	0.00000
SRR6145058	Algibacter sp. L3A6	2686366	S	8	2	10	0.00000
SRR6145058	Alcanivorax sp. N3-2A	2014542	S	36	2	38	0.00000
SRR6145058	Aeromonas rivipollensis	948519	S	1	1	2	0.00000
SRR6145058	Actinobacillus indolicus	51049	S	2	0	2	0.00000
SRR6145058	Acinetobacter virus AbP2	2560264	S	3	2	5	0.00000
SRR6145058	Acinetobacter sp. WCHAc010034	1879049	S	26	2	28	0.00000
SRR6145058	Acinetobacter sp. NCu2D-2	1608473	S	28	2	30	0.00000
SRR6145058	Acinetobacter sp. LoGeW2-3	1808001	S	43	2	45	0.00000
SRR6145058	Acidianus sulfidivorans	312539	S	2	0	2	0.00000
SRR6145058	Acidianus manzaensis	282676	S	2	0	2	0.00000
SRR6145058	Acidianus hospitalis	563177	S	2	0	2	0.00000
SRR6145058	Achromobacter sp. B7	2282475	S	21	2	23	0.00000
SRR6145058	Acetohalobium arabaticum	28187	S	2	0	2	0.00000
SRR6145058	Acetobacterium woodii	33952	S	2	0	2	0.00000
SRR6145058	uncultured crAssphage	1211417	S	1	0	1	0.00000
SRR6145058	Yersinia mollaretii	33060	S	1	0	1	0.00000
SRR6145058	Yersinia intermedia	631	S	1	0	1	0.00000
SRR6145058	Yersinia hibernica	2339259	S	1	0	1	0.00000
SRR6145058	Yersinia canariae	2607663	S	1	0	1	0.00000
SRR6145058	Xenorhabdus poinarii	40577	S	1	0	1	0.00000
SRR6145058	Xanthomonas citri phage CP2	1188795	S	1	0	1	0.00000
SRR6145058	Weissella cryptocerci	2506420	S	1	0	1	0.00000
SRR6145058	Vulcanisaeta moutnovskia	985052	S	1	0	1	0.00000
SRR6145058	Vulcanisaeta distributa	164451	S	1	0	1	0.00000
SRR6145058	Virgibacillus sp. SK37	403957	S	4	1	5	0.00000
SRR6145058	Vibrio tasmaniensis	212663	S	1	0	1	0.00000
SRR6145058	Vibrio qinghaiensis	2025808	S	1	0	1	0.00000
SRR6145058	Vibrio panuliri	1381081	S	1	0	1	0.00000
SRR6145058	Vibrio cyclitrophicus	47951	S	1	0	1	0.00000
SRR6145058	Vibrio crassostreae	246167	S	1	0	1	0.00000
SRR6145058	Vibrio breoganii	553239	S	1	0	1	0.00000
SRR6145058	Tsukamurella virus TIN2	1982570	S	2	1	3	0.00000
SRR6145058	Thiomicrospira aerophila	92245	S	1	0	1	0.00000
SRR6145058	Thiomicrorhabdus sp. AkT22	2675053	S	13	1	14	0.00000
SRR6145058	Thiomicrorhabdus indica	2267253	S	1	0	1	0.00000
SRR6145058	Thermovibrio ammonificans	228745	S	1	0	1	0.00000
SRR6145058	Thermosphaera aggregans	54254	S	1	0	1	0.00000
SRR6145058	Thermoproteus tenax	2271	S	1	0	1	0.00000
SRR6145058	Thermoplasma volcanium	50339	S	1	0	1	0.00000
SRR6145058	Thermoplasma acidophilum	2303	S	1	0	1	0.00000
SRR6145058	Thermoleptolyngbya sp. PKUAC-SCTA183	2737172	S	4	1	5	0.00000
SRR6145058	Thermofilum adornatum	1365176	S	1	0	1	0.00000
SRR6145058	Thermodesulfovibrio yellowstonii	28262	S	1	0	1	0.00000
SRR6145058	Thermodesulfobium acidiphilum	1794699	S	1	0	1	0.00000
SRR6145058	Thermodesulfobacterium commune	1741	S	1	0	1	0.00000
SRR6145058	Thermocrinis minervae	381751	S	1	0	1	0.00000
SRR6145058	Thermococcus sp. 4557	1042877	S	2	1	3	0.00000
SRR6145058	Thermococcus piezophilus	1712654	S	1	0	1	0.00000
SRR6145058	Thermococcus kodakarensis	311400	S	1	0	1	0.00000
SRR6145058	Thermococcus gorgonarius	71997	S	1	0	1	0.00000
SRR6145058	Thermococcus gammatolerans	187878	S	1	0	1	0.00000
SRR6145058	Thermococcus barossii	54077	S	1	0	1	0.00000
SRR6145058	Thermococcus barophilus	55802	S	1	0	1	0.00000
SRR6145058	Thermoanaerobacterium xylanolyticum	29329	S	1	0	1	0.00000
SRR6145058	Thermanaerovibrio velox	108007	S	1	0	1	0.00000
SRR6145058	Thermanaeromonas toyohensis	161154	S	1	0	1	0.00000
SRR6145058	Thermaerobacter sp. PB12/4term	2293838	S	17	1	18	0.00000
SRR6145058	Tetragenococcus osmophilus	526944	S	1	0	1	0.00000
SRR6145058	Taylorella equigenitalis	29575	S	1	0	1	0.00000
SRR6145058	Synechococcus sp. WH 8109	166314	S	1	0	1	0.00000
SRR6145058	Synechococcus sp. WH 8103	29410	S	1	2	3	0.00000
SRR6145058	Synechococcus sp. WH 8102	84588	S	1	2	3	0.00000
SRR6145058	Synechococcus sp. WH 8101	59932	S	1	0	1	0.00000
SRR6145058	Synechococcus sp. WH 8020	32052	S	1	0	1	0.00000
SRR6145058	Synechococcus sp. PCC 73109	374982	S	1	1	2	0.00000
SRR6145058	Synechococcus sp. PCC 7003	374981	S	1	0	1	0.00000
SRR6145058	Synechococcus sp. PCC 7002	32049	S	1	1	2	0.00000
SRR6145058	Sulfurovum lithotrophicum	206403	S	1	0	1	0.00000
SRR6145058	Sulfurospirillum sp. JPD-1	220622	S	1	1	2	0.00000
SRR6145058	Sulfurospirillum barnesii	44674	S	1	0	1	0.00000
SRR6145058	Sulfolobus acidocaldarius	2285	S	1	0	1	0.00000
SRR6145058	Sulfitobacter sp. BSw21498	664426	S	11	1	12	0.00000
SRR6145058	Succinivibrio dextrinosolvens	83771	S	1	0	1	0.00000
SRR6145058	Stygiolobus azoricus	41675	S	1	0	1	0.00000
SRR6145058	Streptomyces sp. NHF165	2175864	S	67	1	68	0.00001
SRR6145058	Streptococcus sp. HSISB1	1316409	S	1	1	2	0.00000
SRR6145058	Streptococcus sp. CNU G2	2686210	S	1	2	3	0.00000
SRR6145058	Streptococcus phage SMP	413066	S	1	1	2	0.00000
SRR6145058	Stappia sp. ES.058	1881061	S	33	1	34	0.00000
SRR6145058	Staphylococcus virus BS2	2734047	S	1	1	2	0.00000
SRR6145058	Stanieria sp. NIES-3757	1807358	S	4	1	5	0.00000
SRR6145058	Sporosarcina ureilytica	298596	S	1	0	1	0.00000
SRR6145058	Sporosarcina sp. PTS2304	2283194	S	4	1	5	0.00000
SRR6145058	Spodoptera litura nucleopolyhedrovirus II	566270	S	1	0	1	0.00000
SRR6145058	Spiroplasma taiwanense	2145	S	1	0	1	0.00000
SRR6145058	Spiroplasma sabaudiense	216944	S	1	0	1	0.00000
SRR6145058	Spiroplasma poulsonii	2138	S	1	0	1	0.00000
SRR6145058	Spiroplasma phoeniceum	47835	S	1	0	1	0.00000
SRR6145058	Spiroplasma helicoides	216938	S	1	0	1	0.00000
SRR6145058	Spiroplasma diminutum	216936	S	1	0	1	0.00000
SRR6145058	Spiroplasma corruscae	216934	S	1	0	1	0.00000
SRR6145058	Spiroplasma chrysopicola	216933	S	1	0	1	0.00000
SRR6145058	Spiroplasma cantharicola	362837	S	1	0	1	0.00000
SRR6145058	Spiroplasma apis	2137	S	1	0	1	0.00000
SRR6145058	Spiroplasma alleghenense	216931	S	1	0	1	0.00000
SRR6145058	Sphingosinicella sp. BN140058	1892855	S	90	1	91	0.00001
SRR6145058	Sphingorhabdus sp. M41	1806885	S	20	1	21	0.00000
SRR6145058	Sphaerochaeta globosa	1131703	S	1	0	1	0.00000
SRR6145058	Sinimarinibacterium sp. NLF-5-8	2698684	S	9	1	10	0.00000
SRR6145058	Simkania negevensis	83561	S	1	0	1	0.00000
SRR6145058	Siansivirga zeaxanthinifaciens	762954	S	1	0	1	0.00000
SRR6145058	Shewanella violacea	60217	S	1	0	1	0.00000
SRR6145058	Shewanella decolorationis	256839	S	1	0	1	0.00000
SRR6145058	Shewanella chilikensis	558541	S	1	0	1	0.00000
SRR6145058	Shewanella benthica	43661	S	1	0	1	0.00000
SRR6145058	Serratia sp. KUDC3025	2597702	S	4	1	5	0.00000
SRR6145058	Serratia quinivorans	137545	S	1	0	1	0.00000
SRR6145058	Sanguibacter sp. HDW7	2714931	S	60	1	61	0.00001
SRR6145058	Salinivibrio sp. YCSC6	2003370	S	1	1	2	0.00000
SRR6145058	Saccharopolyspora sp. E2A	2665642	S	42	1	43	0.00000
SRR6145058	Ruminococcaceae bacterium CPB6	1572656	S	1	1	2	0.00000
SRR6145058	Ruegeria sp. AD91A	2293862	S	11	1	12	0.00000
SRR6145058	Rickettsia prowazekii	782	S	1	0	1	0.00000
SRR6145058	Rhopapillomavirus 1	1176146	S	1	0	1	0.00000
SRR6145058	Rhodococcus sp. WMMA185	679318	S	46	1	47	0.00001
SRR6145058	Rhodococcus sp. P1Y	1302308	S	69	1	70	0.00001
SRR6145058	Rhodobiaceae bacterium	2026785	S	1	0	1	0.00000
SRR6145058	Rhizobium sp. NXC24	2048897	S	27	1	28	0.00000
SRR6145058	Rhizobium sp. 11515TR	2028343	S	23	1	24	0.00000
SRR6145058	Rheinheimera sp. LHK132	2498451	S	101	1	102	0.00001
SRR6145058	Raccoonpox virus	10256	S	1	0	1	0.00000
SRR6145058	Pyrococcus horikoshii	53953	S	1	0	1	0.00000
SRR6145058	Pyrococcus abyssi	29292	S	1	0	1	0.00000
SRR6145058	Pteropox virus	1873698	S	1	0	1	0.00000
SRR6145058	Psychroserpens sp. NJDZ02	2570561	S	6	1	7	0.00000
SRR6145058	Psychrobacillus sp. AK 1817	2303505	S	1	0	1	0.00000
SRR6145058	Pseudothermotoga thermarum	119394	S	1	0	1	0.00000
SRR6145058	Pseudothermotoga elfii	38322	S	1	0	1	0.00000
SRR6145058	Pseudomonas sp. Z003-0.4C(8344-21)	1855380	S	4	1	5	0.00000
SRR6145058	Pseudomonas sp. StFLB209	1028989	S	28	1	29	0.00000
SRR6145058	Pseudomonas sp. S34	1573718	S	10	1	11	0.00000
SRR6145058	Pseudomonas sp. S1-A32-2	2731681	S	45	1	46	0.00001
SRR6145058	Pseudomonas sp. R84	1573712	S	9	1	10	0.00000
SRR6145058	Pseudomonas sp. R32	1573704	S	17	1	18	0.00000
SRR6145058	Pseudomonas sp. PE08	2604832	S	25	1	26	0.00000
SRR6145058	Pseudomonas sp. LG1E9	2219057	S	10	1	11	0.00000
SRR6145058	Pseudomonas sp. LAB-08	143813	S	14	1	15	0.00000
SRR6145058	Pseudomonas sp. K2W31S-8	2320867	S	35	1	36	0.00000
SRR6145058	Pseudomonas sp. IB20	1702250	S	7	1	8	0.00000
SRR6145058	Pseudomonas sp. DTU12.3	2073078	S	13	1	14	0.00000
SRR6145058	Pseudomonas sp. B14-6	2738843	S	1	1	2	0.00000
SRR6145058	Pseudomonas sp. ADAK18	2730848	S	17	1	18	0.00000
SRR6145058	Pseudomonas sp. ADAK13	2730847	S	12	1	13	0.00000
SRR6145058	Pseudomonas sp. 31-12	2201356	S	9	1	10	0.00000
SRR6145058	Pseudomonas sp. 11K1	2505979	S	8	1	9	0.00000
SRR6145058	Pseudogulbenkiania sp. NH8B	748280	S	18	1	19	0.00000
SRR6145058	Pseudoalteromonas sp. 13-15	1761891	S	2	1	3	0.00000
SRR6145058	Pseudoalteromonas piratica	1348114	S	1	0	1	0.00000
SRR6145058	Pseudoalteromonas carrageenovora	227	S	1	0	1	0.00000
SRR6145058	Pseudactinotalea sp. HY158	2654547	S	73	1	74	0.00001
SRR6145058	Providencia sneebia	516075	S	1	0	1	0.00000
SRR6145058	Proteus cibarius	626774	S	1	0	1	0.00000
SRR6145058	Prosthecochloris sp. CIB 2401	1868325	S	1	0	1	0.00000
SRR6145058	Polynucleobacter duraquae	1835254	S	1	0	1	0.00000
SRR6145058	Polaribacter sp. KT 15	1896175	S	1	1	2	0.00000
SRR6145058	Planctomycetes bacterium V202	2527965	S	3	1	4	0.00000
SRR6145058	Planctomycetes bacterium Poly24	2528017	S	5	1	6	0.00000
SRR6145058	Pigeonpox virus	10264	S	1	0	1	0.00000
SRR6145058	Picrophilus torridus	82076	S	1	0	1	0.00000
SRR6145058	Phoenicibacter congonensis	1944646	S	1	0	1	0.00000
SRR6145058	Phenylobacterium sp. HYN0004	2201350	S	52	1	53	0.00001
SRR6145058	Petrocella atlantisensis	2173034	S	1	0	1	0.00000
SRR6145058	Pepper chlorotic spot virus	1414655	S	1	0	1	0.00000
SRR6145058	Pelargonium zonate spot virus	116056	S	1	0	1	0.00000
SRR6145058	Pediococcus damnosus	51663	S	1	0	1	0.00000
SRR6145058	Pectobacterium atrosepticum	29471	S	1	0	1	0.00000
SRR6145058	Parashewanella tropica	2547970	S	1	0	1	0.00000
SRR6145058	Parashewanella spongiae	342950	S	1	0	1	0.00000
SRR6145058	Parasaccharibacter apium	1510841	S	1	0	1	0.00000
SRR6145058	Parageobacillus toebii	153151	S	1	0	1	0.00000
SRR6145058	Paraburkholderia sp. DHF22	2571748	S	33	1	34	0.00000
SRR6145058	Paraburkholderia sp. CCGE1002	640511	S	25	1	26	0.00000
SRR6145058	Pandoravirus inopinatum	1605721	S	1	0	1	0.00000
SRR6145058	Pajaroellobacter abortibovis	1882918	S	1	0	1	0.00000
SRR6145058	Paenibacillus sp. FSL H7-0737	1536775	S	1	0	1	0.00000
SRR6145058	Paenibacillus psychroresistens	1778678	S	1	0	1	0.00000
SRR6145058	Paenibacillus kribbensis	172713	S	1	0	1	0.00000
SRR6145058	Paenalcaligenes hominis	643674	S	1	0	1	0.00000
SRR6145058	Ostreococcus lucimarinus virus OlV5	754064	S	1	0	1	0.00000
SRR6145058	Oenococcus kitaharae	336988	S	1	0	1	0.00000
SRR6145058	Noviherbaspirillum sp. UKPF54	2601898	S	29	1	30	0.00000
SRR6145058	Nostocales cyanobacterium HT-58-2	1940762	S	19	1	20	0.00000
SRR6145058	Nostoc sp. NIES-4103	2005458	S	16	1	17	0.00000
SRR6145058	Nitrosopumilus maritimus	338192	S	1	0	1	0.00000
SRR6145058	Nitrosococcus watsonii	473531	S	1	0	1	0.00000
SRR6145058	Neokomagataea tanensis	661191	S	1	0	1	0.00000
SRR6145058	Natrinema sp. J7-2	406552	S	5	1	6	0.00000
SRR6145058	Myroides profundi	480520	S	1	0	1	0.00000
SRR6145058	Mycoplasma synoviae	2109	S	1	0	1	0.00000
SRR6145058	Mycoplasma struthionis	538220	S	1	0	1	0.00000
SRR6145058	Mycoplasma sp. Phocoena C-264-GEN	754517	S	1	0	1	0.00000
SRR6145058	Mycoplasma phocirhinis	142650	S	1	0	1	0.00000
SRR6145058	Mycoplasma phocicerebrale	142649	S	1	0	1	0.00000
SRR6145058	Mycoplasma ovipneumoniae	29562	S	1	0	1	0.00000
SRR6145058	Mycoplasma orale	2121	S	1	0	1	0.00000
SRR6145058	Mycoplasma meleagridis	29561	S	1	0	1	0.00000
SRR6145058	Mycoplasma hyorhinis	2100	S	1	0	1	0.00000
SRR6145058	Mycoplasma gallopavonis	76629	S	1	0	1	0.00000
SRR6145058	Mycoplasma gallisepticum	2096	S	1	0	1	0.00000
SRR6145058	Mycoplasma flocculare	2128	S	1	0	1	0.00000
SRR6145058	Mycoplasma felis	33923	S	1	0	1	0.00000
SRR6145058	Mycoplasma dispar	86660	S	1	0	1	0.00000
SRR6145058	Mycoplasma crocodyli	50052	S	1	0	1	0.00000
SRR6145058	Mycoplasma cloacale	92401	S	1	0	1	0.00000
SRR6145058	Mycoplasma capricolum	2095	S	1	0	1	0.00000
SRR6145058	Mycoplasma bovoculi	45362	S	1	0	1	0.00000
SRR6145058	Mycoplasma anseris	92400	S	1	0	1	0.00000
SRR6145058	Mycoplasma anatis	171279	S	1	0	1	0.00000
SRR6145058	Mycoplasma alkalescens	45363	S	1	0	1	0.00000
SRR6145058	Mycobacterium virus Halo	373407	S	1	1	2	0.00000
SRR6145058	Mycobacterium virus Brujita	561996	S	2	1	3	0.00000
SRR6145058	Mycobacterium virus Bignuz	1983736	S	1	1	2	0.00000
SRR6145058	Mycobacterium phage Tonenili	1891703	S	2	1	3	0.00000
SRR6145058	Mycobacterium phage KayaCho	1340830	S	1	1	2	0.00000
SRR6145058	Mycobacterium phage Cheetobro	1506716	S	1	1	2	0.00000
SRR6145058	Mycobacterium phage Brocalys	1815608	S	1	1	2	0.00000
SRR6145058	Musca hytrovirus	1285595	S	1	0	1	0.00000
SRR6145058	Muricauda lutaonensis	516051	S	1	0	1	0.00000
SRR6145058	Mupapillomavirus 1	334203	S	1	0	1	0.00000
SRR6145058	Mucilaginibacter sp. F39-2	2728022	S	15	1	16	0.00000
SRR6145058	Moritella marina	90736	S	1	0	1	0.00000
SRR6145058	Methyloversatilis sp. RAC08	1842540	S	37	1	38	0.00000
SRR6145058	Methyloligella sp. GL2	2742204	S	29	1	30	0.00000
SRR6145058	Methylobacillus flagellatus	405	S	1	0	1	0.00000
SRR6145058	Methylacidiphilum kamchatkense	431057	S	1	0	1	0.00000
SRR6145058	Methanothrix soehngenii	2223	S	1	0	1	0.00000
SRR6145058	Methanosarcina sp. WWM596	1434103	S	2	1	3	0.00000
SRR6145058	Methanosarcina horonobensis	418008	S	1	0	1	0.00000
SRR6145058	Methanosarcina acetivorans	2214	S	1	0	1	0.00000
SRR6145058	Methanosalsum zhilinae	39669	S	1	0	1	0.00000
SRR6145058	Methanosaeta harundinacea	301375	S	1	0	1	0.00000
SRR6145058	Methanoregula boonei	358766	S	1	0	1	0.00000
SRR6145058	Methanopyrus kandleri	2320	S	1	0	1	0.00000
SRR6145058	Methanomethylovorans hollandica	101192	S	1	0	1	0.00000
SRR6145058	Methanolinea tarda	263906	S	1	0	1	0.00000
SRR6145058	Methanolacinia petrolearia	54120	S	1	0	1	0.00000
SRR6145058	Methanohalophilus portucalensis	39664	S	1	0	1	0.00000
SRR6145058	Methanohalophilus halophilus	2177	S	1	0	1	0.00000
SRR6145058	Methanofollis liminatans	2201	S	1	0	1	0.00000
SRR6145058	Methanoculleus sp. MAB1	86622	S	1	1	2	0.00000
SRR6145058	Methanocella arvoryzae	1175445	S	1	0	1	0.00000
SRR6145058	Methanocaldococcus fervens	83171	S	1	0	1	0.00000
SRR6145058	Methanobacterium lacus	877455	S	1	0	1	0.00000
SRR6145058	Methanobacterium congolense	118062	S	1	0	1	0.00000
SRR6145058	Mesoplasma tabanidae	219745	S	1	0	1	0.00000
SRR6145058	Mesoplasma syrphidae	225999	S	1	0	1	0.00000
SRR6145058	Mesoplasma lactucae	138853	S	1	0	1	0.00000
SRR6145058	Mesoplasma florum	2151	S	1	0	1	0.00000
SRR6145058	Mesoplasma entomophilum	2149	S	1	0	1	0.00000
SRR6145058	Melissococcus plutonius	33970	S	1	0	1	0.00000
SRR6145058	Marinomonas mediterranea	119864	S	1	0	1	0.00000
SRR6145058	Marinobacter sp. JH2	2547598	S	18	1	19	0.00000
SRR6145058	Marinobacter sp. BSs20148	490759	S	3	1	4	0.00000
SRR6145058	Maribacter sp. 1_2014MBL_MicDiv	1644130	S	2	1	3	0.00000
SRR6145058	Maribacter cobaltidurans	1178778	S	1	0	1	0.00000
SRR6145058	Mannheimia sp. USDA-ARS-USMARC-1261	1432056	S	6	1	7	0.00000
SRR6145058	Maize bushy stunt phytoplasma	202462	S	1	1	2	0.00000
SRR6145058	Macrococcus sp. IME1552	1898474	S	22	1	23	0.00000
SRR6145058	Macaca mulatta papillomavirus 6	2364646	S	1	0	1	0.00000
SRR6145058	Lysobacter sp. HDW10	2714936	S	21	1	22	0.00000
SRR6145058	Litorilituus sediminis	718192	S	1	0	1	0.00000
SRR6145058	Limnohabitans sp. 63ED37-2	1678128	S	25	1	26	0.00000
SRR6145058	Limihaloglobus sulfuriphilus	1851148	S	1	0	1	0.00000
SRR6145058	Liberibacter crescens	1273132	S	1	0	1	0.00000
SRR6145058	Leucobacter sp. HDW9C	2714935	S	16	1	17	0.00000
SRR6145058	Leucobacter sp. HDW9A	2714933	S	14	1	15	0.00000
SRR6145058	Leptospira santarosai	28183	S	1	0	1	0.00000
SRR6145058	Leptolyngbya sp. O-77	1080068	S	8	1	9	0.00000
SRR6145058	Leminorella richardii	158841	S	1	0	1	0.00000
SRR6145058	Legionella lansingensis	45067	S	1	0	1	0.00000
SRR6145058	Leclercia sp. J807	2681307	S	1	1	2	0.00000
SRR6145058	Leclercia sp. 29361	2714951	S	8	1	9	0.00000
SRR6145058	Leclercia sp. 119287	2681308	S	1	1	2	0.00000
SRR6145058	Lactococcus virus bIL170	63118	S	2	1	3	0.00000
SRR6145058	Lactococcus virus P008	83129	S	1	1	2	0.00000
SRR6145058	Lactococcus virus ASCC191	1165134	S	1	1	2	0.00000
SRR6145058	Lactococcus virus 712	213769	S	1	1	2	0.00000
SRR6145058	Lactococcus phage jm3	1262536	S	1	1	2	0.00000
SRR6145058	Lactobacillus sanfranciscensis	1625	S	1	0	1	0.00000
SRR6145058	Lactobacillus paralimentarius	83526	S	1	0	1	0.00000
SRR6145058	Lactobacillus oligofermentans	293371	S	1	0	1	0.00000
SRR6145058	Lactobacillus mali	1618	S	1	0	1	0.00000
SRR6145058	Lactobacillus kullabergensis	1218493	S	1	0	1	0.00000
SRR6145058	Lactobacillus koreensis	637971	S	1	0	1	0.00000
SRR6145058	Lactobacillus hilgardii	1588	S	1	0	1	0.00000
SRR6145058	Lactobacillus heilongjiangensis	1074467	S	1	0	1	0.00000
SRR6145058	Lactobacillus gastricus	227942	S	1	0	1	0.00000
SRR6145058	Lactobacillus futsaii	938155	S	1	0	1	0.00000
SRR6145058	Lactobacillus fructivorans	1614	S	1	0	1	0.00000
SRR6145058	Lactobacillus farciminis	1612	S	1	0	1	0.00000
SRR6145058	Lactobacillus buchneri	1581	S	1	0	1	0.00000
SRR6145058	Lachnoclostridium sp. YL32	1834196	S	1	1	2	0.00000
SRR6145058	Kosmotoga pacifica	1330330	S	1	0	1	0.00000
SRR6145058	Klebsiella virus RaK2	2560545	S	1	1	2	0.00000
SRR6145058	Klebsiella phage KPN N137	2024238	S	1	0	1	0.00000
SRR6145058	Kangiella geojedonensis	914150	S	1	0	1	0.00000
SRR6145058	Kallithea virus	1654582	S	1	0	1	0.00000
SRR6145058	Hyphomicrobium sp. MC1	717785	S	22	1	23	0.00000
SRR6145058	Hyperthermus butylicus	54248	S	1	0	1	0.00000
SRR6145058	Hymenobacter sp. BRD67	2675877	S	5	1	6	0.00000
SRR6145058	Hymenobacter sp. BRD128	2675878	S	25	1	26	0.00000
SRR6145058	Hubei picorna-like virus 34	1923114	S	1	0	1	0.00000
SRR6145058	Hubei endorna-like virus 1	1922893	S	1	0	1	0.00000
SRR6145058	Helicobacter typhlonius	76936	S	1	0	1	0.00000
SRR6145058	Helicobacter suis	104628	S	1	0	1	0.00000
SRR6145058	Helicobacter sp. MIT 01-6242	222136	S	1	0	1	0.00000
SRR6145058	Helicobacter heilmannii	35817	S	1	0	1	0.00000
SRR6145058	Helicobacter apodemus	135569	S	1	0	1	0.00000
SRR6145058	Halothece sp. PCC 7418	65093	S	1	0	1	0.00000
SRR6145058	Halomonas sp. THAF5a	2587844	S	18	1	19	0.00000
SRR6145058	Halomonas sp. HG01	1609967	S	12	1	13	0.00000
SRR6145058	Halobacteriovorax sp. BALOs_7	2109558	S	9	1	10	0.00000
SRR6145058	Halobacillus mangrovi	402384	S	1	0	1	0.00000
SRR6145058	Haloarcula hispanica virus SH1	326574	S	1	0	1	0.00000
SRR6145058	Hahella sp. KA22	1628392	S	6	1	7	0.00000
SRR6145058	Gyrovirus 4	1214955	S	1	0	1	0.00000
SRR6145058	Gordonia virus Twister6	2170253	S	1	1	2	0.00000
SRR6145058	Gordonia virus Cozz	2560490	S	2	1	3	0.00000
SRR6145058	Georgenia sp. Z443	2589797	S	82	1	83	0.00001
SRR6145058	Geoglobus acetivorans	565033	S	1	0	1	0.00000
SRR6145058	Geobacter sp. M18	443143	S	12	1	13	0.00000
SRR6145058	Geobacillus sp. JS12	1813182	S	1	1	2	0.00000
SRR6145058	Geminocystis sp. NIES-3708	1615909	S	4	1	5	0.00000
SRR6145058	Gammapapillomavirus 7	1175849	S	1	0	1	0.00000
SRR6145058	Frankia sp. EAN1pec	298653	S	66	1	67	0.00001
SRR6145058	Francisella persica	954	S	1	0	1	0.00000
SRR6145058	Francisella noatunensis	657445	S	1	0	1	0.00000
SRR6145058	Flavobacterium sp. M31R6	2739062	S	14	1	15	0.00000
SRR6145058	Flavobacterium sp. 140616W15	2478552	S	13	1	14	0.00000
SRR6145058	Flavobacteriaceae bacterium 3519-10	531844	S	67	1	68	0.00001
SRR6145058	Fischerella sp. NIES-4106	2005456	S	9	1	10	0.00000
SRR6145058	Fervidobacterium nodosum	2424	S	1	0	1	0.00000
SRR6145058	Escherichia virus NC29	1945586	S	1	1	2	0.00000
SRR6145058	Entomoplasma somnilux	215578	S	1	0	1	0.00000
SRR6145058	Entomoplasma freundtii	74700	S	1	0	1	0.00000
SRR6145058	Enterococcus sp. CR-Ec1	2057791	S	1	1	2	0.00000
SRR6145058	Enterobacter sp. N18-03635	2500132	S	1	1	2	0.00000
SRR6145058	Elusimicrobium minutum	423605	S	1	0	1	0.00000
SRR6145058	Elephant endotheliotropic herpesvirus 4	548914	S	1	0	1	0.00000
SRR6145058	Ehrlichia ruminantium	779	S	1	0	1	0.00000
SRR6145058	Dyokappapapillomavirus 1	1513247	S	1	0	1	0.00000
SRR6145058	Dolichospermum sp. UHCC 0315A	1914871	S	1	6	7	0.00000
SRR6145058	Dokdonia donghaensis	326320	S	1	0	1	0.00000
SRR6145058	Dictyoglomus turgidum	513050	S	1	0	1	0.00000
SRR6145058	Dickeya sp. CSL RW240	1224144	S	1	1	2	0.00000
SRR6145058	Diaminobutyricimonas sp. LJ205	2683590	S	36	1	37	0.00000
SRR6145058	Desulfovibrio salexigens	880	S	1	0	1	0.00000
SRR6145058	Desulfohalobium retbaense	45663	S	1	0	1	0.00000
SRR6145058	Desulfitobacterium dehalogenans	36854	S	1	0	1	0.00000
SRR6145058	Delphinus delphis polyomavirus 1	1891756	S	1	0	1	0.00000
SRR6145058	Dehalobacterium formicoaceticum	51515	S	1	0	1	0.00000
SRR6145058	Cypovirus 1	205895	S	1	0	1	0.00000
SRR6145058	Cymbidium chlorotic mosaic virus	1602124	S	1	0	1	0.00000
SRR6145058	Cycloclasticus zancles	1329899	S	1	0	1	0.00000
SRR6145058	Cyanophage P-TIM40	1589733	S	1	0	1	0.00000
SRR6145058	Cyanophage P-RSM6	929832	S	1	0	1	0.00000
SRR6145058	Cyanobium sp. NIES-981	1851505	S	7	1	8	0.00000
SRR6145058	Cotia virus	39444	S	1	0	1	0.00000
SRR6145058	Coriobacterium glomerans	33871	S	1	0	1	0.00000
SRR6145058	Conexivisphaera calidus	1874277	S	1	0	1	0.00000
SRR6145058	Citrobacter sp. TSA-1	184912	S	1	1	2	0.00000
SRR6145058	Citrobacter sp. SNU WT2	2562449	S	1	0	1	0.00000
SRR6145058	Chryseobacterium sp. H3001	2487073	S	78	1	79	0.00001
SRR6145058	Chlorobium chlorochromatii	337090	S	1	0	1	0.00000
SRR6145058	Chlamydia suis	83559	S	1	0	1	0.00000
SRR6145058	Chlamydia muridarum	83560	S	1	0	1	0.00000
SRR6145058	Chlamydia felis	83556	S	1	0	1	0.00000
SRR6145058	Cellvibrio sp. PSBB023	1945512	S	30	1	31	0.00000
SRR6145058	Cellvibrio sp. KY-YJ-3	454662	S	31	1	32	0.00000
SRR6145058	Caulobacter virus CcrPW	2734195	S	1	1	2	0.00000
SRR6145058	Capnocytophaga sp. H2931	1945657	S	1	1	2	0.00000
SRR6145058	Candidatus Thioglobus sp. NP1	2508687	S	1	0	1	0.00000
SRR6145058	Candidatus Pelagibacter sp. HIMB1321	1388755	S	1	0	1	0.00000
SRR6145058	Candidatus Pelagibacter sp. FZCC0015	2268451	S	1	0	1	0.00000
SRR6145058	Candidatus Pelagibacter giovannonii	2563896	S	6	1	7	0.00000
SRR6145058	Candidatus Coxiella mudrowiae	2054173	S	3	1	4	0.00000
SRR6145058	Campylobacter sp. NCTC 13003	1660064	S	1	0	1	0.00000
SRR6145058	Campylobacter peloridis	488546	S	1	0	1	0.00000
SRR6145058	Campylobacter mucosalis	202	S	1	0	1	0.00000
SRR6145058	Campylobacter insulaenigrae	260714	S	1	0	1	0.00000
SRR6145058	Campylobacter hepaticus	1813019	S	1	0	1	0.00000
SRR6145058	Campylobacter cuniculorum	374106	S	1	0	1	0.00000
SRR6145058	Campylobacter corcagiensis	1448857	S	1	0	1	0.00000
SRR6145058	Campylobacter canadensis	449520	S	1	0	1	0.00000
SRR6145058	Calothrix sp. NIES-3974	2005462	S	7	1	8	0.00000
SRR6145058	Caldivirga maquilingensis	76887	S	1	0	1	0.00000
SRR6145058	Caldicellulosiruptor saccharolyticus	44001	S	1	0	1	0.00000
SRR6145058	Caldicellulosiruptor changbaiensis	1222016	S	1	0	1	0.00000
SRR6145058	Burkholderia sp. THE68	758782	S	34	1	35	0.00000
SRR6145058	Burkholderia sp. PAMC 28687	1795874	S	1	1	2	0.00000
SRR6145058	Burkholderia sp. CCGE1003	640512	S	22	1	23	0.00000
SRR6145058	Burkholderia sp. Bp7605	1740163	S	20	1	21	0.00000
SRR6145058	Burkholderia sp. BDU8	1385592	S	7	1	8	0.00000
SRR6145058	Burkholderia sp. BDU6	1385591	S	9	1	10	0.00000
SRR6145058	Brucella sp. 10RB9215	1149953	S	3	1	4	0.00000
SRR6145058	Brucella sp. 09RB8471	1149952	S	2	1	3	0.00000
SRR6145058	Brachyspira hampsonii	1287055	S	1	0	1	0.00000
SRR6145058	Bovine papular stomatitis virus	129727	S	1	0	1	0.00000
SRR6145058	Borreliella bissettii	64897	S	1	0	1	0.00000
SRR6145058	Borreliella afzelii	29518	S	1	0	1	0.00000
SRR6145058	Borrelia mayonii	1674146	S	1	0	1	0.00000
SRR6145058	Borrelia hermsii	140	S	1	0	1	0.00000
SRR6145058	Borrelia coriaceae	144	S	1	0	1	0.00000
SRR6145058	Bordetella sp. N	1746199	S	30	1	31	0.00000
SRR6145058	Bordetella sp. H567	1697043	S	28	1	29	0.00000
SRR6145058	Bordetella genomosp. 8	1416806	S	29	1	30	0.00000
SRR6145058	Blattabacterium sp. (Cryptocercus kyebangensis)	298656	S	1	0	1	0.00000
SRR6145058	Blattabacterium sp. (Blatta orientalis)	367806	S	1	0	1	0.00000
SRR6145058	Blattabacterium sp. (Blaberus giganteus)	1186051	S	1	0	1	0.00000
SRR6145058	Bifidobacterium coryneforme	1687	S	1	0	1	0.00000
SRR6145058	Betaproteobacteria bacterium GR16-43	1904640	S	32	1	33	0.00000
SRR6145058	Bermanella marisrubri	207949	S	1	0	1	0.00000
SRR6145058	Bdellovibrio sp. NC01	2220073	S	6	1	7	0.00000
SRR6145058	Bartonella bovis	155194	S	1	0	1	0.00000
SRR6145058	Bartonella birtlesii	111504	S	1	0	1	0.00000
SRR6145058	Bartonella ancashensis	1318743	S	1	0	1	0.00000
SRR6145058	Bacillus xiamenensis	1178537	S	1	0	1	0.00000
SRR6145058	Bacillus thermocopriae	1215031	S	1	0	1	0.00000
SRR6145058	Bacillus tequilensis	227866	S	1	0	1	0.00000
SRR6145058	Bacillus mojavensis	72360	S	1	0	1	0.00000
SRR6145058	Bacillus beveridgei	632773	S	1	0	1	0.00000
SRR6145058	Azoarcus sp. SY39	2067960	S	20	1	21	0.00000
SRR6145058	Avian endogenous retrovirus EAV-HP	93465	S	1	0	1	0.00000
SRR6145058	Aster yellows witches'-broom phytoplasma	229545	S	1	0	1	0.00000
SRR6145058	Arthrobacter sp. YN	2020486	S	34	1	35	0.00000
SRR6145058	Arthrobacter sp. PGP41	2079227	S	34	1	35	0.00000
SRR6145058	Arthrobacter sp. ERGS1:01	1704044	S	56	1	57	0.00001
SRR6145058	Armatimonadetes bacterium Uphvl-Ar2	2004468	S	9	1	10	0.00000
SRR6145058	Arcobacter lanthieri	1355374	S	1	0	1	0.00000
SRR6145058	Archaeoglobus veneficus	58290	S	1	0	1	0.00000
SRR6145058	Archaeoglobus fulgidus	2234	S	1	0	1	0.00000
SRR6145058	Aquitalea sp. THG-DN7.12	1537400	S	12	1	13	0.00000
SRR6145058	Alteromonas pelagimontana	1858656	S	1	0	1	0.00000
SRR6145058	Altererythrobacter sp. BO-6	2604537	S	24	1	25	0.00000
SRR6145058	Allofrancisella frigidaquae	1085644	S	1	0	1	0.00000
SRR6145058	Alkaliphilus oremlandii	461876	S	1	0	1	0.00000
SRR6145058	Algibacter sp. L1A34	2686365	S	5	1	6	0.00000
SRR6145058	Aeropyrum pernix	56636	S	1	0	1	0.00000
SRR6145058	Aeromicrobium sp. A1-2	2107713	S	37	1	38	0.00000
SRR6145058	Adlercreutzia sp. 8CFCBH1	2707299	S	2	1	3	0.00000
SRR6145058	Actinobacteria bacterium IMCC19121	1848754	S	6	1	7	0.00000
SRR6145058	Acinetobacter sp. dk386	2662362	S	26	1	27	0.00000
SRR6145058	Acinetobacter sp. WCHAc010052	2004647	S	5	1	6	0.00000
SRR6145058	Acinetobacter sp. TTH0-4	1646498	S	27	1	28	0.00000
SRR6145058	Acholeplasma oculi	35623	S	1	0	1	0.00000
SRR6145058	Acholeplasma laidlawii	2148	S	1	0	1	0.00000
SRR6145058	secondary endosymbiont of Ctenarytaina eucalypti	1199245	S	2	0	2	0.00000
SRR6145058	methanogenic archaeon ISO4-H5	1495144	S	2	0	2	0.00000
SRR6145058	gamma proteobacterium SS-5	947516	S	14	0	14	0.00000
SRR6145058	gamma proteobacterium HdN1	83406	S	1	0	1	0.00000
SRR6145058	endosymbiont of unidentified scaly snail isolate Monju	1248727	S	18	0	18	0.00000
SRR6145058	endosymbiont of Acanthamoeba sp. UWC8	86106	S	4	0	4	0.00000
SRR6145058	endosymbiont 'TC1' of Trimyema compressum	243899	S	2	0	2	0.00000
SRR6145058	cyanobacterium endosymbiont of Rhopalodia gibberula	1763363	S	4	0	4	0.00000
SRR6145058	cyanobacterium endosymbiont of Epithemia turgida	718217	S	5	0	5	0.00000
SRR6145058	blood disease bacterium A2-HR MARDI	1944648	S	2	4	6	0.00000
SRR6145058	alpha proteobacterium HIMB59	744985	S	1	0	1	0.00000
SRR6145058	alpha proteobacterium HIMB5	859653	S	5	0	5	0.00000
SRR6145058	Yersinia virus Yen9-04	2560849	S	1	0	1	0.00000
SRR6145058	Xylella virus Salvo	2560847	S	5	0	5	0.00000
SRR6145058	Xylella virus Prado	1985736	S	1	0	1	0.00000
SRR6145058	Xanthomonas virus f30	1985735	S	1	0	1	0.00000
SRR6145058	Xanthomonas virus Xc10	2733952	S	2	0	2	0.00000
SRR6145058	Wolbachia endosymbiont of Folsomia candida	169402	S	3	1	4	0.00000
SRR6145058	Wolbachia endosymbiont of Ctenocephalides felis	212123	S	3	3	6	0.00000
SRR6145058	Wolbachia endosymbiont of Cimex lectularius	246273	S	2	3	5	0.00000
SRR6145058	Winogradskyella sp. RHA_55	1249933	S	6	0	6	0.00000
SRR6145058	Winogradskyella sp. PG-2	754409	S	6	0	6	0.00000
SRR6145058	Winogradskyella sp. PC-19	754417	S	3	0	3	0.00000
SRR6145058	Winogradskyella sp. J14-2	1936080	S	3	0	3	0.00000
SRR6145058	Weissella sp. HDW19	2714949	S	3	0	3	0.00000
SRR6145058	Vitreoscilla sp. C1	96942	S	13	0	13	0.00000
SRR6145058	Virgibacillus sp. MSP4-1	2700081	S	3	0	3	0.00000
SRR6145058	Virgibacillus sp. Bac332	2419842	S	5	0	5	0.00000
SRR6145058	Virgibacillus sp. Bac330	2419841	S	1	0	1	0.00000
SRR6145058	Virgibacillus sp. 6R	1911587	S	4	0	4	0.00000
SRR6145058	Vibrio sp. ZWAL4003	2711221	S	3	0	3	0.00000
SRR6145058	Vibrio sp. THAF190c	2587865	S	1	0	1	0.00000
SRR6145058	Vibrio sp. THAF100	2587862	S	1	0	1	0.00000
SRR6145058	Vibrio sp. SM1977	2662262	S	2	0	2	0.00000
SRR6145058	Vibrio sp. HBUAS61001	2479546	S	10	0	10	0.00000
SRR6145058	Vibrio phage VAP7	2584487	S	1	0	1	0.00000
SRR6145058	Verrucomicrobium sp. GAS474	1882831	S	17	0	17	0.00000
SRR6145058	Verrucomicrobia bacterium S94	2488809	S	3	0	3	0.00000
SRR6145058	Verrucomicrobia bacterium IMCC26134	1637999	S	13	0	13	0.00000
SRR6145058	Vampirococcus sp. LiM	1930593	S	1	0	1	0.00000
SRR6145058	Vagococcus sp. HDW17B	2714947	S	7	0	7	0.00000
SRR6145058	Vagococcus sp. HDW17A	2714946	S	11	0	11	0.00000
SRR6145058	Vagococcus sp. CF-49	2562451	S	1	0	1	0.00000
SRR6145058	Undibacterium sp. YM2	2058625	S	1	0	1	0.00000
SRR6145058	Turicibacter sp. H121	1712675	S	6	0	6	0.00000
SRR6145058	Tunisvirus	1255301	S	1	0	1	0.00000
SRR6145058	Tsukamurella phage TPA4	1647476	S	9	0	9	0.00000
SRR6145058	Tropheryma whipplei	2039	S	3	-3	0	0.00000
SRR6145058	Tissierellia sp. JN-28	2507161	S	7	0	7	0.00000
SRR6145058	Thysanoplusia orichalcea nucleopolyhedrovirus	101850	S	1	0	1	0.00000
SRR6145058	Thiomicrorhabdus sp. aks77	2675054	S	2	0	2	0.00000
SRR6145058	Thiomicrorhabdus sp. G2	2739063	S	1	0	1	0.00000
SRR6145058	Thiomicrorhabdus sp. G1	2580412	S	7	0	7	0.00000
SRR6145058	Thioalkalivibrio sp. K90mix	396595	S	9	0	9	0.00000
SRR6145058	Thermus sp. CCB_US3_UF1	1111069	S	3	0	3	0.00000
SRR6145058	Thermosynechococcus sp. CL-1	2583530	S	2	0	2	0.00000
SRR6145058	Thermoplasmatales archaeon BRNA1	1054217	S	3	0	3	0.00000
SRR6145058	Thermococcus sp. SY113	2598455	S	1	0	1	0.00000
SRR6145058	Thermococcus sp. P6	122420	S	2	0	2	0.00000
SRR6145058	Thermococcus sp. IOH1	2586643	S	1	0	1	0.00000
SRR6145058	Thermoanaerobacterium sp. RBIITD	1550240	S	10	0	10	0.00000
SRR6145058	Thermoanaerobacterales bacterium SK-G1	2316383	S	2	0	2	0.00000
SRR6145058	Thermaerobacter sp. FW80	2546351	S	16	0	16	0.00000
SRR6145058	Thalassotalea sp. PS06	2594005	S	3	0	3	0.00000
SRR6145058	Thalassococcus sp. S3	2017482	S	19	0	19	0.00000
SRR6145058	Terasakiella sp. SH-1	2560057	S	3	0	3	0.00000
SRR6145058	Tenericutes bacterium MO-XQ	1911684	S	1	0	1	0.00000
SRR6145058	Tenacibaculum sp. SZ-18	754423	S	6	0	6	0.00000
SRR6145058	Tatumella sp. TA1	2487345	S	7	0	7	0.00000
SRR6145058	Tannerella sp. oral taxon HOT-286	712710	S	515	1	516	0.00006
SRR6145058	Tamlana sp. UJ94	2069432	S	7	0	7	0.00000
SRR6145058	Synechococcus sp. SynAce01	1916956	S	11	0	11	0.00000
SRR6145058	Synechococcus sp. RSCCF101	2511069	S	7	0	7	0.00000
SRR6145058	Synechococcus sp. RCC307	316278	S	5	0	5	0.00000
SRR6145058	Synechococcus sp. NIES-970	1827144	S	2	0	2	0.00000
SRR6145058	Synechococcus sp. KORDI-52	585425	S	1	0	1	0.00000
SRR6145058	Synechococcus sp. KORDI-49	585423	S	7	0	7	0.00000
SRR6145058	Synechococcus sp. KORDI-100	1280380	S	2	0	2	0.00000
SRR6145058	Synechococcus sp. JA-3-3Ab	321327	S	5	0	5	0.00000
SRR6145058	Synechococcus sp. JA-2-3B'a(2-13)	321332	S	4	0	4	0.00000
SRR6145058	Synechococcus sp. CC9902	316279	S	1	0	1	0.00000
SRR6145058	Synechococcus sp. CC9605	110662	S	11	0	11	0.00000
SRR6145058	Synechococcus sp. CB0101	232348	S	6	0	6	0.00000
SRR6145058	Synechococcus phage S-WAM2	1815522	S	4	0	4	0.00000
SRR6145058	Synechococcus phage S-RSM4	555387	S	2	0	2	0.00000
SRR6145058	Synechococcus phage S-PM2	238854	S	1	0	1	0.00000
SRR6145058	Swingsia sp. F3b2	2558361	S	2	0	2	0.00000
SRR6145058	Sulfurovum sp. NBC37-1	387093	S	1	0	1	0.00000
SRR6145058	Sulfurospirillum sp. UCH001	1581011	S	2	0	2	0.00000
SRR6145058	Sulfurimonas sp. NW10	2509341	S	1	0	1	0.00000
SRR6145058	Sulfurimonas sp. GYSZ_1	2590022	S	1	0	1	0.00000
SRR6145058	Sulfurihydrogenibium sp. YO3AOP1	436114	S	2	0	2	0.00000
SRR6145058	Sulfuriferula sp. AH1	1985873	S	6	0	6	0.00000
SRR6145058	Sulfolobus sp. S-194	2512240	S	1	0	1	0.00000
SRR6145058	Sulfolobus sp. E11-6	2663020	S	1	0	1	0.00000
SRR6145058	Sulfolobus sp. A20	1891280	S	1	0	1	0.00000
SRR6145058	Sulfitobacter sp. SK012	1389005	S	10	0	10	0.00000
SRR6145058	Sulfitobacter sp. SK011	1389004	S	5	0	5	0.00000
SRR6145058	Sulfitobacter sp. JL08	2070369	S	12	0	12	0.00000
SRR6145058	Sugarcane bacilliform Guadeloupe A virus	1960252	S	1	0	1	0.00000
SRR6145058	Streptomyces virus phiBT1	225588	S	1	0	1	0.00000
SRR6145058	Streptomyces virus TG1	374422	S	1	0	1	0.00000
SRR6145058	Streptomyces virus Scap1	2560792	S	1	0	1	0.00000
SRR6145058	Streptomyces virus Picard	2734264	S	1	0	1	0.00000
SRR6145058	Streptomyces virus Mildred21	2560787	S	1	0	1	0.00000
SRR6145058	Streptomyces phage VWB	10702	S	1	0	1	0.00000
SRR6145058	Streptomyces phage SV1	1204525	S	1	0	1	0.00000
SRR6145058	Streptomyces phage SF3	1690818	S	1	0	1	0.00000
SRR6145058	Streptomyces lividans	1916	S	1	-1	0	0.00000
SRR6145058	Streptococcus virus Cp7	1982585	S	2	0	2	0.00000
SRR6145058	Streptococcus virus Cp1	1982584	S	2	0	2	0.00000
SRR6145058	Streptococcus virus 7201	112023	S	1	0	1	0.00000
SRR6145058	Streptococcus sp. oral taxon 431	712633	S	1132	89	1221	0.00013
SRR6145058	Streptococcus sp. oral taxon 064	712624	S	453	632	1085	0.00012
SRR6145058	Streptococcus sp. Z15	2173853	S	10	0	10	0.00000
SRR6145058	Streptococcus phage YMC-2011	1051631	S	3	0	3	0.00000
SRR6145058	Streptococcus phage Str-PAP-1	1589270	S	1	0	1	0.00000
SRR6145058	Streptococcus phage PH15	537874	S	8	0	8	0.00000
SRR6145058	Streptococcus phage M102AD	1587907	S	1	0	1	0.00000
SRR6145058	Streptococcus constellatus	76860	S	31	-31	0	0.00000
SRR6145058	Strepomyces virus Drgrey	2560783	S	2	0	2	0.00000
SRR6145058	Staphylococcus virus Twort	55510	S	1	0	1	0.00000
SRR6145058	Staphylococcus virus SA12	1924730	S	2	0	2	0.00000
SRR6145058	Staphylococcus virus S25-4	1980964	S	1	0	1	0.00000
SRR6145058	Staphylococcus virus Rodi	1980962	S	2	0	2	0.00000
SRR6145058	Staphylococcus virus P108	1924731	S	1	0	1	0.00000
SRR6145058	Staphylococcus virus MCE2014	1924733	S	1	0	1	0.00000
SRR6145058	Staphylococcus virus Andhra	2732591	S	4	0	4	0.00000
SRR6145058	Staphylococcus phage vB_SscM-1	1868844	S	2	0	2	0.00000
SRR6145058	Spongiibacter sp. IMCC21906	1620392	S	9	0	9	0.00000
SRR6145058	Spodoptera littoralis nucleopolyhedrovirus	10456	S	1	0	1	0.00000
SRR6145058	Spirosoma sp. TS118	2735870	S	11	0	11	0.00000
SRR6145058	Spirosoma sp. CJU-R4	2728024	S	20	0	20	0.00000
SRR6145058	Spiroplasma sp. TIUS-1	216963	S	1	0	1	0.00000
SRR6145058	Spiroplasma sp. BIUS-1	216964	S	4	0	4	0.00000
SRR6145058	Spiribacter sp. 2438	2666185	S	6	0	6	0.00000
SRR6145058	Sphingorhabdus sp. JK6	2725558	S	11	0	11	0.00000
SRR6145058	Sphingorhabdus sp. IMCC1753	2509719	S	24	0	24	0.00000
SRR6145058	Sphingopyxis sp. LPB0140	1913578	S	6	0	6	0.00000
SRR6145058	Sphingomonas virus Scott	2733954	S	1	0	1	0.00000
SRR6145058	Sphingomonas sp. YZ-8	2319844	S	22	0	22	0.00000
SRR6145058	Sphingomonas sp. HDW15C	2714944	S	37	0	37	0.00000
SRR6145058	Sphingomonas sp. HDW15B	2714943	S	47	0	47	0.00001
SRR6145058	Sphingomonas sp. HDW15A	2714942	S	38	0	38	0.00000
SRR6145058	Sphingomonas sp. CSW-10	2698828	S	29	0	29	0.00000
SRR6145058	Sphingomonas sp. AE3	2594473	S	38	0	38	0.00000
SRR6145058	Sphingomonas phage PAU	1150991	S	1	0	1	0.00000
SRR6145058	Sphingobium sp. SCG-1	2072936	S	47	0	47	0.00001
SRR6145058	Sphingobacterium sp. dk4302	2662364	S	13	0	13	0.00000
SRR6145058	Sphingobacterium sp. ML3W	1538644	S	19	0	19	0.00000
SRR6145058	Sphingobacteriaceae bacterium GW460-11-11-14-LB5	1986952	S	11	0	11	0.00000
SRR6145058	Solibacillus sp. R5-41	2048654	S	3	0	3	0.00000
SRR6145058	Silvanigrellales bacterium RF1110005	2493639	S	2	0	2	0.00000
SRR6145058	Shewanella sp. WE21	2029986	S	6	0	6	0.00000
SRR6145058	Shewanella sp. Pdp11	2059264	S	1	0	1	0.00000
SRR6145058	Shewanella sp. M2	2487742	S	3	0	3	0.00000
SRR6145058	Shewanella sp. Arc9-LZ	2698686	S	6	0	6	0.00000
SRR6145058	Serratia sp. 3ACOL1	2448483	S	1	0	1	0.00000
SRR6145058	Seonamhaeicola sp. S2-3	1936081	S	3	0	3	0.00000
SRR6145058	Selenomonas sp. oral taxon 920	1884263	S	90	1	91	0.00001
SRR6145058	Selenomonas sp. oral taxon 478	712538	S	34	16	50	0.00001
SRR6145058	Selenomonas sp. oral taxon 136	713030	S	47	21	68	0.00001
SRR6145058	Selenomonas sp. oral taxon 126	712528	S	122	2	124	0.00001
SRR6145058	Salmonella virus SKML39	2169690	S	2	0	2	0.00000
SRR6145058	Salmonella virus BPS17W1	2560725	S	1	0	1	0.00000
SRR6145058	Salinisphaera sp. LB1	2183911	S	17	0	17	0.00000
SRR6145058	Salinimonas sp. KX18D6	2572577	S	3	0	3	0.00000
SRR6145058	Salinibacterium sp. UTAS2018	2508880	S	33	0	33	0.00000
SRR6145058	Salinarchaeum sp. Harcht-Bsk1	1333523	S	8	0	8	0.00000
SRR6145058	Salegentibacter sp. T436	1729720	S	4	0	4	0.00000
SRR6145058	Salarchaeum sp. JOR-1	2599399	S	8	0	8	0.00000
SRR6145058	Runella sp. SP2	2268026	S	14	0	14	0.00000
SRR6145058	Runella sp. HYN0085	2259595	S	12	0	12	0.00000
SRR6145058	Ruminococcus sp. JE7A12	2564099	S	5	0	5	0.00000
SRR6145058	Ruania sp. HY168	2603206	S	52	0	52	0.00001
SRR6145058	Roseovarius sp. MME-070	2494550	S	29	0	29	0.00000
SRR6145058	Roseimicrobium sp. ORNL1	2711231	S	17	0	17	0.00000
SRR6145058	Roseiflexus sp. RS-1	357808	S	9	0	9	0.00000
SRR6145058	Romboutsia sp. CE17	2724150	S	9	0	9	0.00000
SRR6145058	Rickettsiales endosymbiont of Stachyamoeba lipophora	2486578	S	3	0	3	0.00000
SRR6145058	Rickettsiales bacterium Ac37b	1528098	S	6	0	6	0.00000
SRR6145058	Rickettsia massiliae	35791	S	1	-1	0	0.00000
SRR6145058	Rickettsia endosymbiont of Ixodes scapularis	444612	S	6	2	8	0.00000
SRR6145058	Rickettsia endosymbiont of Bemisia tabaci	337479	S	16	0	16	0.00000
SRR6145058	Rhodoferax sp. Gr-4	2527691	S	11	0	11	0.00000
SRR6145058	Rhodocytophaga sp. 172606-1	2704465	S	7	0	7	0.00000
SRR6145058	Rhodococcus virus Weasel	2560706	S	1	0	1	0.00000
SRR6145058	Rhodococcus virus Poco6	1982369	S	2	0	2	0.00000
SRR6145058	Rhodococcus phage ReqiPine5	691963	S	1	0	1	0.00000
SRR6145058	Rhodococcus phage REQ3	1109714	S	1	0	1	0.00000
SRR6145058	Rhodobacteraceae bacterium BAR1	2171755	S	12	0	12	0.00000
SRR6145058	Rhizobium virus P106B	2560703	S	1	0	1	0.00000
SRR6145058	Rheinheimera sp. D18	2545632	S	7	0	7	0.00000
SRR6145058	Ralstonia virus RSPI1	2733590	S	1	0	1	0.00000
SRR6145058	Ralstonia phage phiITL-1	1597967	S	1	0	1	0.00000
SRR6145058	Raineyella sp. CBA3103	2662261	S	76	0	76	0.00001
SRR6145058	Rahnella sp. ERMR1:05	1805933	S	15	0	15	0.00000
SRR6145058	Pyrococcus sp. ST04	1183377	S	1	0	1	0.00000
SRR6145058	Pyrococcus sp. NA2	342949	S	1	0	1	0.00000
SRR6145058	Pusillimonas sp. ye3	2028345	S	7	0	7	0.00000
SRR6145058	Pusillimonas sp. T7-7	1007105	S	12	0	12	0.00000
SRR6145058	Pusillimonas sp. DMV24BSW_D	2716226	S	3	0	3	0.00000
SRR6145058	Psychromonas sp. CNPT3	314282	S	3	0	3	0.00000
SRR6145058	Psychrobacter sp. P2G3	1699622	S	1	0	1	0.00000
SRR6145058	Psychrobacter sp. P11G3	1699623	S	16	0	16	0.00000
SRR6145058	Psychrobacter sp. P11F6	1699621	S	49	0	49	0.00001
SRR6145058	Psychrobacter sp. G	571800	S	9	0	9	0.00000
SRR6145058	Psychrobacter sp. FME2	86185	S	17	0	17	0.00000
SRR6145058	Psychrobacter sp. DAB_AL43B	1028416	S	13	0	13	0.00000
SRR6145058	Psychrobacter sp. AntiMn-1	1720344	S	28	0	28	0.00000
SRR6145058	Pseudovibrio sp. FO-BEG1	911045	S	3	0	3	0.00000
SRR6145058	Pseudorhodobacter sp. S12M18	2500533	S	21	0	21	0.00000
SRR6145058	Pseudomonas virus nickie	2560688	S	1	0	1	0.00000
SRR6145058	Pseudomonas virus PspYZU08	2733662	S	1	0	1	0.00000
SRR6145058	Pseudomonas virus PaMx74	1982358	S	1	0	1	0.00000
SRR6145058	Pseudomonas virus PaBG	2734089	S	2	0	2	0.00000
SRR6145058	Pseudomonas virus EL	1984787	S	1	0	1	0.00000
SRR6145058	Pseudomonas virus Ab18	1982096	S	2	0	2	0.00000
SRR6145058	Pseudomonas virus 22PfluR64PP	2733656	S	1	0	1	0.00000
SRR6145058	Pseudomonas syringae group genomosp. 3	251701	S	12	0	12	0.00000
SRR6145058	Pseudomonas sp. gcc21	2726989	S	6	0	6	0.00000
SRR6145058	Pseudomonas sp. UW4	1207075	S	5	0	5	0.00000
SRR6145058	Pseudomonas sp. TCU-HL1	1856685	S	17	0	17	0.00000
SRR6145058	Pseudomonas sp. S35	1573719	S	6	0	6	0.00000
SRR6145058	Pseudomonas sp. S-6-2	1931241	S	13	0	13	0.00000
SRR6145058	Pseudomonas sp. R5-89-07	658644	S	1	0	1	0.00000
SRR6145058	Pseudomonas sp. OIL-1	2706126	S	8	0	8	0.00000
SRR6145058	Pseudomonas sp. MPC6	2498848	S	6	0	6	0.00000
SRR6145058	Pseudomonas sp. M30-35	1981174	S	5	0	5	0.00000
SRR6145058	Pseudomonas sp. Leaf58	1736226	S	12	0	12	0.00000
SRR6145058	Pseudomonas sp. HLS-6	2049589	S	7	0	7	0.00000
SRR6145058	Pseudomonas sp. DY-1	1755504	S	21	0	21	0.00000
SRR6145058	Pseudomonas sp. DG56-2	2320270	S	9	0	9	0.00000
SRR6145058	Pseudomonas sp. CC6-YY-74	1930532	S	13	0	13	0.00000
SRR6145058	Pseudomonas sp. C27(2019)	2604941	S	6	0	6	0.00000
SRR6145058	Pseudomonas sp. ACM7	2052956	S	4	0	4	0.00000
SRR6145058	Pseudomonas sp. 7SR1	1881017	S	15	0	15	0.00000
SRR6145058	Pseudomonas phage PaP2	270673	S	1	0	1	0.00000
SRR6145058	Pseudomonas phage PS-1	1573458	S	1	0	1	0.00000
SRR6145058	Pseudomonas phage PPpW-3	1279082	S	1	0	1	0.00000
SRR6145058	Pseudomonas phage OBP	1124849	S	1	0	1	0.00000
SRR6145058	Pseudodesulfovibrio sp. zrk46	2725288	S	3	0	3	0.00000
SRR6145058	Pseudodesulfovibrio sp. SRB007	2678688	S	6	0	6	0.00000
SRR6145058	Pseudoalteromonas sp. R3	1709477	S	5	0	5	0.00000
SRR6145058	Pseudoalteromonas sp. NC201	1514074	S	2	0	2	0.00000
SRR6145058	Pseudoalteromonas sp. DL-6	1390185	S	3	0	3	0.00000
SRR6145058	Pseudoalteromonas sp. A25	116092	S	2	0	2	0.00000
SRR6145058	Pseudoalteromonas sp. 16-SW-7	2583375	S	1	0	1	0.00000
SRR6145058	Pseudenhygromyxa sp. WMMC2535	2712867	S	60	0	60	0.00001
SRR6145058	Pseudanabaena sp. ABRG5-3	685565	S	4	0	4	0.00000
SRR6145058	Providencia sp. WCHPHu000369	2027290	S	2	0	2	0.00000
SRR6145058	Proteus sp. CD3	1921565	S	3	0	3	0.00000
SRR6145058	Prosthecochloris sp. HL-130-GSB	1974213	S	1	0	1	0.00000
SRR6145058	Prosthecochloris sp. GSB1	281093	S	2	0	2	0.00000
SRR6145058	Prolixibacteraceae bacterium WC007	2681766	S	10	0	10	0.00000
SRR6145058	Prevotella sp. oral taxon 299	652716	S	272	13	285	0.00003
SRR6145058	Pragia sp. CF-458	2498113	S	1	0	1	0.00000
SRR6145058	Pradoshia sp. D12	2651284	S	4	0	4	0.00000
SRR6145058	Porcine type-C oncovirus	369960	S	2	0	2	0.00000
SRR6145058	Pontibacter sp. SGAir0037	2571030	S	11	0	11	0.00000
SRR6145058	Pontibacter sp. BT326	2694929	S	8	0	8	0.00000
SRR6145058	Pontibacter sp. BT214	2694930	S	8	0	8	0.00000
SRR6145058	Pontibacillus sp. HMF3514	2692425	S	5	0	5	0.00000
SRR6145058	Polynucleobacter sp. MWH-UH21B	1743174	S	4	0	4	0.00000
SRR6145058	Polynucleobacter sp. LimPoW16	1743162	S	3	0	3	0.00000
SRR6145058	Polaribacter sp. SA4-12	1312072	S	3	0	3	0.00000
SRR6145058	Polaribacter sp. SA4-10	754397	S	6	0	6	0.00000
SRR6145058	Polaribacter sp. MED152	313598	S	1	0	1	0.00000
SRR6145058	Polaribacter sp. L3A8	2686361	S	3	0	3	0.00000
SRR6145058	Polaribacter sp. KT25b	1855336	S	8	0	8	0.00000
SRR6145058	Polaribacter sp. Hel1_33_78	1336804	S	3	0	3	0.00000
SRR6145058	Polaribacter sp. ALD11	2058137	S	3	0	3	0.00000
SRR6145058	Planococcus sp. Y42	2213202	S	4	0	4	0.00000
SRR6145058	Planococcus sp. MB-3u-03	2058136	S	4	0	4	0.00000
SRR6145058	Planctomycetes bacterium V22	2528027	S	13	0	13	0.00000
SRR6145058	Planctomycetes bacterium TBK1r	2527963	S	14	0	14	0.00000
SRR6145058	Planctomycetes bacterium SV_7m_r	2528025	S	10	0	10	0.00000
SRR6145058	Planctomycetes bacterium SRT547	2596890	S	3	0	3	0.00000
SRR6145058	Planctomycetes bacterium Q31a	2527968	S	8	0	8	0.00000
SRR6145058	Planctomycetes bacterium Poly30	2528018	S	25	0	25	0.00000
SRR6145058	Planctomycetes bacterium Pla85_3_4	2528010	S	24	0	24	0.00000
SRR6145058	Planctomycetes bacterium Pla175	2528009	S	35	0	35	0.00000
SRR6145058	Planctomycetes bacterium Pla163	2528008	S	37	0	37	0.00000
SRR6145058	Planctomycetes bacterium Pla110	2528007	S	5	0	5	0.00000
SRR6145058	Planctomycetes bacterium Pan44	2527983	S	39	0	39	0.00000
SRR6145058	Planctomycetes bacterium Pan265	2527982	S	6	0	6	0.00000
SRR6145058	Planctomycetes bacterium Pan241w	2527973	S	2	0	2	0.00000
SRR6145058	Planctomycetes bacterium Pan216	2527975	S	18	0	18	0.00000
SRR6145058	Planctomycetes bacterium Pan189	2527980	S	17	0	17	0.00000
SRR6145058	Planctomycetes bacterium Pan181	2527972	S	10	0	10	0.00000
SRR6145058	Planctomycetes bacterium MalM25	2527998	S	17	0	17	0.00000
SRR6145058	Planctomycetes bacterium Mal48	2527994	S	4	0	4	0.00000
SRR6145058	Planctomycetes bacterium Mal4	2528026	S	27	0	27	0.00000
SRR6145058	Planctomycetes bacterium KS4	2528020	S	2	0	2	0.00000
SRR6145058	Planctomycetes bacterium K23_9	1930275	S	11	0	11	0.00000
SRR6145058	Planctomycetes bacterium K22_7	1930273	S	10	0	10	0.00000
SRR6145058	Planctomycetes bacterium I41	2528024	S	28	0	28	0.00000
SRR6145058	Planctomycetes bacterium FF011L	1930274	S	5	0	5	0.00000
SRR6145058	Planctomycetes bacterium Enr17	2527976	S	3	0	3	0.00000
SRR6145058	Planctomycetes bacterium Enr13	2527979	S	8	0	8	0.00000
SRR6145058	Planctomycetes bacterium ElP	2527974	S	56	0	56	0.00001
SRR6145058	Planctomycetes bacterium ETA_A8	2528021	S	18	0	18	0.00000
SRR6145058	Planctomycetes bacterium ETA_A1	2528023	S	77	0	77	0.00001
SRR6145058	Planctomycetales bacterium 10988	2603660	S	2	0	2	0.00000
SRR6145058	Planctomyces sp. SH-PL14	1632864	S	57	0	57	0.00001
SRR6145058	Pirellula sp. SH-Sr6A	1632865	S	12	0	12	0.00000
SRR6145058	Phycisphaerae bacterium RAS2	2528035	S	11	0	11	0.00000
SRR6145058	Phaeocystis globosa virus	251749	S	1	0	1	0.00000
SRR6145058	Peptostreptococcaceae bacterium oral taxon 929	2081703	S	185	8	193	0.00002
SRR6145058	Peptoniphilus sp. ING2-D1G	1912856	S	13	0	13	0.00000
SRR6145058	Peptococcaceae bacterium DCMF	1761012	S	1	0	1	0.00000
SRR6145058	Pelosinus sp. UFO1	484770	S	8	0	8	0.00000
SRR6145058	Pelobacter sp. SFB93	1842532	S	4	0	4	0.00000
SRR6145058	Pelistega sp. NLN63	2652177	S	6	0	6	0.00000
SRR6145058	Pedobacter sp. eg	2201271	S	11	0	11	0.00000
SRR6145058	Pedobacter sp. KBS0701	2578106	S	10	0	10	0.00000
SRR6145058	Pedobacter sp. HDW13	2714940	S	9	0	9	0.00000
SRR6145058	Pedobacter sp. G11	2482728	S	5	0	5	0.00000
SRR6145058	Pedobacter sp. CJ43	2605747	S	9	0	9	0.00000
SRR6145058	Pectobacterium virus My1	2560631	S	1	0	1	0.00000
SRR6145058	Pectobacterium phage phiA41	1965354	S	1	0	1	0.00000
SRR6145058	Pectobacterium phage CBB	1792242	S	1	0	1	0.00000
SRR6145058	Pectobacterium bacteriophage PM2	1429794	S	1	0	1	0.00000
SRR6145058	Pasteurellaceae bacterium RH1A	1823760	S	2	0	2	0.00000
SRR6145058	Pasteurellaceae bacterium Orientalotternb1	1524976	S	5	0	5	0.00000
SRR6145058	Paraliobacillus sp. X-1125	2213194	S	4	0	4	0.00000
SRR6145058	Paraglaciecola sp. L3A3	2686358	S	3	0	3	0.00000
SRR6145058	Paraglaciecola sp. L1A13	2686359	S	4	0	4	0.00000
SRR6145058	Parageobacillus genomosp. 1	1295642	S	3	0	3	0.00000
SRR6145058	Paraburkholderia sp. SOS3	1926494	S	29	0	29	0.00000
SRR6145058	Pantoea virus Limelight	1985729	S	2	0	2	0.00000
SRR6145058	Pantoea virus AAS23	2734030	S	1	0	1	0.00000
SRR6145058	Pantoea sp. CCBC3-3-1	2490851	S	14	0	14	0.00000
SRR6145058	Pantoea sp. At-9b	592316	S	19	0	19	0.00000
SRR6145058	Pantoea sp. 201603H	2479547	S	3	0	3	0.00000
SRR6145058	Paenisporosarcina sp. K2R23-3	2320858	S	2	0	2	0.00000
SRR6145058	Paenibacillus sp. Y412MC10	481743	S	2	0	2	0.00000
SRR6145058	Paenibacillus sp. RUD330	2023772	S	12	0	12	0.00000
SRR6145058	Paenibacillus sp. JDR-2	324057	S	7	0	7	0.00000
SRR6145058	Paenibacillus sp. IHB B 3084	867076	S	1	0	1	0.00000
SRR6145058	Paenibacillus sp. HB172198	2565926	S	5	0	5	0.00000
SRR6145058	Paenibacillus sp. DCT19	2211212	S	3	0	3	0.00000
SRR6145058	Paenibacillus sp. CAA11	1532905	S	8	0	8	0.00000
SRR6145058	Paenibacillus sp. BIHB4019	1870819	S	3	0	3	0.00000
SRR6145058	Paenibacillus sp. 37	2607911	S	4	0	4	0.00000
SRR6145058	Paenibacillus sp. 32O-W	1695218	S	4	0	4	0.00000
SRR6145058	Paenibacillus sp. 14171R-81	2704463	S	7	0	7	0.00000
SRR6145058	Paenibacillus sp. 12200R-189	2704462	S	15	0	15	0.00000
SRR6145058	Paenibacillaceae bacterium GAS479	1882832	S	7	0	7	0.00000
SRR6145058	Oxynema sp. AP17	2064643	S	4	0	4	0.00000
SRR6145058	Ottowia sp. oral taxon 894	1658672	S	245	8	253	0.00003
SRR6145058	Oscillatoriales cyanobacterium JSC-12	864702	S	5	0	5	0.00000
SRR6145058	Orgyia leucostigma nucleopolyhedrovirus	490711	S	1	0	1	0.00000
SRR6145058	Orbus sp. IPMB12	1635327	S	2	0	2	0.00000
SRR6145058	Opitutus sp. GAS368	1882749	S	21	0	21	0.00000
SRR6145058	Opitutaceae bacterium TAV5	794903	S	23	0	23	0.00000
SRR6145058	Olsenella sp. oral taxon 807	712411	S	287	2	289	0.00003
SRR6145058	Olsenella sp. GAM18	2109685	S	5	0	5	0.00000
SRR6145058	Olleya sp. Bg11-27	2058135	S	1	0	1	0.00000
SRR6145058	Oceanospirillales bacterium S2-4-1H	2683272	S	4	0	4	0.00000
SRR6145058	Oceanobacillus sp. 160	2052660	S	3	0	3	0.00000
SRR6145058	Oceanispirochaeta sp. K2	2518645	S	3	0	3	0.00000
SRR6145058	Oceanimonas sp. GK1	511062	S	15	0	15	0.00000
SRR6145058	Oceanihabitans sp. IOP_32	2529032	S	5	0	5	0.00000
SRR6145058	Oceanicola sp. D3	2587163	S	31	0	31	0.00000
SRR6145058	Nostoc sp. CENA543	1869241	S	8	0	8	0.00000
SRR6145058	Nonlabens sp. MJ115	2496866	S	2	0	2	0.00000
SRR6145058	Nonlabens sp. MB-3u-79	2058134	S	2	0	2	0.00000
SRR6145058	Nonlabens sp. Hel1_33_55	1336802	S	5	0	5	0.00000
SRR6145058	Nonlabens sp. Ci31	2608253	S	1	0	1	0.00000
SRR6145058	Nodularia spumigena	70799	S	4	-4	0	0.00000
SRR6145058	Nitrospira sp. KM1	1936990	S	6	0	6	0.00000
SRR6145058	Nitrosomonas sp. Is79A3	261292	S	4	0	4	0.00000
SRR6145058	Nitrosomonadales bacterium skT11	2715678	S	12	0	12	0.00000
SRR6145058	Nitrosomonadales bacterium Swamp67	2732487	S	27	0	27	0.00000
SRR6145058	Nitrosomonadales bacterium 0125_3	2732067	S	24	0	24	0.00000
SRR6145058	Nitrincola sp. KXZD1103	2614693	S	7	0	7	0.00000
SRR6145058	Nissabacter sp. SGAir0207	2126321	S	15	0	15	0.00000
SRR6145058	Nibribacter sp. BT10	2698458	S	1	0	1	0.00000
SRR6145058	Nesterenkonia sp. NBAIMH1	2600320	S	57	0	57	0.00001
SRR6145058	Neokomagataea sp. Ha5	2558360	S	4	0	4	0.00000
SRR6145058	Neochlamydia sp. S13	1353976	S	2	0	2	0.00000
SRR6145058	Neisseria sp. oral taxon 014	641148	S	1408	141	1549	0.00017
SRR6145058	Neisseria sp. 10022	1853276	S	23	0	23	0.00000
SRR6145058	Nautilia sp. PV-1	2579250	S	1	0	1	0.00000
SRR6145058	Nakamurella sp. s14-144	1902245	S	22	0	22	0.00000
SRR6145058	Myroides sp. CJ210	2572594	S	3	0	3	0.00000
SRR6145058	Myotis gammaherpesvirus 8	1780507	S	1	0	1	0.00000
SRR6145058	Mycoplasma suis	57372	S	1	-1	0	0.00000
SRR6145058	Mycoplasma sp. OR1901	2742195	S	1	0	1	0.00000
SRR6145058	Mycoplasma sp. NEAQ87857	2683967	S	2	0	2	0.00000
SRR6145058	Mycoplasma sp. C264-NAS	2726117	S	1	0	1	0.00000
SRR6145058	Mycoplasma sp. (ex Biomphalaria glabrata)	1749074	S	1	0	1	0.00000
SRR6145058	Mycobacterium virus Yoshi	1034150	S	1	0	1	0.00000
SRR6145058	Mycobacterium virus Wildcat	1993859	S	1	0	1	0.00000
SRR6145058	Mycobacterium virus Predator	1982365	S	1	0	1	0.00000
SRR6145058	Mycobacterium virus Pixie	1034114	S	1	0	1	0.00000
SRR6145058	Mycobacterium virus Jaws	1051143	S	1	0	1	0.00000
SRR6145058	Mycobacterium virus Crimd	861045	S	1	0	1	0.00000
SRR6145058	Mycobacterium phage Enkosi	1698709	S	1	0	1	0.00000
SRR6145058	Mycobacterium phage EagleEye	1429759	S	1	0	1	0.00000
SRR6145058	Mycobacterium phage Dori	1089121	S	1	0	1	0.00000
SRR6145058	Mycobacterium phage Cambiare	1647305	S	2	0	2	0.00000
SRR6145058	Mycetocola sp. 449	2079792	S	31	0	31	0.00000
SRR6145058	Muriicola sp. MMS17-SY002	2507538	S	5	0	5	0.00000
SRR6145058	Muricauda sp. 501str8	2698672	S	8	0	8	0.00000
SRR6145058	Muribaculum sp. TLL-A4	2530390	S	3	0	3	0.00000
SRR6145058	Mucilaginibacter sp. HYN0043	2305508	S	5	0	5	0.00000
SRR6145058	Mucilaginibacter sp. 14171R-50	2703789	S	4	0	4	0.00000
SRR6145058	Moumouvirus	985782	S	2	0	2	0.00000
SRR6145058	Morganella phage vB_MmoM_MP1	1852628	S	1	0	1	0.00000
SRR6145058	Moraxellaceae bacterium HYN0046	2283318	S	10	0	10	0.00000
SRR6145058	Molluscum contagiosum virus	10279	S	3	0	3	0.00000
SRR6145058	Mobilicoccus sp. NJES-13	2716227	S	82	0	82	0.00001
SRR6145058	Microvirga sp. 17 mud 1-3	2082949	S	50	5	55	0.00001
SRR6145058	Microcystis sp. MC19	1967666	S	1	0	1	0.00000
SRR6145058	Microbulbifer sp. THAF38	2587856	S	6	0	6	0.00000
SRR6145058	Microbulbifer sp. SH-1	2681547	S	3	0	3	0.00000
SRR6145058	Microbulbifer sp. GL-2	2591606	S	4	0	4	0.00000
SRR6145058	Microbulbifer sp. ALW1	1516059	S	11	0	11	0.00000
SRR6145058	Microbulbifer sp. A4B17	359370	S	3	0	3	0.00000
SRR6145058	Microbacterium virus MementoMori	2734252	S	1	0	1	0.00000
SRR6145058	Microbacterium virus Eleri	2560589	S	1	0	1	0.00000
SRR6145058	Microbacterium virus Dismas	2560588	S	1	0	1	0.00000
SRR6145058	Microbacterium virus Appa	2734215	S	1	0	1	0.00000
SRR6145058	Methylophilus sp. TWE2	1662285	S	3	0	3	0.00000
SRR6145058	Methylomonas sp. LW13	107637	S	3	0	3	0.00000
SRR6145058	Methylomonas sp. GJ1	2608981	S	7	0	7	0.00000
SRR6145058	Methylomonas sp. DH-1	1727196	S	2	0	2	0.00000
SRR6145058	Methylomicrobium sp. wino1	2049332	S	1	0	1	0.00000
SRR6145058	Methylococcus sp. IM1	2681310	S	10	0	10	0.00000
SRR6145058	Methyloceanibacter sp. wino2	2170729	S	9	0	9	0.00000
SRR6145058	Methanothermobacter sp. THM-2	2606912	S	1	0	1	0.00000
SRR6145058	Methanosarcina thermophila	2210	S	2	-2	0	0.00000
SRR6145058	Methanomassiliicoccaceae archaeon DOK	1535962	S	1	0	1	0.00000
SRR6145058	Methanofervidicoccus sp. A16	2607662	S	2	0	2	0.00000
SRR6145058	Methanocaldococcus sp. FS406-22	644281	S	2	0	2	0.00000
SRR6145058	Methanobrevibacter sp. YE315	1609968	S	1	0	1	0.00000
SRR6145058	Methanobrevibacter sp. AbM4	224719	S	6	0	6	0.00000
SRR6145058	Methanobacterium sp. MB1	1379702	S	1	0	1	0.00000
SRR6145058	Marinomonas sp. MWYL1	400668	S	3	0	3	0.00000
SRR6145058	Marinomonas sp. FW-1	2071621	S	3	0	3	0.00000
SRR6145058	Marinobacterium sp. LSUCC0821	2668067	S	3	0	3	0.00000
SRR6145058	Marinobacter sp. es.042	1761794	S	1	0	1	0.00000
SRR6145058	Marinobacter sp. NP-4(2019)	2488665	S	5	0	5	0.00000
SRR6145058	Marinobacter sp. LV10R510-11A	1415568	S	14	0	14	0.00000
SRR6145058	Marinobacter sp. Arc7-DN-1	2304594	S	10	0	10	0.00000
SRR6145058	Marinilactibacillus sp. 15R	1911586	S	14	0	14	0.00000
SRR6145058	Mariniflexile sp. TRM1-10	2027857	S	7	0	7	0.00000
SRR6145058	Maribius sp. THAF1	2587842	S	30	0	30	0.00000
SRR6145058	Maribacter sp. T28	1836467	S	2	0	2	0.00000
SRR6145058	Maribacter sp. MJ134	2496865	S	5	0	5	0.00000
SRR6145058	Maribacter sp. HTCC2170	313603	S	5	0	5	0.00000
SRR6145058	Mannheimia sp. ZY170218	2679994	S	4	0	4	0.00000
SRR6145058	Magnetospira sp. QH-2	1288970	S	14	0	14	0.00000
SRR6145058	Macacine betaherpesvirus 9	2560568	S	1	0	1	0.00000
SRR6145058	Lysinibacillus sp. YS11	2072025	S	4	0	4	0.00000
SRR6145058	Lysinibacillus sp. SGAir0095	2070463	S	2	0	2	0.00000
SRR6145058	Lysinibacillus sp. 2017	2169540	S	10	0	10	0.00000
SRR6145058	Lymantria xylina nucleopolyhedrovirus	166921	S	1	0	1	0.00000
SRR6145058	Luteolibacter sp. G-1-1-1	2728835	S	14	0	14	0.00000
SRR6145058	Litoreibacter sp. LN3S51	2599296	S	18	0	18	0.00000
SRR6145058	Listeria sp. PSOL-1	1844999	S	2	0	2	0.00000
SRR6145058	Limnohabitans sp. 103DPR2	1678129	S	11	0	11	0.00000
SRR6145058	Limnobacter sp. SAORIC-580	2732163	S	20	0	20	0.00000
SRR6145058	Leucobacter sp. HDW9B	2714934	S	16	0	16	0.00000
SRR6145058	Lettuce mosaic virus	12202	S	1	0	1	0.00000
SRR6145058	Leptotrichia sp. oral taxon 847	1785996	S	86	10	96	0.00001
SRR6145058	Leptotrichia sp. oral taxon 498	712368	S	184	34	218	0.00002
SRR6145058	Leptotrichia sp. oral taxon 212	712357	S	405	11	416	0.00005
SRR6145058	Leptospirillum sp. Group II 'CF-1'	1660083	S	1	0	1	0.00000
SRR6145058	Leptospira biflexa	172	S	3	-3	0	0.00000
SRR6145058	Leptolyngbya sp. NIES-3755	1752064	S	11	0	11	0.00000
SRR6145058	Lentilitoribacter sp. Alg239-R112	2305987	S	1	0	1	0.00000
SRR6145058	Lelliottia sp. WB101	2153385	S	6	0	6	0.00000
SRR6145058	Legionella sp. TUM19329	2708020	S	3	0	3	0.00000
SRR6145058	Legionella endosymbiont of Polyplax serrata	2005262	S	4	0	4	0.00000
SRR6145058	Leeuwenhoekiella sp. ZYFB001	2719912	S	4	0	4	0.00000
SRR6145058	Lactococcus virus c2	31537	S	3	0	3	0.00000
SRR6145058	Lactococcus virus Sl4	287412	S	1	0	1	0.00000
SRR6145058	Lactococcus virus CB13	665883	S	2	0	2	0.00000
SRR6145058	Lactococcus virus Bibb29	494269	S	2	0	2	0.00000
SRR6145058	Lactococcus phage phi7	1262538	S	2	0	2	0.00000
SRR6145058	Lactococcus phage P680	1262537	S	1	0	1	0.00000
SRR6145058	Lactobacillus sp. wkB8	1545702	S	1	0	1	0.00000
SRR6145058	Lactobacillus sp. P38	2692756	S	2	0	2	0.00000
SRR6145058	Lactobacillus sp. CBA3606	2099789	S	1	0	1	0.00000
SRR6145058	Lactobacillus sp. BHWM-4	2419772	S	1	0	1	0.00000
SRR6145058	Lactobacillus kefiranofaciens	267818	S	7	-7	0	0.00000
SRR6145058	Lacinutrix sp. Bg11-31	2057808	S	9	0	9	0.00000
SRR6145058	Lacinutrix sp. 5H-3-7-4	983544	S	5	0	5	0.00000
SRR6145058	Lachnospiraceae bacterium oral taxon 500	712991	S	52	3	55	0.00001
SRR6145058	Lachnospiraceae bacterium KM106-2	2093742	S	7	0	7	0.00000
SRR6145058	Lachnospiraceae bacterium KGMB03038	2594789	S	3	0	3	0.00000
SRR6145058	Lachnospiraceae bacterium Choco86	2109690	S	7	0	7	0.00000
SRR6145058	Labrenzia sp. VG12	2021862	S	30	0	30	0.00000
SRR6145058	Labrenzia sp. THAF82	2587861	S	8	0	8	0.00000
SRR6145058	Labrenzia sp. PHM005	2590016	S	7	0	7	0.00000
SRR6145058	Kushneria sp. YCWA18	657387	S	8	0	8	0.00000
SRR6145058	Kurthia sp. 11kri321	1750719	S	17	0	17	0.00000
SRR6145058	Kordia sp. SMS9	2282170	S	9	0	9	0.00000
SRR6145058	Kluyvera sp. PO2S7	2705459	S	8	0	8	0.00000
SRR6145058	Klebsiella virus Sugarland	2560546	S	1	0	1	0.00000
SRR6145058	Klebsiella virus K64-1	2560541	S	1	0	1	0.00000
SRR6145058	Klebsiella virus IME205	2733667	S	1	0	1	0.00000
SRR6145058	Klebsiella virus 0507KN21	2169687	S	1	0	1	0.00000
SRR6145058	Klebsiella phage vB_KpnM_KpV477	1852625	S	1	0	1	0.00000
SRR6145058	Kiritimatiellaeota bacterium S-5007	2697043	S	4	0	4	0.00000
SRR6145058	Kineobactrum sp. M2	2708301	S	10	0	10	0.00000
SRR6145058	Jeongeupia sp. USM3	1906741	S	21	0	21	0.00000
SRR6145058	Jatrophihabitans sp. GAS493	1907575	S	41	0	41	0.00000
SRR6145058	Janthinobacterium sp. B9-8	1236179	S	9	0	9	0.00000
SRR6145058	Janthinobacterium sp. 17J80-10	2497863	S	17	0	17	0.00000
SRR6145058	Jannaschia sp. CCS1	290400	S	23	0	23	0.00000
SRR6145058	Izhakiella sp. KSNA2	2579935	S	6	0	6	0.00000
SRR6145058	Iodobacter sp. H11R3	2496266	S	2	0	2	0.00000
SRR6145058	Idiomarinaceae bacterium HL-53	1298881	S	3	0	3	0.00000
SRR6145058	Idiomarina sp. X4	2055892	S	1	0	1	0.00000
SRR6145058	Idiomarina sp. OT37-5b	2100422	S	4	0	4	0.00000
SRR6145058	Idiomarina loihiensis	135577	S	3	-3	0	0.00000
SRR6145058	Hyphomonas sp. Mor2	1906738	S	8	0	8	0.00000
SRR6145058	Hymenobacter sp. TS19	2735321	S	13	0	13	0.00000
SRR6145058	Hymenobacter sp. BT182	2697562	S	20	0	20	0.00000
SRR6145058	Hymenobacter sp. BT18	2724192	S	13	0	13	0.00000
SRR6145058	Hydrogenophaga sp. PAMC20947	2565558	S	33	0	33	0.00000
SRR6145058	Hydrogenobaculum sp. Y04AAS1	380749	S	1	0	1	0.00000
SRR6145058	Hydrogenobacter sp. T-8	1632019	S	7	0	7	0.00000
SRR6145058	Human polyomavirus 5	1891726	S	10	0	10	0.00000
SRR6145058	Human polyomavirus 11	1891745	S	1	0	1	0.00000
SRR6145058	Human gammaherpesvirus 4	10376	S	1	0	1	0.00000
SRR6145058	Human alphaherpesvirus 1	10298	S	1	0	1	0.00000
SRR6145058	Hoeflea sp. IMCC20628	1620421	S	13	0	13	0.00000
SRR6145058	Herbaspirillum sp. meg3	2025949	S	14	0	14	0.00000
SRR6145058	Halothiobacillus sp. LS2	1860122	S	7	0	7	0.00000
SRR6145058	Halorussus sp. ZS-3	2650975	S	5	0	5	0.00000
SRR6145058	Halorussus sp. RC-68	2505977	S	9	0	9	0.00000
SRR6145058	Halorubrum sp. PV6	634157	S	12	0	12	0.00000
SRR6145058	Halorubrum sp. BOL3-1	2497325	S	6	0	6	0.00000
SRR6145058	Halorubrum phage CGphi46	754066	S	1	0	1	0.00000
SRR6145058	Halorientalis sp. IM1011	1932360	S	14	0	14	0.00000
SRR6145058	Haloprofundus sp. MHR1	2572921	S	15	0	15	0.00000
SRR6145058	Halomonas sp. Y2R2	2562282	S	13	0	13	0.00000
SRR6145058	Halomonas sp. N3-2A	2014541	S	4	0	4	0.00000
SRR6145058	Halomonas sp. GT	1971364	S	4	0	4	0.00000
SRR6145058	Halomonas sp. GFAJ-1	1118153	S	17	0	17	0.00000
SRR6145058	Halomonas sp. BC-M4-5	2497861	S	18	0	18	0.00000
SRR6145058	Halomonas sp. 1513	1883416	S	18	0	18	0.00000
SRR6145058	Halomicrobium sp. LC1Hm	2610902	S	5	0	5	0.00000
SRR6145058	Halocella sp. SP3-1	2382161	S	3	0	3	0.00000
SRR6145058	Haloarculaceae archaeon HArcel1	1679096	S	5	0	5	0.00000
SRR6145058	Haloarcula sp. JP-L23	2716717	S	3	0	3	0.00000
SRR6145058	Haloactinobacterium sp. HY164	2675754	S	67	0	67	0.00001
SRR6145058	Halieaceae bacterium IMCC3088	2518989	S	11	0	11	0.00000
SRR6145058	Haemophilus sp. oral taxon 036	712310	S	212	45	257	0.00003
SRR6145058	Granulicella sp. WH15	2602070	S	11	0	11	0.00000
SRR6145058	Gramella sp. MAR_2010_147	1250205	S	5	0	5	0.00000
SRR6145058	Gramella sp. MAR_2010_102	1250231	S	8	0	8	0.00000
SRR6145058	Gracilibacillus sp. SCU50	2663022	S	2	0	2	0.00000
SRR6145058	Gordonia virus Ruthy	2734272	S	1	0	1	0.00000
SRR6145058	Gordonia virus OneUp	1982560	S	1	0	1	0.00000
SRR6145058	Gordonia virus Nyceirae	2560506	S	1	0	1	0.00000
SRR6145058	Gordonia virus Mahdia	2560505	S	1	0	1	0.00000
SRR6145058	Gordonia virus Lucky10	2734247	S	2	0	2	0.00000
SRR6145058	Gordonia virus GAL1	2560493	S	7	0	7	0.00000
SRR6145058	Gordonia virus Britbrat	2560489	S	5	0	5	0.00000
SRR6145058	Gordonia virus BetterKatz	2560485	S	1	0	1	0.00000
SRR6145058	Gordonia phage Phinally	1821560	S	14	0	14	0.00000
SRR6145058	Gordonia phage Obliviate	1821559	S	2	0	2	0.00000
SRR6145058	Gordonia phage McGonagall	1838072	S	1	0	1	0.00000
SRR6145058	Gordonia phage Guacamole	1821553	S	1	0	1	0.00000
SRR6145058	Gordonia phage GTE6	1647474	S	10	0	10	0.00000
SRR6145058	Gordonia phage Fairfaxidum	2572526	S	1	0	1	0.00000
SRR6145058	Gordonia phage Daredevil	2283286	S	1	0	1	0.00000
SRR6145058	Gordonia phage CarolAnn	1887644	S	1	0	1	0.00000
SRR6145058	Gordonia phage Blueberry	1838062	S	2	0	2	0.00000
SRR6145058	Glaesserella sp. 15-184	2030797	S	7	0	7	0.00000
SRR6145058	Glaciecola sp. THG-3.7	2489595	S	6	0	6	0.00000
SRR6145058	Glaciecola sp. 4H-3-7+YE-5	983545	S	1	0	1	0.00000
SRR6145058	Gilvibacter sp. SZ-19	754429	S	4	0	4	0.00000
SRR6145058	Gillisia sp. Hel1_33_143	1336796	S	5	0	5	0.00000
SRR6145058	Geobacter sp. FeAm09	2597769	S	13	0	13	0.00000
SRR6145058	Geobacillus sp. WCH70	471223	S	1	0	1	0.00000
SRR6145058	Geobacillus genomosp. 3	1921421	S	1	0	1	0.00000
SRR6145058	Gemmatimonas sp. TET16	2732249	S	19	0	19	0.00000
SRR6145058	Geminocystis sp. NIES-3709	1617448	S	4	0	4	0.00000
SRR6145058	Gemella sp. oral taxon 928	1785995	S	15	25	40	0.00000
SRR6145058	Gammaproteobacteria bacterium ESL0073	2070539	S	1	0	1	0.00000
SRR6145058	Gammaproteobacteria bacterium DM2	2169539	S	6	0	6	0.00000
SRR6145058	Fusobacterium sp. oral taxon 203	671211	S	51	20	71	0.00001
SRR6145058	Frankineae bacterium MT45	1882833	S	36	0	36	0.00000
SRR6145058	Francisella sp. FSC1006	1547445	S	3	0	3	0.00000
SRR6145058	Formosa sp. L2A11	2686363	S	2	0	2	0.00000
SRR6145058	Formosa sp. Hel3_A1_48	1336795	S	4	0	4	0.00000
SRR6145058	Formosa sp. Hel1_33_131	1336794	S	2	0	2	0.00000
SRR6145058	Formosa sp. Hel1_31_208	1798225	S	6	0	6	0.00000
SRR6145058	Flintibacter sp. KGMB00164	2610895	S	5	0	5	0.00000
SRR6145058	Flavobacterium sp. XS-5	2602769	S	18	0	18	0.00000
SRR6145058	Flavobacterium sp. Sr18	935222	S	6	0	6	0.00000
SRR6145058	Flavobacterium sp. CJ74	2294119	S	23	0	23	0.00000
SRR6145058	Flavobacteriaceae bacterium UJ101	1150389	S	5	0	5	0.00000
SRR6145058	Flavobacteriaceae bacterium MAR_2010_188	1250295	S	4	0	4	0.00000
SRR6145058	Flavobacteriaceae bacterium F202Z8	2583587	S	11	0	11	0.00000
SRR6145058	Flavobacteriaceae bacterium 10Alg115	2584122	S	8	0	8	0.00000
SRR6145058	Flavisolibacter sp. 17J28-1	2502779	S	28	0	28	0.00000
SRR6145058	Flavihumibacter sp. SB-02	2676868	S	18	0	18	0.00000
SRR6145058	Flaviflexus sp. H23T48	2496867	S	21	0	21	0.00000
SRR6145058	Flammeovirgaceae bacterium 311	1257021	S	8	0	8	0.00000
SRR6145058	Flammeovirga sp. MY04	1191459	S	7	0	7	0.00000
SRR6145058	Fibrella sp. ES10-3-2-2	1834519	S	10	0	10	0.00000
SRR6145058	Ferrimonas sp. S7	2724191	S	4	0	4	0.00000
SRR6145058	Felid gammaherpesvirus 1	2560468	S	1	0	1	0.00000
SRR6145058	Exiguobacterium sp. N4-1P	2051906	S	6	0	6	0.00000
SRR6145058	Euzebya sp. DY32-46	1608957	S	46	0	46	0.00001
SRR6145058	Escherichia virus Talmos	1910969	S	7	0	7	0.00000
SRR6145058	Escherichia virus RB43	115991	S	1	0	1	0.00000
SRR6145058	Escherichia virus PBECO4	2560463	S	1	0	1	0.00000
SRR6145058	Escherichia virus ID62	1945588	S	1	0	1	0.00000
SRR6145058	Escherichia virus G4	1986034	S	3	0	3	0.00000
SRR6145058	Escherichia sp. E4742	2044467	S	3	0	3	0.00000
SRR6145058	Erythrobacter sp. KY5	2011159	S	21	0	21	0.00000
SRR6145058	Erysipelotrichaceae bacterium GAM147	2109692	S	1	0	1	0.00000
SRR6145058	Erysipelothrix sp. HDW6C	2714930	S	1	0	1	0.00000
SRR6145058	Erysipelothrix sp. HDW6B	2714929	S	4	0	4	0.00000
SRR6145058	Erysipelothrix sp. HDW6A	2714928	S	5	0	5	0.00000
SRR6145058	Erysipelothrix sp. 15TAL0474	2485784	S	1	0	1	0.00000
SRR6145058	Erwiniaceae bacterium PD-1	2740817	S	4	0	4	0.00000
SRR6145058	Erwinia virus Yoloswag	2734158	S	2	0	2	0.00000
SRR6145058	Erwinia virus Y2	2733974	S	1	0	1	0.00000
SRR6145058	Erwinia virus Machina	2169990	S	1	0	1	0.00000
SRR6145058	Erwinia virus EaH2	2169883	S	1	0	1	0.00000
SRR6145058	Erwinia virus Alexandra	2734081	S	1	0	1	0.00000
SRR6145058	Erwinia sp. J780	2681984	S	7	0	7	0.00000
SRR6145058	Erwinia phage vB_EamM_Caitlin	1883379	S	1	0	1	0.00000
SRR6145058	Enterococcus phage EF62phi	977801	S	1	0	1	0.00000
SRR6145058	Enterobacteriaceae endosymbiont of Plateumaris sericea	2675797	S	1	0	1	0.00000
SRR6145058	Enterobacteriaceae endosymbiont of Plateumaris consimilis	2675794	S	1	0	1	0.00000
SRR6145058	Enterobacteriaceae endosymbiont of Macroplea appendiculata	2675790	S	1	0	1	0.00000
SRR6145058	Enterobacteriaceae endosymbiont of Donacia simplex	2675784	S	1	0	1	0.00000
SRR6145058	Enterobacteriaceae endosymbiont of Donacia proxima	2675782	S	2	0	2	0.00000
SRR6145058	Enterobacteriaceae endosymbiont of Donacia piscatrix	2675780	S	2	0	2	0.00000
SRR6145058	Enterobacteriaceae endosymbiont of Donacia dentata	2675777	S	1	1	2	0.00000
SRR6145058	Enterobacteriaceae endosymbiont of Donacia cinerea	2675774	S	1	0	1	0.00000
SRR6145058	Enterobacteriaceae endosymbiont of Donacia cincticornis	2675773	S	1	0	1	0.00000
SRR6145058	Enterobacteriaceae bacterium strain FGI 57	693444	S	9	0	9	0.00000
SRR6145058	Enterobacter virus PG7	1913655	S	1	0	1	0.00000
SRR6145058	Enterobacter sp. SA187	1914861	S	5	0	5	0.00000
SRR6145058	Enterobacter sp. R4-368	1166130	S	3	0	3	0.00000
SRR6145058	Enterobacter sp. 638	399742	S	5	0	5	0.00000
SRR6145058	Emcibacter sp. MEBiC09520	2582913	S	16	0	16	0.00000
SRR6145058	Elizabethkingia sp. JS20170427COW	2583851	S	33	0	33	0.00000
SRR6145058	Elephantid betaherpesvirus 1	146015	S	1	0	1	0.00000
SRR6145058	Ehrlichia chaffeensis	945	S	2	-2	0	0.00000
SRR6145058	Eggerthellaceae bacterium zg-1050	2734634	S	13	0	13	0.00000
SRR6145058	Eggerthella sp. YY7918	502558	S	4	0	4	0.00000
SRR6145058	Edaphobacter sp. 12200R-103	2703788	S	5	0	5	0.00000
SRR6145058	Ectothiorhodospiraceae bacterium BW-2	947515	S	5	0	5	0.00000
SRR6145058	Ectothiorhodospiraceae bacterium 2226	2740164	S	16	0	16	0.00000
SRR6145058	Echinicola sp. LN3S3	2591634	S	3	0	3	0.00000
SRR6145058	Dyella sp. M7H15-1	2501295	S	8	0	8	0.00000
SRR6145058	Drosophila innubila nudivirus	2057187	S	2	0	2	0.00000
SRR6145058	Draconibacterium sp. M1	2706887	S	5	0	5	0.00000
SRR6145058	Dokdonia sp. PRO95	1239415	S	1	0	1	0.00000
SRR6145058	Dokdonia sp. MED134	313590	S	2	0	2	0.00000
SRR6145058	Dokdonia sp. Dokd-P16	2173169	S	2	0	2	0.00000
SRR6145058	Dokdonia sp. 4H-3-7-5	983548	S	2	0	2	0.00000
SRR6145058	Dinoroseobacter virus DFL12	2169868	S	1	0	1	0.00000
SRR6145058	Dietzia sp. oral taxon 368	712270	S	3067	465	3532	0.00039
SRR6145058	Dickeya virus AD1	2734080	S	4	0	4	0.00000
SRR6145058	Dickeya phage vB_DsoP_JA10	2283033	S	1	0	1	0.00000
SRR6145058	Desulfuromonas sp. DDH964	1823759	S	11	0	11	0.00000
SRR6145058	Desulfurococcus amylolyticus	94694	S	1	-1	0	0.00000
SRR6145058	Desulfovibrio sp. IOR2	2583823	S	8	0	8	0.00000
SRR6145058	Deinococcus sp. S14-83	2489213	S	42	0	42	0.00000
SRR6145058	Deefgea sp. D17	2739061	S	2	0	2	0.00000
SRR6145058	Dechloromonas sp. HYN0024	2231055	S	12	0	12	0.00000
SRR6145058	Cyprinid herpesvirus 3	180230	S	1	0	1	0.00000
SRR6145058	Curvibacter sp. AEP1-3	1844971	S	28	0	28	0.00000
SRR6145058	Cronobacter virus GAP227	2733371	S	1	0	1	0.00000
SRR6145058	Cronobacter phage vB_CsaM_GAP32	1141136	S	2	0	2	0.00000
SRR6145058	Cronobacter phage CR5	1195085	S	2	0	2	0.00000
SRR6145058	Crassaminicella sp. SY095	2599308	S	1	0	1	0.00000
SRR6145058	Coxiella endosymbiont of Amblyomma sculptum	2487929	S	1	1	2	0.00000
SRR6145058	Corynebacterium sp. sy039	2599641	S	20	0	20	0.00000
SRR6145058	Corynebacteriaceae bacterium 'ARUP UnID 227'	1164002	S	35	34	69	0.00001
SRR6145058	Coriobacteriaceae bacterium 68-1-3	1531429	S	6	0	6	0.00000
SRR6145058	Colwellia sp. MT41	58049	S	7	0	7	0.00000
SRR6145058	Colwellia sp. Arc7-D	2161872	S	1	0	1	0.00000
SRR6145058	Colwellia sp. Arc7-635	2497879	S	2	0	2	0.00000
SRR6145058	Colwellia sp. 20A7	2689569	S	2	0	2	0.00000
SRR6145058	Cohnella sp. MFER-1	2728023	S	2	0	2	0.00000
SRR6145058	Cohaesibacter sp. ES.047	1798205	S	9	0	9	0.00000
SRR6145058	Cobetia sp. L2A1	2686360	S	3	0	3	0.00000
SRR6145058	Clostridium sp. SY8519	1042156	S	3	0	3	0.00000
SRR6145058	Clostridium sp. JN500901	2068654	S	5	0	5	0.00000
SRR6145058	Clostridium sp. JN-9	2507159	S	9	0	9	0.00000
SRR6145058	Clostridium sp. JN-1	2483110	S	5	0	5	0.00000
SRR6145058	Clostridium sp. DL-VIII	641107	S	14	0	14	0.00000
SRR6145058	Clostridium sp. CT4	2320868	S	11	0	11	0.00000
SRR6145058	Clostridium sp. BNL1100	755731	S	1	0	1	0.00000
SRR6145058	Clostridium sp. AWRP	2212991	S	6	0	6	0.00000
SRR6145058	Clostridiaceae bacterium 14S0207	2082193	S	9	0	9	0.00000
SRR6145058	Citrus endogenous pararetrovirus	1435008	S	3	0	3	0.00000
SRR6145058	Citrobacter sp. NMI7904_11	2653932	S	3	0	3	0.00000
SRR6145058	Citrobacter sp. LY-1	2546350	S	1	0	1	0.00000
SRR6145058	Citrobacter freundii complex sp. CFNIH9	2077149	S	5	22	27	0.00000
SRR6145058	Citrobacter freundii complex sp. CFNIH3	2077147	S	1	3	4	0.00000
SRR6145058	Citrobacter freundii complex sp. CFNIH2	2066049	S	2	1	3	0.00000
SRR6145058	Chrysochromulina ericina virus	455364	S	2	0	2	0.00000
SRR6145058	Chryseobacterium sp. T16E-39	2015076	S	32	0	32	0.00000
SRR6145058	Chryseobacterium sp. IHB B 17019	1721091	S	81	2	83	0.00001
SRR6145058	Chromatiaceae bacterium No.7	2699430	S	9	0	9	0.00000
SRR6145058	Chromatiaceae bacterium 2141T.STBD.0c.01a	1978339	S	16	0	16	0.00000
SRR6145058	Christensenella sp. Marseille-P3954	2086585	S	5	0	5	0.00000
SRR6145058	Chondrocystis sp. NIES-4102	2005460	S	3	0	3	0.00000
SRR6145058	Chloroflexus aurantiacus	1108	S	11	-11	0	0.00000
SRR6145058	Chlamydia pecorum	85991	S	1	-1	0	0.00000
SRR6145058	Chitinophaga sp. XS-30	2604421	S	10	0	10	0.00000
SRR6145058	Chitinophaga sp. MD30	2033437	S	12	0	12	0.00000
SRR6145058	Chitinophaga sp. H33E-04	2703787	S	4	0	4	0.00000
SRR6145058	Chitinimonas sp. R3-44	2594795	S	12	0	12	0.00000
SRR6145058	Cellvibrio sp. PSBB006	1987723	S	6	0	6	0.00000
SRR6145058	Cellulophaga sp. L1A9	2686362	S	3	0	3	0.00000
SRR6145058	Cedecea sp. FDAARGOS_727	2545798	S	1	0	1	0.00000
SRR6145058	Caviid betaherpesvirus 2	33706	S	1	0	1	0.00000
SRR6145058	Caulobacteraceae bacterium OTSz_A_272	1759059	S	14	0	14	0.00000
SRR6145058	Caulobacteraceae bacterium 0127_4	2686094	S	30	0	30	0.00000
SRR6145058	Caulobacter virus Rogue	1211643	S	1	0	1	0.00000
SRR6145058	Caulobacter virus CcrSC	2734193	S	1	0	1	0.00000
SRR6145058	Catenovulum sp. CCB-QB4	2172099	S	3	0	3	0.00000
SRR6145058	Carnobacterium sp. CP1	1564681	S	8	0	8	0.00000
SRR6145058	Carnobacterium sp. 17-4	208596	S	4	0	4	0.00000
SRR6145058	Cardinium endosymbiont of Sogatella furcifera	650378	S	3	0	3	0.00000
SRR6145058	Caproiciproducens sp. NJN-50	2507162	S	12	0	12	0.00000
SRR6145058	Capnocytophaga sp. oral taxon 878	1316596	S	118	9	127	0.00001
SRR6145058	Capnocytophaga sp. oral taxon 864	1316593	S	78	40	118	0.00001
SRR6145058	Capnocytophaga sp. oral taxon 323	1705617	S	78	45	123	0.00001
SRR6145058	Candidatus Walczuchella monophlebidarum	1415657	S	1	0	1	0.00000
SRR6145058	Candidatus Vesicomyosocius okutanii	412965	S	3	0	3	0.00000
SRR6145058	Candidatus Uzinura diaspidicola	670956	S	1	0	1	0.00000
SRR6145058	Candidatus Thioglobus singularis	1427364	S	2	0	2	0.00000
SRR6145058	Candidatus Thioglobus autotrophicus	1705394	S	2	0	2	0.00000
SRR6145058	Candidatus Thiodictyon syntrophicum	1166950	S	32	0	32	0.00000
SRR6145058	Candidatus Syntrophocurvum alkaliphilum	2293317	S	2	0	2	0.00000
SRR6145058	Candidatus Symbiobacter mobilis	1436290	S	7	0	7	0.00000
SRR6145058	Candidatus Solibacter usitatus	332163	S	18	0	18	0.00000
SRR6145058	Candidatus Sneabacter namystus	2601646	S	1	0	1	0.00000
SRR6145058	Candidatus Saccharimonas aalborgensis	1332188	S	11	0	11	0.00000
SRR6145058	Candidatus Ruthia endofausta	2738852	S	1	0	1	0.00000
SRR6145058	Candidatus Riesia pediculicola	401619	S	1	0	1	0.00000
SRR6145058	Candidatus Rickettsiella viridis	676208	S	1	0	1	0.00000
SRR6145058	Candidatus Rhodoluna planktonica	535712	S	7	0	7	0.00000
SRR6145058	Candidatus Reidiella endopervernicosa	2738883	S	3	0	3	0.00000
SRR6145058	Candidatus Purcelliella pentastirinorum	472834	S	1	0	1	0.00000
SRR6145058	Candidatus Puniceispirillum marinum	767892	S	4	0	4	0.00000
SRR6145058	Candidatus Protochlamydia naegleriophila	389348	S	1	0	1	0.00000
SRR6145058	Candidatus Protochlamydia amoebophila	362787	S	3	0	3	0.00000
SRR6145058	Candidatus Promineofilum breve	1806508	S	16	0	16	0.00000
SRR6145058	Candidatus Prometheoarchaeum syntrophicum	2594042	S	4	0	4	0.00000
SRR6145058	Candidatus Profftella armatura	669502	S	3	0	3	0.00000
SRR6145058	Candidatus Portiera aleyrodidarum	91844	S	2	0	2	0.00000
SRR6145058	Candidatus Planktophila versatilis	1884905	S	4	0	4	0.00000
SRR6145058	Candidatus Planktophila vernalis	1884907	S	3	0	3	0.00000
SRR6145058	Candidatus Planktophila limnetica	573600	S	5	0	5	0.00000
SRR6145058	Candidatus Planktophila lacus	1884913	S	3	0	3	0.00000
SRR6145058	Candidatus Planktophila dulcis	1884914	S	2	0	2	0.00000
SRR6145058	Candidatus Phytoplasma australiense	59748	S	1	0	1	0.00000
SRR6145058	Candidatus Phycorickettsia trachydisci	2115978	S	2	0	2	0.00000
SRR6145058	Candidatus Phaeomarinobacter ectocarpi	1458461	S	13	0	13	0.00000
SRR6145058	Candidatus Pelagibacter ubique	198252	S	4	0	4	0.00000
SRR6145058	Candidatus Paracaedibacter acanthamoebae	91604	S	2	0	2	0.00000
SRR6145058	Candidatus Pantoea carbekii	1235990	S	1	0	1	0.00000
SRR6145058	Candidatus Nucleicultrix amoebiphila	1509244	S	3	0	3	0.00000
SRR6145058	Candidatus Nitrospira inopinata	1715989	S	8	0	8	0.00000
SRR6145058	Candidatus Nitrosotenuis cloacae	1603555	S	8	0	8	0.00000
SRR6145058	Candidatus Nitrosotenuis aquarius	1846278	S	1	0	1	0.00000
SRR6145058	Candidatus Nitrosotalea okcheonensis	1903276	S	1	0	1	0.00000
SRR6145058	Candidatus Nitrosotalea devanaterra	1078905	S	2	0	2	0.00000
SRR6145058	Candidatus Nitrososphaera gargensis	497727	S	1	0	1	0.00000
SRR6145058	Candidatus Nitrosopumilus koreensis	1510466	S	1	0	1	0.00000
SRR6145058	Candidatus Nitrosopelagicus brevis	1410606	S	7	0	7	0.00000
SRR6145058	Candidatus Nitrosoglobus terrae	1630141	S	3	0	3	0.00000
SRR6145058	Candidatus Nitrosocosmicus franklandus	1798806	S	2	0	2	0.00000
SRR6145058	Candidatus Nitrosocosmicus exaquare	1826872	S	5	0	5	0.00000
SRR6145058	Candidatus Nardonella dryophthoridicola	1971485	S	1	0	1	0.00000
SRR6145058	Candidatus Nanopelagicus hibericus	1884915	S	3	0	3	0.00000
SRR6145058	Candidatus Nanopelagicus abundans	1884916	S	2	0	2	0.00000
SRR6145058	Candidatus Moranella endobia	1048758	S	1	0	1	0.00000
SRR6145058	Candidatus Methylospira mobilis	1808979	S	5	0	5	0.00000
SRR6145058	Candidatus Methylopumilus universalis	2588536	S	9	0	9	0.00000
SRR6145058	Candidatus Methylopumilus turicensis	1581680	S	2	0	2	0.00000
SRR6145058	Candidatus Methylopumilus rimovensis	2588535	S	3	0	3	0.00000
SRR6145058	Candidatus Methylopumilus planktonicus	1581557	S	2	0	2	0.00000
SRR6145058	Candidatus Methanomassiliicoccus intestinalis	1406512	S	4	0	4	0.00000
SRR6145058	Candidatus Mancarchaeum acidiphilum	1920749	S	1	0	1	0.00000
SRR6145058	Candidatus Liberibacter asiaticus	34021	S	1	0	1	0.00000
SRR6145058	Candidatus Kuenenia stuttgartiensis	174633	S	7	0	7	0.00000
SRR6145058	Candidatus Koribacter versatilis	658062	S	7	0	7	0.00000
SRR6145058	Candidatus Kinetoplastibacterium sorsogonicusi	1576550	S	1	0	1	0.00000
SRR6145058	Candidatus Kinetoplastibacterium oncopeltii	994696	S	5	0	5	0.00000
SRR6145058	Candidatus Kinetoplastibacterium desouzaii	994692	S	1	0	1	0.00000
SRR6145058	Candidatus Hodgkinia cicadicola	573658	S	2	0	2	0.00000
SRR6145058	Candidatus Hamiltonella defensa	138072	S	5	0	5	0.00000
SRR6145058	Candidatus Gullanella endobia	1070130	S	2	0	2	0.00000
SRR6145058	Candidatus Frankia datiscae	2716812	S	40	0	40	0.00000
SRR6145058	Candidatus Fonsibacter ubiquis	1925548	S	3	0	3	0.00000
SRR6145058	Candidatus Filomicrobium marinum	1608628	S	7	0	7	0.00000
SRR6145058	Candidatus Evansia muelleri	1495769	S	2	0	2	0.00000
SRR6145058	Candidatus Erwinia haradaeae	1922217	S	7	0	7	0.00000
SRR6145058	Candidatus Enterovibrio luxaltus	1927128	S	1	0	1	0.00000
SRR6145058	Candidatus Endolissoclinum faulkneri	1263979	S	2	0	2	0.00000
SRR6145058	Candidatus Doolittlea endobia	1778262	S	2	0	2	0.00000
SRR6145058	Candidatus Desulforudis audaxviator	471827	S	3	0	3	0.00000
SRR6145058	Candidatus Desulfofervidus auxilii	1621989	S	1	0	1	0.00000
SRR6145058	Candidatus Deianiraea vastatrix	2163644	S	2	0	2	0.00000
SRR6145058	Candidatus Cytomitobacter indipagum	2601575	S	1	0	1	0.00000
SRR6145058	Candidatus Cyclonatronum proteinivorum	1457365	S	4	0	4	0.00000
SRR6145058	Candidatus Cloacimonas acidaminovorans	456827	S	2	0	2	0.00000
SRR6145058	Candidatus Cardinium hertigii	247481	S	1	0	1	0.00000
SRR6145058	Candidatus Blochmannia vafer	251535	S	1	0	1	0.00000
SRR6145058	Candidatus Blochmannia chromaiodes	251542	S	1	0	1	0.00000
SRR6145058	Candidatus Bipolaricaulis anaerobius	2026885	S	2	0	2	0.00000
SRR6145058	Candidatus Baumannia cicadellinicola	186490	S	4	0	4	0.00000
SRR6145058	Candidatus Azobacteroides pseudotrichonymphae	511435	S	4	0	4	0.00000
SRR6145058	Candidatus Atelocyanobacterium thalassa	713887	S	1	0	1	0.00000
SRR6145058	Candidatus Arsenophonus lipoptenae	634113	S	1	0	1	0.00000
SRR6145058	Candidatus Amoebophilus asiaticus	281120	S	2	0	2	0.00000
SRR6145058	Candidatus Accumulibacter phosphatis	327160	S	36	0	36	0.00000
SRR6145058	Campylobacter subantarcticus	497724	S	2	-2	0	0.00000
SRR6145058	Campylobacter sp. RM6914	1032243	S	2	0	2	0.00000
SRR6145058	Campylobacter sp. RM6137	1660073	S	2	0	2	0.00000
SRR6145058	Campylobacter sp. RM16192	1660080	S	4	0	4	0.00000
SRR6145058	Campylobacter sp. RM12175	1660076	S	2	0	2	0.00000
SRR6145058	Caloramator sp. E03	2576307	S	3	0	3	0.00000
SRR6145058	Buttiauxella sp. 3AFRM03	2479367	S	7	0	7	0.00000
SRR6145058	Burkholderiales bacterium YL45	1834205	S	2	0	2	0.00000
SRR6145058	Burkholderiales bacterium GJ-E10	1469502	S	23	0	23	0.00000
SRR6145058	Burkholderia virus BcepNY3	446807	S	1	0	1	0.00000
SRR6145058	Burkholderia virus Bcep1	244310	S	1	0	1	0.00000
SRR6145058	Burkholderia sp. DHOD12	2571746	S	28	0	28	0.00000
SRR6145058	Bubaline alphaherpesvirus 1	202910	S	1	0	1	0.00000
SRR6145058	Brucella sp. 2280	2592625	S	1	0	1	0.00000
SRR6145058	Brucella sp. 141012304	1885919	S	1	0	1	0.00000
SRR6145058	Bradymonadales bacterium V1718	2600177	S	3	0	3	0.00000
SRR6145058	Brachyspira pilosicoli	52584	S	6	-6	0	0.00000
SRR6145058	Boseongicola sp. CCM32	2552942	S	17	0	17	0.00000
SRR6145058	Borreliella valaisiana	62088	S	1	-1	0	0.00000
SRR6145058	Bordetella virus PHB04	2734129	S	1	0	1	0.00000
SRR6145058	Bordetella sp. HZ20	2163011	S	4	0	4	0.00000
SRR6145058	Blochmannia endosymbiont of Camponotus nipponensis	2681986	S	1	0	1	0.00000
SRR6145058	Blautia sp. N6H1-15	1912897	S	2	0	2	0.00000
SRR6145058	Blattabacterium sp. DPU	2715232	S	1	0	1	0.00000
SRR6145058	Bifidobacterium asteroides	1684	S	18	-18	0	0.00000
SRR6145058	Bathymodiolus thermophilus thioautotrophic gill symbiont	2360	S	1	0	1	0.00000
SRR6145058	Bathymodiolus septemdierum thioautotrophic gill symbiont	113267	S	1	0	1	0.00000
SRR6145058	Bathycoccus sp. RCC1105 virus BpV	933845	S	1	0	1	0.00000
SRR6145058	Bat mastadenovirus G	2015376	S	1	0	1	0.00000
SRR6145058	Bat Hp-betacoronavirus Zhejiang2013	2501961	S	1	0	1	0.00000
SRR6145058	Bartonella sp. WD16.2	1933904	S	1	0	1	0.00000
SRR6145058	Bacteroides sp. CBA7301	2715212	S	9	0	9	0.00000
SRR6145058	Bacteroidales bacterium CF	1400053	S	3	0	3	0.00000
SRR6145058	Bacteroidales bacterium 38-H	2590900	S	6	0	6	0.00000
SRR6145058	Bacillus sp. Y1	352858	S	3	0	3	0.00000
SRR6145058	Bacillus sp. X1(2014)	1565991	S	4	0	4	0.00000
SRR6145058	Bacillus sp. THAF10	2587848	S	6	0	6	0.00000
SRR6145058	Bacillus sp. SYJ	2529386	S	1	0	1	0.00000
SRR6145058	Bacillus sp. SPB7	2715209	S	1	0	1	0.00000
SRR6145058	Bacillus sp. SB49	1071080	S	3	0	3	0.00000
SRR6145058	Bacillus sp. S3	486398	S	2	0	2	0.00000
SRR6145058	Bacillus sp. OxB-1	98228	S	3	0	3	0.00000
SRR6145058	Bacillus sp. NSP9.1	1071078	S	1	0	1	0.00000
SRR6145058	Bacillus sp. N1-1	2682541	S	3	0	3	0.00000
SRR6145058	Bacillus sp. KH172YL63	2709784	S	3	0	3	0.00000
SRR6145058	Bacillus sp. FJAT-45348	2011012	S	1	0	1	0.00000
SRR6145058	Bacillus sp. FJAT-42376	2014076	S	4	0	4	0.00000
SRR6145058	Bacillus sp. FJAT-25496	1742359	S	3	0	3	0.00000
SRR6145058	Bacillus sp. FJAT-22090	1581038	S	9	0	9	0.00000
SRR6145058	Bacillus sp. FJAT-18017	1705566	S	2	0	2	0.00000
SRR6145058	Bacillus sp. DSL-17	2567941	S	6	0	6	0.00000
SRR6145058	Bacillus sp. Cs-700	2589818	S	2	0	2	0.00000
SRR6145058	Bacillus sp. 1NLA3E	666686	S	6	0	6	0.00000
SRR6145058	Bacillus phage vB_BanS-Tsamsa	1308863	S	1	0	1	0.00000
SRR6145058	Bacillus phage SalinJah	1837830	S	1	0	1	0.00000
SRR6145058	Bacillaceae bacterium TKL69	2594883	S	3	0	3	0.00000
SRR6145058	Azotobacter vinelandii	354	S	14	-14	0	0.00000
SRR6145058	Azoarcus sp. M9-3-2	2016596	S	22	0	22	0.00000
SRR6145058	Azoarcus sp. KH32C	748247	S	22	0	22	0.00000
SRR6145058	Auritidibacter sp. NML130574	2170745	S	53	0	53	0.00001
SRR6145058	Aureococcus anophagefferens virus	1474867	S	1	0	1	0.00000
SRR6145058	Aureitalea sp. RR4-38	2094025	S	3	0	3	0.00000
SRR6145058	Aurantimicrobium sp. MWH-Uga1	2079575	S	10	0	10	0.00000
SRR6145058	Aurantimicrobium sp. MWH-Mo1	1987356	S	12	0	12	0.00000
SRR6145058	Ateline alphaherpesvirus 1	35243	S	1	0	1	0.00000
SRR6145058	Artogeia rapae granulovirus	362830	S	1	0	1	0.00000
SRR6145058	Arthrobacter virus Maja	2734249	S	1	0	1	0.00000
SRR6145058	Arthrobacter virus Laroye	1982087	S	1	0	1	0.00000
SRR6145058	Arthrobacter virus Brent	1980948	S	1	0	1	0.00000
SRR6145058	Arsenophonus endosymbiont of Aleurodicus dispersus	235559	S	1	0	1	0.00000
SRR6145058	Arsenicicoccus sp. oral taxon 190	1658671	S	221	14	235	0.00003
SRR6145058	Arcanobacterium sp. 2701	2722751	S	9	0	9	0.00000
SRR6145058	Arachidicoccus sp. KIS59-12	2341117	S	14	0	14	0.00000
SRR6145058	Arachidicoccus sp. BS20	1850526	S	11	0	11	0.00000
SRR6145058	Arachidicoccus sp. B3-10	2545455	S	13	0	13	0.00000
SRR6145058	Aquimarina sp. BL5	1714860	S	9	0	9	0.00000
SRR6145058	Aquimarina sp. AD10	1714849	S	11	0	11	0.00000
SRR6145058	Aquimarina sp. AD1	1714848	S	6	0	6	0.00000
SRR6145058	Aquiluna sp. 15G-AUS-rot	2499157	S	2	0	2	0.00000
SRR6145058	Aquaspirillum sp. LM1	1938604	S	14	0	14	0.00000
SRR6145058	Apibacter sp. HY041	2500547	S	6	0	6	0.00000
SRR6145058	Aneurinibacillus sp. XH2	1450761	S	2	0	2	0.00000
SRR6145058	Anaeromyxobacter sp. Fw109-5	404589	S	48	0	48	0.00001
SRR6145058	Anaerolineaceae bacterium oral taxon 439	1889813	S	9	0	9	0.00000
SRR6145058	Anaerocolumna sp. CBA3638	2696063	S	2	0	2	0.00000
SRR6145058	Amycolatopsis mediterranei	33910	S	103	-103	0	0.00000
SRR6145058	Aminipila sp. CBA3637	2697030	S	5	0	5	0.00000
SRR6145058	Alteromonas sp. RKMC-009	2267264	S	8	0	8	0.00000
SRR6145058	Alteromonas sp. I4	2652380	S	3	0	3	0.00000
SRR6145058	Alteromonas sp. BL110	1714845	S	5	0	5	0.00000
SRR6145058	Alteromonas sp. 76-1	2358187	S	2	0	2	0.00000
SRR6145058	Altererythrobacter sp. ZODW24	2185142	S	22	0	22	0.00000
SRR6145058	Alloprevotella sp. E39	2133944	S	26	0	26	0.00000
SRR6145058	Alistipes sp. dk3624	2662363	S	9	0	9	0.00000
SRR6145058	Alcaligenaceae bacterium SJ-26	2593958	S	19	0	19	0.00000
SRR6145058	Aeromonas sp. CU5	2033033	S	6	0	6	0.00000
SRR6145058	Aeromonas sp. CA23	2033032	S	5	0	5	0.00000
SRR6145058	Aequorivita sp. H23M31	2494375	S	3	0	3	0.00000
SRR6145058	Actinomyces virus Av1	338473	S	3	0	3	0.00000
SRR6145058	Actinomyces sp. oral taxon 897	2081702	S	641	22	663	0.00007
SRR6145058	Actinomyces sp. oral taxon 848	649739	S	286	1	287	0.00003
SRR6145058	Actinomyces sp. oral taxon 414	712122	S	2573	129	2702	0.00030
SRR6145058	Actinomyces sp. oral taxon 171	706438	S	4429	490	4919	0.00054
SRR6145058	Actinobaculum sp. 313	2495645	S	20	0	20	0.00000
SRR6145058	Actinobacteria bacterium IMCC26256	1650658	S	2	0	2	0.00000
SRR6145058	Actinobacteria bacterium IMCC26103	1848756	S	6	0	6	0.00000
SRR6145058	Actinobacteria bacterium IMCC26077	1848755	S	5	0	5	0.00000
SRR6145058	Actinobacteria bacterium IMCC25003	1848255	S	1	0	1	0.00000
SRR6145058	Acinetobacter virus ME3	2560269	S	12	0	12	0.00000
SRR6145058	Acinetobacter virus AP22	1915209	S	2	0	2	0.00000
SRR6145058	Acinetobacter sp. TGL-Y2	1407071	S	23	0	23	0.00000
SRR6145058	Acinetobacter sp. Marseille-Q1620	2714110	S	18	0	18	0.00000
SRR6145058	Acinetobacter sp. 323-1	2715164	S	16	0	16	0.00000
SRR6145058	Acinetobacter sp. 185	2715163	S	15	0	15	0.00000
SRR6145058	Acinetobacter phage ZZ1	1049283	S	1	0	1	0.00000
SRR6145058	Acinetobacter phage YMC13/03/R2096	1560342	S	1	0	1	0.00000
SRR6145058	Acinetobacter phage Acj61	760732	S	1	0	1	0.00000
SRR6145058	Acidiferrobacter sp. SPIII_3	1281578	S	8	0	8	0.00000
SRR6145058	Achromobacter virus Axp3	2169962	S	1	0	1	0.00000
SRR6145058	Acetobacterium sp. KB-1	2184575	S	2	0	2	0.00000
SRR6145058	Acanthocystis turfacea chlorella virus 1	322019	S	1	0	1	0.00000
SRR6145058	Bacillus virus BCP78	1985182	S	1	-1	0	0.00000
SRR6145058	Candidatus Kinetoplastibacterium crithidii	33056	S	3	-3	0	0.00000
