sample	name	taxonomy_id	taxonomy_lvl	kraken_assigned_reads	added_reads	new_est_reads	fraction_total_reads
SRR6145058	Candidatus Nanopelagicaceae	2162846	F	23	1	24	0.00000
SRR6145058	Candidatus Brocadiaceae	1127830	F	7	0	7	0.00000
SRR6145058	Candidatus Paracaedibacteraceae	1777752	F	2	0	2	0.00000
SRR6145058	Candidatus Deianiraeaceae	2603433	F	2	0	2	0.00000
SRR6145058	Candidatus Desulfofervidaceae	1902584	F	1	0	1	0.00000
SRR6145058	Hominidae	9604	F	7868181	4955	7873136	0.86056
SRR6145058	Propionibacteriaceae	31957	F	492884	4849	497733	0.05440
SRR6145058	Staphylococcaceae	90964	F	94213	25306	119519	0.01306
SRR6145058	Moraxellaceae	468	F	65573	2608	68181	0.00745
SRR6145058	Micrococcaceae	1268	F	61939	2927	64866	0.00709
SRR6145058	Streptococcaceae	1300	F	53258	3211	56469	0.00617
SRR6145058	Corynebacteriaceae	1653	F	46135	1032	47167	0.00516
SRR6145058	Actinomycetaceae	2049	F	33786	813	34599	0.00378
SRR6145058	Flavobacteriaceae	49546	F	18980	192	19172	0.00210
SRR6145058	Rhodobacteraceae	31989	F	17791	1280	19071	0.00208
SRR6145058	Burkholderiaceae	119060	F	18243	634	18877	0.00206
SRR6145058	Neisseriaceae	481	F	16500	836	17336	0.00189
SRR6145058	Mycobacteriaceae	1762	F	14822	161	14983	0.00164
SRR6145058	Gordoniaceae	85026	F	12694	536	13230	0.00145
SRR6145058	Pseudomonadaceae	135621	F	11969	602	12571	0.00137
SRR6145058	Sphingomonadaceae	41297	F	11653	720	12373	0.00135
SRR6145058	Xanthomonadaceae	32033	F	10734	328	11062	0.00121
SRR6145058	Siphoviridae	10699	F	3697	7299	10996	0.00120
SRR6145058	Comamonadaceae	80864	F	7423	3496	10919	0.00119
SRR6145058	Tsukamurellaceae	85028	F	9649	358	10007	0.00109
SRR6145058	Caulobacteraceae	76892	F	9557	416	9973	0.00109
SRR6145058	Microbacteriaceae	85023	F	9593	286	9879	0.00108
SRR6145058	Pasteurellaceae	712	F	9472	347	9819	0.00107
SRR6145058	Dermacoccaceae	145357	F	9235	471	9706	0.00106
SRR6145058	Bradyrhizobiaceae	41294	F	8762	426	9188	0.00100
SRR6145058	Enterobacteriaceae	543	F	6409	2694	9103	0.00099
SRR6145058	Dietziaceae	85029	F	8042	840	8882	0.00097
SRR6145058	Nocardiaceae	85025	F	6995	1618	8613	0.00094
SRR6145058	Intrasporangiaceae	85021	F	8377	263	8640	0.00094
SRR6145058	Streptomycetaceae	2062	F	8427	98	8525	0.00093
SRR6145058	Deinococcaceae	183710	F	7276	11	7287	0.00080
SRR6145058	Methylobacteriaceae	119045	F	5556	310	5866	0.00064
SRR6145058	Prevotellaceae	171552	F	5591	135	5726	0.00063
SRR6145058	Veillonellaceae	31977	F	5660	13	5673	0.00062
SRR6145058	Peptoniphilaceae	1570339	F	4403	314	4717	0.00052
SRR6145058	Rhizobiaceae	82115	F	3551	439	3990	0.00044
SRR6145058	Nocardioidaceae	85015	F	3997	68	4065	0.00044
SRR6145058	Halomonadaceae	28256	F	3899	63	3962	0.00043
SRR6145058	Leptotrichiaceae	1129771	F	3661	23	3684	0.00040
SRR6145058	Acetobacteraceae	433	F	3256	331	3587	0.00039
SRR6145058	Brevibacteriaceae	85019	F	3327	118	3445	0.00038
SRR6145058	Yersiniaceae	1903411	F	2990	230	3220	0.00035
SRR6145058	Pseudonocardiaceae	2070	F	3185	-63	3122	0.00034
SRR6145058	Sphingobacteriaceae	84566	F	2987	75	3062	0.00033
SRR6145058	Fusobacteriaceae	203492	F	2700	13	2713	0.00030
SRR6145058	Dermabacteraceae	85020	F	2576	64	2640	0.00029
SRR6145058	Oxalobacteraceae	75682	F	2065	85	2150	0.00024
SRR6145058	Micromonosporaceae	28056	F	2087	25	2112	0.00023
SRR6145058	Alcaligenaceae	506	F	1557	469	2026	0.00022
SRR6145058	Rhodospirillaceae	41295	F	1570	352	1922	0.00021
SRR6145058	Lactobacillaceae	33958	F	1673	130	1803	0.00020
SRR6145058	Carnobacteriaceae	186828	F	1798	27	1825	0.00020
SRR6145058	Bacillaceae	186817	F	1717	94	1811	0.00020
SRR6145058	Erythrobacteraceae	335929	F	1532	157	1689	0.00018
SRR6145058	Phyllobacteriaceae	69277	F	1391	80	1471	0.00016
SRR6145058	Aerococcaceae	186827	F	1362	45	1407	0.00015
SRR6145058	Porphyromonadaceae	171551	F	1034	61	1095	0.00012
SRR6145058	Bifidobacteriaceae	31953	F	1061	-8	1053	0.00012
SRR6145058	Erwiniaceae	1903409	F	899	67	966	0.00011
SRR6145058	Campylobacteraceae	72294	F	1012	3	1015	0.00011
SRR6145058	Aeromonadaceae	84642	F	938	104	1042	0.00011
SRR6145058	Tannerellaceae	2005525	F	843	29	872	0.00010
SRR6145058	Isosphaeraceae	1763524	F	120	674	794	0.00009
SRR6145058	Cellulomonadaceae	85016	F	794	27	821	0.00009
SRR6145058	Xanthobacteraceae	335928	F	680	65	745	0.00008
SRR6145058	Spirochaetaceae	137	F	623	2	625	0.00007
SRR6145058	Promicromonosporaceae	85017	F	597	19	616	0.00007
SRR6145058	Leuconostocaceae	81850	F	593	17	610	0.00007
SRR6145058	Geodermatophilaceae	85030	F	639	14	653	0.00007
SRR6145058	Clostridiaceae	31979	F	651	18	669	0.00007
SRR6145058	Zoogloeaceae	2008794	F	497	66	563	0.00006
SRR6145058	Sporichthyaceae	85033	F	528	5	533	0.00006
SRR6145058	Selenomonadaceae	1843491	F	530	1	531	0.00006
SRR6145058	Rhodanobacteraceae	1775411	F	520	25	545	0.00006
SRR6145058	Lachnospiraceae	186803	F	496	23	519	0.00006
SRR6145058	Hyphomicrobiaceae	45401	F	565	23	588	0.00006
SRR6145058	Cardiobacteriaceae	868	F	520	11	531	0.00006
SRR6145058	Polyangiaceae	49	F	347	96	443	0.00005
SRR6145058	Peptostreptococcaceae	186804	F	440	46	486	0.00005
SRR6145058	Paenibacillaceae	186822	F	452	15	467	0.00005
SRR6145058	Nakamurellaceae	85031	F	419	7	426	0.00005
SRR6145058	Hymenobacteraceae	1853232	F	443	3	446	0.00005
SRR6145058	Frankiaceae	74712	F	378	40	418	0.00005
SRR6145058	Beijerinckiaceae	45404	F	204	211	415	0.00005
SRR6145058	Bacteroidaceae	815	F	426	27	453	0.00005
SRR6145058	Atopobiaceae	1643824	F	467	1	468	0.00005
SRR6145058	Thermomonosporaceae	2012	F	388	12	400	0.00004
SRR6145058	Streptosporangiaceae	2004	F	372	8	380	0.00004
SRR6145058	Myxococcaceae	31	F	322	9	331	0.00004
SRR6145058	Morganellaceae	1903414	F	283	82	365	0.00004
SRR6145058	Enterococcaceae	81852	F	373	21	394	0.00004
SRR6145058	Chromobacteriaceae	1499392	F	347	12	359	0.00004
SRR6145058	Cellvibrionaceae	1706371	F	396	1	397	0.00004
SRR6145058	Calotrichaceae	2661849	F	367	4	371	0.00004
SRR6145058	Brachyspiraceae	143786	F	21	359	380	0.00004
SRR6145058	Vibrionaceae	641	F	283	5	288	0.00003
SRR6145058	Rubrobacteraceae	84997	F	246	0	246	0.00003
SRR6145058	Pectobacteriaceae	1903410	F	244	6	250	0.00003
SRR6145058	Nocardiopsaceae	83676	F	290	6	296	0.00003
SRR6145058	Cytophagaceae	89373	F	308	2	310	0.00003
SRR6145058	Chromatiaceae	1046	F	263	2	265	0.00003
SRR6145058	Chitinophagaceae	563835	F	252	0	252	0.00003
SRR6145058	Bogoriellaceae	145358	F	254	6	260	0.00003
SRR6145058	Beutenbergiaceae	125316	F	265	11	276	0.00003
SRR6145058	Alteromonadaceae	72275	F	267	6	273	0.00003
SRR6145058	Thermaceae	188786	F	156	0	156	0.00002
SRR6145058	Synechococcaceae	1890426	F	144	4	148	0.00002
SRR6145058	Sterolibacteriaceae	2008793	F	135	76	211	0.00002
SRR6145058	Shewanellaceae	267890	F	208	13	221	0.00002
SRR6145058	Ruminococcaceae	541000	F	142	22	164	0.00002
SRR6145058	Ruaniaceae	1331736	F	119	61	180	0.00002
SRR6145058	Rickettsiaceae	775	F	169	-1	168	0.00002
SRR6145058	Rhodocyclaceae	75787	F	168	35	203	0.00002
SRR6145058	Planococcaceae	186818	F	139	2	141	0.00002
SRR6145058	Planctomycetaceae	126	F	189	35	224	0.00002
SRR6145058	Papillomaviridae	151340	F	196	-14	182	0.00002
SRR6145058	Nostocaceae	1162	F	161	54	215	0.00002
SRR6145058	Natrialbaceae	1644061	F	204	2	206	0.00002
SRR6145058	Myoviridae	10662	F	118	58	176	0.00002
SRR6145058	Methylocystaceae	31993	F	188	8	196	0.00002
SRR6145058	Methylococcaceae	403	F	92	89	181	0.00002
SRR6145058	Jiangellaceae	1217100	F	214	3	217	0.00002
SRR6145058	Gottschalkiaceae	2042895	F	4	137	141	0.00002
SRR6145058	Gemmataceae	1914233	F	222	0	222	0.00002
SRR6145058	Ectothiorhodospiraceae	72276	F	220	3	223	0.00002
SRR6145058	Desulfovibrionaceae	194924	F	180	2	182	0.00002
SRR6145058	Dermatophilaceae	85018	F	165	1	166	0.00002
SRR6145058	Chelatococcaceae	2036754	F	150	16	166	0.00002
SRR6145058	Brucellaceae	118882	F	144	36	180	0.00002
SRR6145058	Aurantimonadaceae	255475	F	156	15	171	0.00002
SRR6145058	Archangiaceae	39	F	187	5	192	0.00002
SRR6145058	Anaeromyxobacteraceae	1524215	F	137	1	138	0.00002
SRR6145058	Vicinamibacteraceae	2211325	F	37	11	48	0.00001
SRR6145058	Verrucomicrobiaceae	203557	F	65	0	65	0.00001
SRR6145058	Thiobacillaceae	2008790	F	41	75	116	0.00001
SRR6145058	Sinobacteraceae	568386	F	87	1	88	0.00001
SRR6145058	Scytonemataceae	1182	F	99	-26	73	0.00001
SRR6145058	Sanguibacteraceae	145360	F	132	4	136	0.00001
SRR6145058	Sandaracinaceae	1055686	F	70	0	70	0.00001
SRR6145058	Rikenellaceae	171550	F	87	5	92	0.00001
SRR6145058	Rhodothermaceae	563843	F	78	0	78	0.00001
SRR6145058	Rhodobiaceae	119043	F	74	11	85	0.00001
SRR6145058	Pseudoalteromonadaceae	267888	F	131	4	135	0.00001
SRR6145058	Piscirickettsiaceae	135616	F	64	1	65	0.00001
SRR6145058	Pirellulaceae	2691357	F	55	0	55	0.00001
SRR6145058	Peptococcaceae	186807	F	56	0	56	0.00001
SRR6145058	Opitutaceae	134623	F	116	1	117	0.00001
SRR6145058	Oceanospirillaceae	135620	F	61	0	61	0.00001
SRR6145058	Nitrosomonadaceae	206379	F	47	1	48	0.00001
SRR6145058	Nannocystaceae	224463	F	60	0	60	0.00001
SRR6145058	Mycoplasmataceae	2092	F	117	1	118	0.00001
SRR6145058	Microviridae	10841	F	27	28	55	0.00001
SRR6145058	Microcoleaceae	1892252	F	60	2	62	0.00001
SRR6145058	Microbulbiferaceae	1706373	F	54	0	54	0.00001
SRR6145058	Methylophilaceae	32011	F	46	0	46	0.00001
SRR6145058	Listeriaceae	186820	F	110	4	114	0.00001
SRR6145058	Legionellaceae	444	F	95	0	95	0.00001
SRR6145058	Lacipirellulaceae	2691359	F	63	0	63	0.00001
SRR6145058	Labilitrichaceae	1524216	F	56	0	56	0.00001
SRR6145058	Kofleriaceae	224464	F	50	0	50	0.00001
SRR6145058	Kineosporiaceae	83778	F	90	2	92	0.00001
SRR6145058	Iamiaceae	633392	F	61	0	61	0.00001
SRR6145058	Hyphomonadaceae	69657	F	89	0	89	0.00001
SRR6145058	Hydrogenophilaceae	206349	F	71	1	72	0.00001
SRR6145058	Hungateiclostridiaceae	2304686	F	46	2	48	0.00001
SRR6145058	Herelleviridae	2560065	F	79	-1	78	0.00001
SRR6145058	Helicobacteraceae	72293	F	70	5	75	0.00001
SRR6145058	Hapalosiphonaceae	1892263	F	25	25	50	0.00001
SRR6145058	Halorubraceae	1963271	F	108	28	136	0.00001
SRR6145058	Haloferacaceae	1644056	F	124	2	126	0.00001
SRR6145058	Halobacteriaceae	2236	F	100	11	111	0.00001
SRR6145058	Haloarculaceae	1963268	F	93	18	111	0.00001
SRR6145058	Halieaceae	1706372	F	58	1	59	0.00001
SRR6145058	Hafniaceae	1903412	F	42	45	87	0.00001
SRR6145058	Glycomycetaceae	85034	F	49	83	132	0.00001
SRR6145058	Geobacteraceae	213422	F	128	2	130	0.00001
SRR6145058	Gemmatimonadaceae	219687	F	134	0	134	0.00001
SRR6145058	Gallionellaceae	90627	F	60	2	62	0.00001
SRR6145058	Flammeovirgaceae	200667	F	35	18	53	0.00001
SRR6145058	Euzebyaceae	908622	F	46	0	46	0.00001
SRR6145058	Eubacteriaceae	186806	F	27	30	57	0.00001
SRR6145058	Erysipelotrichaceae	128827	F	71	21	92	0.00001
SRR6145058	Egicoccaceae	1755824	F	53	0	53	0.00001
SRR6145058	Eggerthellaceae	1643826	F	95	0	95	0.00001
SRR6145058	Desulfuromonadaceae	213421	F	50	1	51	0.00001
SRR6145058	Desulfobacteraceae	213119	F	61	0	61	0.00001
SRR6145058	Cyclobacteriaceae	563798	F	62	1	63	0.00001
SRR6145058	Conexibacteraceae	320583	F	134	1	135	0.00001
SRR6145058	Cohaesibacteraceae	655351	F	66	2	68	0.00001
SRR6145058	Chroococcidiopsidaceae	1890528	F	124	6	130	0.00001
SRR6145058	Catenulisporaceae	414877	F	69	0	69	0.00001
SRR6145058	Bdellovibrionaceae	213483	F	51	0	51	0.00001
SRR6145058	Baekduiaceae	2600303	F	98	0	98	0.00001
SRR6145058	Alcanivoracaceae	224372	F	100	3	103	0.00001
SRR6145058	Acidobacteriaceae	204434	F	79	0	79	0.00001
SRR6145058	Woeseiaceae	1738654	F	4	0	4	0.00000
SRR6145058	Wenzhouxiangellaceae	1676141	F	19	15	34	0.00000
SRR6145058	Vulgatibacteraceae	1524213	F	24	0	24	0.00000
SRR6145058	Vallitaleaceae	2603322	F	1	0	1	0.00000
SRR6145058	Trueperaceae	332247	F	34	0	34	0.00000
SRR6145058	Tospoviridae	1980419	F	1	0	1	0.00000
SRR6145058	Tolypothrichaceae	119859	F	6	3	9	0.00000
SRR6145058	Tissierellaceae	1737406	F	12	0	12	0.00000
SRR6145058	Thiotrichaceae	135617	F	5	0	5	0.00000
SRR6145058	Thioalkalispiraceae	1096778	F	10	1	11	0.00000
SRR6145058	Thioalkalibacteraceae	2035710	F	10	0	10	0.00000
SRR6145058	Thermotogaceae	188709	F	4	-2	2	0.00000
SRR6145058	Thermoproteaceae	2267	F	18	0	18	0.00000
SRR6145058	Thermoplasmataceae	46659	F	2	0	2	0.00000
SRR6145058	Thermomicrobiaceae	189777	F	5	0	5	0.00000
SRR6145058	Thermoguttaceae	2691358	F	3	0	3	0.00000
SRR6145058	Thermofilaceae	114378	F	3	0	3	0.00000
SRR6145058	Thermodesulfobiaceae	227387	F	3	2	5	0.00000
SRR6145058	Thermodesulfobacteriaceae	188711	F	9	0	9	0.00000
SRR6145058	Thermococcaceae	2259	F	28	3	31	0.00000
SRR6145058	Thermoanaerobacterales Family IV. Incertae Sedis	543372	F	8	0	8	0.00000
SRR6145058	Thermoanaerobacterales Family III. Incertae Sedis	543371	F	38	0	38	0.00000
SRR6145058	Thermoanaerobacteraceae	186814	F	36	0	36	0.00000
SRR6145058	Thermoactinomycetaceae	186824	F	18	0	18	0.00000
SRR6145058	Tepidiformaceae	2682227	F	17	0	17	0.00000
SRR6145058	Syntrophomonadaceae	68298	F	4	0	4	0.00000
SRR6145058	Syntrophobacteraceae	213465	F	17	0	17	0.00000
SRR6145058	Syntrophaceae	213468	F	9	0	9	0.00000
SRR6145058	Synergistaceae	649777	F	28	0	28	0.00000
SRR6145058	Symbiobacteriaceae	543349	F	14	0	14	0.00000
SRR6145058	Sutterellaceae	995019	F	8	0	8	0.00000
SRR6145058	Sulfolobaceae	118883	F	20	0	20	0.00000
SRR6145058	Succinivibrionaceae	83763	F	1	0	1	0.00000
SRR6145058	Steroidobacteraceae	2689614	F	20	1	21	0.00000
SRR6145058	Sporomusaceae	1843490	F	19	0	19	0.00000
SRR6145058	Sporolactobacillaceae	186821	F	8	0	8	0.00000
SRR6145058	Spongiibacteraceae	1706375	F	17	0	17	0.00000
SRR6145058	Spiroplasmataceae	2131	F	38	2	40	0.00000
SRR6145058	Sphaerolipoviridae	1714267	F	1	0	1	0.00000
SRR6145058	Sphaerobacteraceae	85002	F	22	0	22	0.00000
SRR6145058	Solibacteraceae	332161	F	18	0	18	0.00000
SRR6145058	Solemoviridae	2169577	F	1	0	1	0.00000
SRR6145058	Simkaniaceae	92712	F	1	0	1	0.00000
SRR6145058	Silvanigrellaceae	2024974	F	4	2	6	0.00000
SRR6145058	Segniliparaceae	316606	F	30	0	30	0.00000
SRR6145058	Sedimentisphaeraceae	2483367	F	11	2	13	0.00000
SRR6145058	Saprospiraceae	89374	F	6	0	6	0.00000
SRR6145058	Salinivirgaceae	1970190	F	8	0	8	0.00000
SRR6145058	Salinisphaeraceae	742031	F	17	0	17	0.00000
SRR6145058	Saccharospirillaceae	255527	F	14	0	14	0.00000
SRR6145058	Roseiflexaceae	1508635	F	18	0	18	0.00000
SRR6145058	Rivulariaceae	1185	F	12	0	12	0.00000
SRR6145058	Retroviridae	11632	F	6	0	6	0.00000
SRR6145058	Reoviridae	10880	F	1	0	1	0.00000
SRR6145058	Pyrodictiaceae	2307	F	1	0	1	0.00000
SRR6145058	Puniceicoccaceae	415002	F	3	0	3	0.00000
SRR6145058	Psychromonadaceae	267894	F	5	0	5	0.00000
SRR6145058	Pseudanabaenaceae	1890436	F	8	0	8	0.00000
SRR6145058	Prolixibacteraceae	1471398	F	20	0	20	0.00000
SRR6145058	Prochlorotrichaceae	2303730	F	4	0	4	0.00000
SRR6145058	Prochloraceae	1213	F	29	0	29	0.00000
SRR6145058	Poxviridae	10240	F	10	0	10	0.00000
SRR6145058	Potyviridae	39729	F	1	0	1	0.00000
SRR6145058	Polyomaviridae	151341	F	12	0	12	0.00000
SRR6145058	Podoviridae	10744	F	41	-5	36	0.00000
SRR6145058	Picrophilaceae	46630	F	1	0	1	0.00000
SRR6145058	Phycodnaviridae	10501	F	7	0	7	0.00000
SRR6145058	Phycisphaeraceae	666507	F	26	0	26	0.00000
SRR6145058	Petrotogaceae	1643949	F	15	0	15	0.00000
SRR6145058	Pelagibacteraceae	1655514	F	30	3	33	0.00000
SRR6145058	Parvularculaceae	255474	F	14	0	14	0.00000
SRR6145058	Parachlamydiaceae	92713	F	11	0	11	0.00000
SRR6145058	Paludibacteraceae	2005523	F	7	0	7	0.00000
SRR6145058	Oscillospiraceae	216572	F	18	2	20	0.00000
SRR6145058	Oscillatoriaceae	1892254	F	28	1	29	0.00000
SRR6145058	Orbaceae	1240483	F	24	0	24	0.00000
SRR6145058	Oleiphilaceae	191033	F	6	0	6	0.00000
SRR6145058	Odoribacteraceae	1853231	F	20	17	37	0.00000
SRR6145058	Oculatellaceae	2303507	F	4	1	5	0.00000
SRR6145058	Nudiviridae	1511852	F	3	0	3	0.00000
SRR6145058	Nitrospiraceae	189779	F	43	0	43	0.00000
SRR6145058	Nitrososphaeraceae	1033997	F	10	0	10	0.00000
SRR6145058	Nitrosopumilaceae	338190	F	8	6	14	0.00000
SRR6145058	Nimaviridae	196937	F	2	0	2	0.00000
SRR6145058	Nautiliaceae	224467	F	10	2	12	0.00000
SRR6145058	Natranaerobiaceae	485255	F	3	0	3	0.00000
SRR6145058	Muribaculaceae	2005473	F	38	-8	30	0.00000
SRR6145058	Moritellaceae	267891	F	7	0	7	0.00000
SRR6145058	Mimiviridae	549779	F	4	0	4	0.00000
SRR6145058	Microcystaceae	1890449	F	21	2	23	0.00000
SRR6145058	Methylacidiphilaceae	717964	F	4	0	4	0.00000
SRR6145058	Methanotrichaceae	143067	F	2	0	2	0.00000
SRR6145058	Methanospirillaceae	196137	F	3	0	3	0.00000
SRR6145058	Methanosarcinaceae	2206	F	44	-1	43	0.00000
SRR6145058	Methanoregulaceae	1198451	F	5	0	5	0.00000
SRR6145058	Methanopyraceae	183713	F	1	0	1	0.00000
SRR6145058	Methanomicrobiaceae	2194	F	12	0	12	0.00000
SRR6145058	Methanomassiliicoccaceae	1577788	F	5	2	7	0.00000
SRR6145058	Methanococcaceae	2183	F	32	0	32	0.00000
SRR6145058	Methanocellaceae	570265	F	6	1	7	0.00000
SRR6145058	Methanocaldococcaceae	196117	F	15	2	17	0.00000
SRR6145058	Methanobacteriaceae	2159	F	29	0	29	0.00000
SRR6145058	Merismopediaceae	1890428	F	12	0	12	0.00000
SRR6145058	Marseilleviridae	944644	F	1	0	1	0.00000
SRR6145058	Mariprofundaceae	580372	F	9	0	9	0.00000
SRR6145058	Marinilabiliaceae	558415	F	9	0	9	0.00000
SRR6145058	Marinifilaceae	1573805	F	7	0	7	0.00000
SRR6145058	Magnetococcaceae	1191479	F	5	0	5	0.00000
SRR6145058	Litoricolaceae	449732	F	5	4	9	0.00000
SRR6145058	Limnochordaceae	1676650	F	7	0	7	0.00000
SRR6145058	Lichenihabitantaceae	2723775	F	43	1	44	0.00000
SRR6145058	Leptospiraceae	170	F	22	-4	18	0.00000
SRR6145058	Leptolyngbyaceae	1890438	F	31	2	33	0.00000
SRR6145058	Ktedonosporobacteraceae	2692416	F	8	3	11	0.00000
SRR6145058	Kosmotogaceae	1643948	F	3	0	3	0.00000
SRR6145058	Kiritimatiellaceae	1921783	F	9	15	24	0.00000
SRR6145058	Kangiellaceae	1920240	F	14	0	14	0.00000
SRR6145058	Jonesiaceae	85022	F	9	0	9	0.00000
SRR6145058	Iridoviridae	10486	F	1	0	1	0.00000
SRR6145058	Immundisolibacteraceae	1934946	F	28	0	28	0.00000
SRR6145058	Ilumatobacteraceae	2448023	F	33	0	33	0.00000
SRR6145058	Ignavibacteriaceae	795749	F	1	1	2	0.00000
SRR6145058	Idiomarinaceae	267893	F	19	-3	16	0.00000
SRR6145058	Ichthyobacteriaceae	1755828	F	2	0	2	0.00000
SRR6145058	Hytrosaviridae	1285590	F	1	0	1	0.00000
SRR6145058	Hyellaceae	1890500	F	9	0	9	0.00000
SRR6145058	Hydrogenothermaceae	224027	F	6	5	11	0.00000
SRR6145058	Holosporaceae	44746	F	5	0	5	0.00000
SRR6145058	Herpesviridae	10292	F	10	0	10	0.00000
SRR6145058	Heliobacteriaceae	31984	F	11	0	11	0.00000
SRR6145058	Halothiobacillaceae	255526	F	10	0	10	0.00000
SRR6145058	Halobacteroidaceae	53434	F	7	0	7	0.00000
SRR6145058	Halobacteriovoraceae	1652132	F	16	0	16	0.00000
SRR6145058	Haliscomenobacteraceae	1937961	F	7	0	7	0.00000
SRR6145058	Halanaerobiaceae	972	F	10	8	18	0.00000
SRR6145058	Hahellaceae	224379	F	14	0	14	0.00000
SRR6145058	Granulosicoccaceae	449719	F	21	0	21	0.00000
SRR6145058	Gomontiellaceae	1892255	F	9	0	9	0.00000
SRR6145058	Gloeomargaritaceae	1955043	F	7	0	7	0.00000
SRR6145058	Gloeobacteraceae	1890422	F	20	9	29	0.00000
SRR6145058	Francisellaceae	34064	F	32	0	32	0.00000
SRR6145058	Fimbriimonadaceae	1663426	F	15	12	27	0.00000
SRR6145058	Fibrobacteraceae	204431	F	4	2	6	0.00000
SRR6145058	Fervidobacteriaceae	1643950	F	15	-2	13	0.00000
SRR6145058	Ferrimonadaceae	267892	F	14	0	14	0.00000
SRR6145058	Entomoplasmataceae	33925	F	13	1	14	0.00000
SRR6145058	Endozoicomonadaceae	2066474	F	6	0	6	0.00000
SRR6145058	Endomicrobiaceae	1783343	F	1	1	2	0.00000
SRR6145058	Emcibacteraceae	2066491	F	23	0	23	0.00000
SRR6145058	Elusimicrobiaceae	641876	F	1	0	1	0.00000
SRR6145058	Egibacteraceae	1747769	F	34	0	34	0.00000
SRR6145058	Dysgonamonadaceae	2005520	F	13	0	13	0.00000
SRR6145058	Drexlerviridae	2731691	F	1	0	1	0.00000
SRR6145058	Dictyoglomaceae	203488	F	5	0	5	0.00000
SRR6145058	Desulfurococcaceae	2272	F	9	-2	7	0.00000
SRR6145058	Desulfurobacteriaceae	558314	F	3	0	3	0.00000
SRR6145058	Desulfurellaceae	117942	F	4	0	4	0.00000
SRR6145058	Desulfomicrobiaceae	213116	F	24	0	24	0.00000
SRR6145058	Desulfohalobiaceae	213117	F	1	0	1	0.00000
SRR6145058	Desulfobulbaceae	213121	F	35	0	35	0.00000
SRR6145058	Desulfarculaceae	453228	F	12	1	13	0.00000
SRR6145058	Dermocarpellaceae	1890498	F	13	1	14	0.00000
SRR6145058	Demerecviridae	2731690	F	2	0	2	0.00000
SRR6145058	Dehalococcoidaceae	1202464	F	2	0	2	0.00000
SRR6145058	Deferribacteraceae	191394	F	16	0	16	0.00000
SRR6145058	Cyanothecaceae	1892249	F	5	5	10	0.00000
SRR6145058	Cyanobacteriaceae	1890452	F	2	0	2	0.00000
SRR6145058	Cryomorphaceae	246874	F	6	2	8	0.00000
SRR6145058	Crocinitomicaceae	1853230	F	7	0	7	0.00000
SRR6145058	Coxiellaceae	118968	F	13	0	13	0.00000
SRR6145058	Coronaviridae	11118	F	1	0	1	0.00000
SRR6145058	Coriobacteriaceae	84107	F	41	2	43	0.00000
SRR6145058	Colwelliaceae	267889	F	41	0	41	0.00000
SRR6145058	Coleofasciculaceae	1892251	F	10	0	10	0.00000
SRR6145058	Clostridiales Family XVII. Incertae Sedis	539000	F	49	0	49	0.00001
SRR6145058	Clostridiales Family XVI. Incertae Sedis	543347	F	4	0	4	0.00000
SRR6145058	Clostridiales Family XIII. Incertae Sedis	543314	F	284	5	289	0.00003
SRR6145058	Chthonomonadaceae	1077264	F	5	2	7	0.00000
SRR6145058	Chrysiogenaceae	189770	F	3	0	3	0.00000
SRR6145058	Chroococcaceae	1890464	F	36	2	38	0.00000
SRR6145058	Christensenellaceae	990719	F	7	0	7	0.00000
SRR6145058	Chloroflexaceae	1106	F	18	-11	7	0.00000
SRR6145058	Chlorobiaceae	191412	F	35	4	39	0.00000
SRR6145058	Chlamydiaceae	809	F	9	-1	8	0.00000
SRR6145058	Chaseviridae	2731689	F	1	0	1	0.00000
SRR6145058	Chamaesiphonaceae	1890431	F	6	0	6	0.00000
SRR6145058	Caulimoviridae	186534	F	1	0	1	0.00000
SRR6145058	Casimicrobiaceae	2705999	F	27	13	40	0.00000
SRR6145058	Calditrichaceae	1962854	F	5	0	5	0.00000
SRR6145058	Caldisphaeraceae	255472	F	2	19	21	0.00000
SRR6145058	Caldilineaceae	475964	F	4	0	4	0.00000
SRR6145058	Caedimonadaceae	2100208	F	3	0	3	0.00000
SRR6145058	Budviciaceae	1903416	F	4	0	4	0.00000
SRR6145058	Bromoviridae	39740	F	1	2	3	0.00000
SRR6145058	Bradymonadaceae	1779135	F	12	24	36	0.00000
SRR6145058	Borreliaceae	1643685	F	19	-1	18	0.00000
SRR6145058	Blattabacteriaceae	39782	F	21	0	21	0.00000
SRR6145058	Bernardetiaceae	1937968	F	8	0	8	0.00000
SRR6145058	Bartonellaceae	772	F	44	1	45	0.00000
SRR6145058	Barnesiellaceae	2005519	F	11	1	12	0.00000
SRR6145058	Baculoviridae	10442	F	8	0	8	0.00000
SRR6145058	Bacteriovoracaceae	263369	F	23	0	23	0.00000
SRR6145058	Azonexaceae	2008795	F	31	0	31	0.00000
SRR6145058	Autographiviridae	2731643	F	17	-3	14	0.00000
SRR6145058	Ardenticatenaceae	1382930	F	16	0	16	0.00000
SRR6145058	Archaeoglobaceae	2232	F	7	0	7	0.00000
SRR6145058	Aquificaceae	64898	F	11	0	11	0.00000
SRR6145058	Aphanothecaceae	1890450	F	22	1	23	0.00000
SRR6145058	Aphanizomenonaceae	1892259	F	28	3	31	0.00000
SRR6145058	Anelloviridae	687329	F	1	0	1	0.00000
SRR6145058	Anaplasmataceae	942	F	25	7	32	0.00000
SRR6145058	Anaerolineaceae	292628	F	18	0	18	0.00000
SRR6145058	Anaerohalosphaeraceae	2690158	F	2	11	13	0.00000
SRR6145058	Amoebophilaceae	1501348	F	7	0	7	0.00000
SRR6145058	Alloherpesviridae	548682	F	1	0	1	0.00000
SRR6145058	Alicyclobacillaceae	186823	F	35	0	35	0.00000
SRR6145058	Akkermansiaceae	1647988	F	14	16	30	0.00000
SRR6145058	Adenoviridae	10508	F	1	0	1	0.00000
SRR6145058	Actinopolysporaceae	622451	F	29	0	29	0.00000
SRR6145058	Ackermannviridae	2169529	F	4	0	4	0.00000
SRR6145058	Acidothermaceae	85032	F	12	0	12	0.00000
SRR6145058	Acidithiobacillaceae	225058	F	30	0	30	0.00000
SRR6145058	Acidimicrobiaceae	84994	F	7	20	27	0.00000
SRR6145058	Acidilobaceae	871007	F	4	0	4	0.00000
SRR6145058	Acidiferrobacteraceae	1692041	F	39	0	39	0.00000
SRR6145058	Acidaminococcaceae	909930	F	23	-6	17	0.00000
SRR6145058	Acholeplasmataceae	2146	F	24	5	29	0.00000
SRR6145058	Acaryochloridaceae	1890429	F	5	0	5	0.00000
