sample	name	taxonomy_id	taxonomy_lvl	kraken_assigned_reads	added_reads	new_est_reads	fraction_total_reads
SRR6145060	Candidatus Pelagibacter	198251	G	68	30	98	0.00001
SRR6145060	Candidatus Methylospira	1808977	G	10	55	65	0.00001
SRR6145060	Candidatus Solibacter	332162	G	58	1	59	0.00001
SRR6145060	Candidatus Atelocyanobacterium	1453359	G	40	15	55	0.00001
SRR6145060	Candidatus Saccharimonas	1331051	G	18	28	46	0.00001
SRR6145060	Candidatus Accumulibacter	327159	G	44	0	44	0.00001
SRR6145060	Candidatus Methylopumilus	1679002	G	39	1	40	0.00001
SRR6145060	Candidatus Blochmannia	203804	G	34	0	34	0.00000
SRR6145060	Candidatus Promineofilum	1988031	G	30	0	30	0.00000
SRR6145060	Candidatus Hamiltonella	568987	G	17	13	30	0.00000
SRR6145060	Candidatus Kinetoplastibacterium	33055	G	38	-9	29	0.00000
SRR6145060	Candidatus Planktophila	622681	G	26	2	28	0.00000
SRR6145060	Candidatus Bipolaricaulis	2250122	G	2	25	27	0.00000
SRR6145060	Candidatus Izimaplasma	1912503	G	15	11	26	0.00000
SRR6145060	Candidatus Desulforudis	471826	G	3	21	24	0.00000
SRR6145060	Candidatus Ruthia	1541743	G	10	12	22	0.00000
SRR6145060	Candidatus Arthromitus	49082	G	22	0	22	0.00000
SRR6145060	Candidatus Phytoplasma	33926	G	20	0	20	0.00000
SRR6145060	Candidatus Symbiobacter	1436289	G	14	0	14	0.00000
SRR6145060	Candidatus Protochlamydia	282132	G	14	0	14	0.00000
SRR6145060	Candidatus Phaeomarinobacter	1541445	G	14	0	14	0.00000
SRR6145060	Candidatus Nanopelagicus	2039639	G	14	0	14	0.00000
SRR6145060	Candidatus Thioglobus	655184	G	13	0	13	0.00000
SRR6145060	Candidatus Nitrosotalea	1078904	G	13	0	13	0.00000
SRR6145060	Candidatus Sulcia	336809	G	10	2	12	0.00000
SRR6145060	Candidatus Nitrosocosmicus	1826864	G	12	0	12	0.00000
SRR6145060	Candidatus Endolissoclinum	1263978	G	12	0	12	0.00000
SRR6145060	Candidatus Prometheoarchaeum	2732160	G	9	2	11	0.00000
SRR6145060	Candidatus Kuenenia	380738	G	11	0	11	0.00000
SRR6145060	Candidatus Fonsibacter	2045213	G	4	7	11	0.00000
SRR6145060	Candidatus Cardinium	273135	G	11	0	11	0.00000
SRR6145060	Candidatus Aquiluna	529881	G	11	0	11	0.00000
SRR6145060	Candidatus Nitrotoga	453161	G	10	0	10	0.00000
SRR6145060	Candidatus Fukatsuia	1927833	G	10	0	10	0.00000
SRR6145060	Candidatus Doolittlea	1906657	G	10	0	10	0.00000
SRR6145060	Candidatus Portiera	235572	G	8	0	8	0.00000
SRR6145060	Candidatus Koribacter	658061	G	8	0	8	0.00000
SRR6145060	Candidatus Hepatoplasma	295595	G	8	0	8	0.00000
SRR6145060	Candidatus Nucleicultrix	1509243	G	7	0	7	0.00000
SRR6145060	Candidatus Desulfofervidus	1902583	G	7	0	7	0.00000
SRR6145060	Candidatus Cyclonatronum	2489367	G	7	0	7	0.00000
SRR6145060	Candidatus Syntrophocurvum	2293313	G	6	0	6	0.00000
SRR6145060	Candidatus Nitrosotenuis	1825023	G	6	0	6	0.00000
SRR6145060	Candidatus Nitrosoglobus	1980513	G	6	0	6	0.00000
SRR6145060	Candidatus Azobacteroides	511434	G	6	0	6	0.00000
SRR6145060	Candidatus Amoebophilus	281119	G	6	0	6	0.00000
SRR6145060	Candidatus Tachikawaea	1682492	G	5	0	5	0.00000
SRR6145060	Candidatus Riesia	401618	G	5	0	5	0.00000
SRR6145060	Candidatus Reidiella	2738850	G	5	0	5	0.00000
SRR6145060	Candidatus Puniceispirillum	767891	G	5	0	5	0.00000
SRR6145060	Candidatus Profftella	1381133	G	5	0	5	0.00000
SRR6145060	Candidatus Nitrosomarinus	1993653	G	5	0	5	0.00000
SRR6145060	Candidatus Methanoplasma	1607807	G	2	3	5	0.00000
SRR6145060	Candidatus Methanomethylophilus	1291539	G	5	0	5	0.00000
SRR6145060	Candidatus Gullanella	1906661	G	3	2	5	0.00000
SRR6145060	Candidatus Deianiraea	2603321	G	5	0	5	0.00000
SRR6145060	Candidatus Cytomitobacter	2601574	G	5	0	5	0.00000
SRR6145060	Candidatus Cloacimonas	456826	G	4	1	5	0.00000
SRR6145060	Candidatus Babela	1551504	G	5	0	5	0.00000
SRR6145060	Candidatus Paracaedibacter	1521255	G	4	0	4	0.00000
SRR6145060	Candidatus Nesciobacter	2601651	G	4	0	4	0.00000
SRR6145060	Candidatus Nasuia	1301080	G	4	0	4	0.00000
SRR6145060	Candidatus Nardonella	204619	G	4	0	4	0.00000
SRR6145060	Candidatus Midichloria	411566	G	4	0	4	0.00000
SRR6145060	Candidatus Ishikawaella	409304	G	4	0	4	0.00000
SRR6145060	Candidatus Hodgkinia	573657	G	4	0	4	0.00000
SRR6145060	Candidatus Evansia	1495768	G	4	0	4	0.00000
SRR6145060	Candidatus Vesicomyosocius	2732587	G	3	0	3	0.00000
SRR6145060	Candidatus Phycorickettsia	2115980	G	3	0	3	0.00000
SRR6145060	Candidatus Fokinia	1802983	G	3	0	3	0.00000
SRR6145060	Candidatus Carsonella	114185	G	3	0	3	0.00000
SRR6145060	Candidatus Walczuchella	1940138	G	2	0	2	0.00000
SRR6145060	Candidatus Purcelliella	472825	G	2	0	2	0.00000
SRR6145060	Candidatus Xiphinematobacter	134550	G	1	0	1	0.00000
SRR6145060	Candidatus Sneabacter	2601645	G	1	0	1	0.00000
SRR6145060	Candidatus Nitrosopelagicus	1593364	G	1	0	1	0.00000
SRR6145060	Candidatus Korarchaeum	498845	G	1	0	1	0.00000
SRR6145060	Candidatus Hoaglandella	1906659	G	1	0	1	0.00000
SRR6145060	Candidatus Chazhemtobacterium	2715734	G	1	0	1	0.00000
SRR6145060	Candidatus Annandia	1302410	G	1	0	1	0.00000
SRR6145060	Homo	9605	G	6039591	2789	6042380	0.79620
SRR6145060	Cutibacterium	1912216	G	371529	6221	377750	0.04978
SRR6145060	Staphylococcus	1279	G	126494	19792	146286	0.01928
SRR6145060	Moraxella	475	G	105164	2573	107737	0.01420
SRR6145060	Micrococcus	1269	G	67663	5275	72938	0.00961
SRR6145060	Acinetobacter	469	G	67516	3635	71151	0.00938
SRR6145060	Streptococcus	1301	G	60111	2081	62192	0.00819
SRR6145060	Corynebacterium	1716	G	44487	1677	46164	0.00608
SRR6145060	Chryseobacterium	59732	G	28262	1421	29683	0.00391
SRR6145060	Pseudomonas	286	G	23164	1436	24600	0.00324
SRR6145060	Methylobacterium	407	G	19253	1167	20420	0.00269
SRR6145060	Paracoccus	265	G	17656	1433	19089	0.00252
SRR6145060	Dermacoccus	57495	G	17899	801	18700	0.00246
SRR6145060	Gordonia	2053	G	16772	1466	18238	0.00240
SRR6145060	Halomonas	2745	G	17235	246	17481	0.00230
SRR6145060	Actinomyces	1654	G	15769	510	16279	0.00215
SRR6145060	Streptomyces	1883	G	14753	402	15155	0.00200
SRR6145060	Brevundimonas	41275	G	13388	731	14119	0.00186
SRR6145060	Neisseria	482	G	12977	693	13670	0.00180
SRR6145060	Paraburkholderia	1822464	G	12361	640	13001	0.00171
SRR6145060	Sphingomonas	13687	G	11280	967	12247	0.00161
SRR6145060	Mycolicibacterium	1866885	G	10776	1057	11833	0.00156
SRR6145060	Janibacter	53457	G	10271	555	10826	0.00143
SRR6145060	Microbacterium	33882	G	9542	710	10252	0.00135
SRR6145060	Haemophilus	724	G	9130	368	9498	0.00125
SRR6145060	Kocuria	57493	G	8646	391	9037	0.00119
SRR6145060	Prevotella	838	G	7500	590	8090	0.00107
SRR6145060	Rhodococcus	1827	G	7155	464	7619	0.00100
SRR6145060	Mycobacterium	1763	G	6076	1513	7589	0.00100
SRR6145060	Gemella	1378	G	7379	148	7527	0.00099
SRR6145060	Rothia	32207	G	7103	116	7219	0.00095
SRR6145060	Stenotrophomonas	40323	G	6404	747	7151	0.00094
SRR6145060	Dietzia	37914	G	6232	757	6989	0.00092
SRR6145060	Finegoldia	150022	G	5907	612	6519	0.00086
SRR6145060	Nocardioides	1839	G	6145	307	6452	0.00085
SRR6145060	Sphingobacterium	28453	G	6190	143	6333	0.00083
SRR6145060	Deinococcus	1298	G	5761	16	5777	0.00076
SRR6145060	Roseomonas	125216	G	5035	674	5709	0.00075
SRR6145060	Tsukamurella	2060	G	5196	264	5460	0.00072
SRR6145060	Massilia	149698	G	5038	431	5469	0.00072
SRR6145060	Sphingobium	165695	G	4179	1212	5391	0.00071
SRR6145060	Rhizobium	379	G	3490	1903	5393	0.00071
SRR6145060	Nocardia	1817	G	4534	293	4827	0.00064
SRR6145060	Klebsiella	570	G	2997	1610	4607	0.00061
SRR6145060	Porphyromonas	836	G	4418	127	4545	0.00060
SRR6145060	Fusobacterium	848	G	4539	20	4559	0.00060
SRR6145060	Veillonella	29465	G	4396	10	4406	0.00058
SRR6145060	Leptotrichia	32067	G	3680	24	3704	0.00049
SRR6145060	Enterobacter	547	G	3085	613	3698	0.00049
SRR6145060	Campylobacter	194	G	3579	33	3612	0.00048
SRR6145060	Kytococcus	57499	G	3315	238	3553	0.00047
SRR6145060	Bradyrhizobium	374	G	3370	204	3574	0.00047
SRR6145060	Corallococcus	83461	G	3232	93	3325	0.00044
SRR6145060	Pahexavirus	1982251	G	2395	545	2940	0.00039
SRR6145060	Brevibacterium	1696	G	2880	117	2997	0.00039
SRR6145060	Methylorubrum	2282523	G	2205	673	2878	0.00038
SRR6145060	Lactobacillus	1578	G	2800	91	2891	0.00038
SRR6145060	Luteimonas	83614	G	2663	169	2832	0.00037
SRR6145060	Burkholderia	32008	G	2583	213	2796	0.00037
SRR6145060	Serratia	613	G	2549	147	2696	0.00036
SRR6145060	Capnocytophaga	1016	G	2716	20	2736	0.00036
SRR6145060	Bacillus	1386	G	2423	311	2734	0.00036
SRR6145060	Brachybacterium	43668	G	2618	47	2665	0.00035
SRR6145060	Aeromonas	642	G	2374	232	2606	0.00034
SRR6145060	Pseudonocardia	1847	G	2395	105	2500	0.00033
SRR6145060	Lysobacter	68	G	2434	108	2542	0.00033
SRR6145060	Curtobacterium	2034	G	2275	99	2374	0.00031
SRR6145060	Xanthomonas	338	G	2112	181	2293	0.00030
SRR6145060	Micromonospora	1873	G	2035	155	2190	0.00029
SRR6145060	Leuconostoc	1243	G	2129	79	2208	0.00029
SRR6145060	Escherichia	561	G	392	1788	2180	0.00029
SRR6145060	Bosea	85413	G	2095	93	2188	0.00029
SRR6145060	Comamonas	283	G	1952	208	2160	0.00028
SRR6145060	Acidovorax	12916	G	1568	560	2128	0.00028
SRR6145060	Clostridium	1485	G	1930	16	1946	0.00026
SRR6145060	Sphingopyxis	165697	G	1595	223	1818	0.00024
SRR6145060	Mesorhizobium	68287	G	1657	104	1761	0.00023
SRR6145060	Caulobacter	75	G	1646	53	1699	0.00022
SRR6145060	Rhodobacter	1060	G	1080	514	1594	0.00021
SRR6145060	Cupriavidus	106589	G	1439	145	1584	0.00021
SRR6145060	Arthrobacter	1663	G	1509	80	1589	0.00021
SRR6145060	Leclercia	83654	G	1387	166	1553	0.00020
SRR6145060	Lawsonella	1847725	G	1472	35	1507	0.00020
SRR6145060	Friedmanniella	53387	G	1447	55	1502	0.00020
SRR6145060	Variovorax	34072	G	1361	105	1466	0.00019
SRR6145060	Sulfitobacter	60136	G	325	1118	1443	0.00019
SRR6145060	Lautropia	47670	G	1360	79	1439	0.00019
SRR6145060	Agrobacterium	357	G	1223	216	1439	0.00019
SRR6145060	Bacteroides	816	G	1147	226	1373	0.00018
SRR6145060	Anaerococcus	165779	G	1282	85	1367	0.00018
SRR6145060	Aggregatibacter	416916	G	1298	37	1335	0.00018
SRR6145060	Achromobacter	222	G	1131	200	1331	0.00018
SRR6145060	Pantoea	53335	G	1231	88	1319	0.00017
SRR6145060	Novosphingobium	165696	G	1129	175	1304	0.00017
SRR6145060	Mycobacteroides	670516	G	767	556	1323	0.00017
SRR6145060	Hymenobacter	89966	G	1271	12	1283	0.00017
SRR6145060	Cellulomonas	1707	G	1192	67	1259	0.00017
SRR6145060	Schaalia	2529408	G	1215	29	1244	0.00016
SRR6145060	Peptoniphilus	162289	G	1153	52	1205	0.00016
SRR6145060	Azospirillum	191	G	1178	47	1225	0.00016
SRR6145060	Amycolatopsis	1813	G	1333	-125	1208	0.00016
SRR6145060	Pasteurella	745	G	880	273	1153	0.00015
SRR6145060	Serinicoccus	265976	G	986	74	1060	0.00014
SRR6145060	Gardnerella	2701	G	1026	21	1047	0.00014
SRR6145060	Flavobacterium	237	G	1055	8	1063	0.00014
SRR6145060	Actinoplanes	1865	G	1034	25	1059	0.00014
SRR6145060	Pseudoxanthomonas	83618	G	844	106	950	0.00013
SRR6145060	Gluconobacter	441	G	925	38	963	0.00013
SRR6145060	Abiotrophia	46123	G	973	8	981	0.00013
SRR6145060	Thermogutta	1676125	G	5	918	923	0.00012
SRR6145060	Raoultella	160674	G	360	531	891	0.00012
SRR6145060	Phietavirus	1623298	G	56	836	892	0.00012
SRR6145060	Ornithinimicrobium	125287	G	809	71	880	0.00012
SRR6145060	Nakamurella	53460	G	927	18	945	0.00012
SRR6145060	Lactococcus	1357	G	792	117	909	0.00012
SRR6145060	Hydrogenophaga	47420	G	795	129	924	0.00012
SRR6145060	Elizabethkingia	308865	G	869	44	913	0.00012
SRR6145060	Aeromicrobium	2040	G	912	36	948	0.00012
SRR6145060	Aerococcus	1375	G	842	41	883	0.00012
SRR6145060	Shewanella	22	G	795	39	834	0.00011
SRR6145060	Salmonella	590	G	124	686	810	0.00011
SRR6145060	Rathayibacter	33886	G	805	38	843	0.00011
SRR6145060	Phycicoccus	367298	G	802	48	850	0.00011
SRR6145060	Dolosigranulum	29393	G	837	15	852	0.00011
SRR6145060	Cloacibacterium	501783	G	810	27	837	0.00011
SRR6145060	Altererythrobacter	361177	G	795	75	870	0.00011
SRR6145060	Weissella	46255	G	737	14	751	0.00010
SRR6145060	Psychrobacter	497	G	716	40	756	0.00010
SRR6145060	Erythrobacter	1041	G	661	118	779	0.00010
SRR6145060	Bordetella	517	G	706	86	792	0.00010
SRR6145060	Agromyces	33877	G	700	40	740	0.00010
SRR6145060	Actinomadura	1988	G	709	36	745	0.00010
SRR6145060	Zymobacter	33073	G	669	9	678	0.00009
SRR6145060	Vibrio	662	G	691	15	706	0.00009
SRR6145060	Thauera	33057	G	532	120	652	0.00009
SRR6145060	Tessaracoccus	72763	G	644	29	673	0.00009
SRR6145060	Paenibacillus	44249	G	652	-1	651	0.00009
SRR6145060	Macrococcus	69965	G	658	23	681	0.00009
SRR6145060	Duganella	75654	G	621	92	713	0.00009
SRR6145060	Delftia	80865	G	556	131	687	0.00009
SRR6145060	Caloranaerobacter	171003	G	9	656	665	0.00009
SRR6145060	Agrococcus	46352	G	621	37	658	0.00009
SRR6145060	Acetobacter	434	G	630	17	647	0.00009
SRR6145060	Sinorhizobium	28105	G	535	50	585	0.00008
SRR6145060	Rhodopseudomonas	1073	G	440	147	587	0.00008
SRR6145060	Rheinheimera	67575	G	593	6	599	0.00008
SRR6145060	Ralstonia	48736	G	529	74	603	0.00008
SRR6145060	Pseudoalteromonas	53246	G	612	7	619	0.00008
SRR6145060	Porphyrobacter	1111	G	514	94	608	0.00008
SRR6145060	Modestobacter	88138	G	533	44	577	0.00008
SRR6145060	Marmoricola	86795	G	494	76	570	0.00008
SRR6145060	Frankia	1854	G	631	6	637	0.00008
SRR6145060	Ezakiella	1582879	G	508	67	575	0.00008
SRR6145060	Exiguobacterium	33986	G	568	6	574	0.00008
SRR6145060	Epidermidibacterium	2078948	G	592	7	599	0.00008
SRR6145060	Acidipropionibacterium	1912215	G	549	27	576	0.00008
SRR6145060	Tannerella	195950	G	419	86	505	0.00007
SRR6145060	Spirosoma	107	G	520	5	525	0.00007
SRR6145060	Sorangium	39643	G	498	15	513	0.00007
SRR6145060	Saccharomonospora	1851	G	498	49	547	0.00007
SRR6145060	Pseudopropionibacterium	1912217	G	498	5	503	0.00007
SRR6145060	Microlunatus	29404	G	521	4	525	0.00007
SRR6145060	Humibacter	427753	G	149	371	520	0.00007
SRR6145060	Geodermatophilus	1860	G	489	47	536	0.00007
SRR6145060	Enterococcus	1350	G	513	49	562	0.00007
SRR6145060	Empedobacter	59734	G	539	7	546	0.00007
SRR6145060	Dyella	231454	G	480	49	529	0.00007
SRR6145060	Citrobacter	544	G	443	84	527	0.00007
SRR6145060	Cellulosimicrobium	157920	G	497	24	521	0.00007
SRR6145060	Bifidobacterium	1678	G	523	-10	513	0.00007
SRR6145060	Thermomonas	141948	G	415	40	455	0.00006
SRR6145060	Saccharothrix	2071	G	390	44	434	0.00006
SRR6145060	Saccharopolyspora	1835	G	411	20	431	0.00006
SRR6145060	Pseudarthrobacter	1742993	G	417	17	434	0.00006
SRR6145060	Proteus	583	G	432	42	474	0.00006
SRR6145060	Ottowia	219181	G	456	18	474	0.00006
SRR6145060	Nonomuraea	83681	G	435	14	449	0.00006
SRR6145060	Leifsonia	110932	G	462	19	481	0.00006
SRR6145060	Janthinobacterium	29580	G	396	22	418	0.00006
SRR6145060	Herbaspirillum	963	G	441	31	472	0.00006
SRR6145060	Glutamicibacter	1742989	G	408	14	422	0.00006
SRR6145060	Diaphorobacter	238749	G	150	290	440	0.00006
SRR6145060	Dermabacter	36739	G	432	55	487	0.00006
SRR6145060	Blastococcus	38501	G	414	36	450	0.00006
SRR6145060	Azoarcus	12960	G	398	44	442	0.00006
SRR6145060	Treponema	157	G	374	1	375	0.00005
SRR6145060	Skermanella	204447	G	347	13	360	0.00005
SRR6145060	Rhodoferax	28065	G	376	31	407	0.00005
SRR6145060	Propionibacterium	1743	G	353	46	399	0.00005
SRR6145060	Pimelobacter	2044	G	311	60	371	0.00005
SRR6145060	Phenylobacterium	20	G	383	17	400	0.00005
SRR6145060	Paucibacter	318147	G	94	294	388	0.00005
SRR6145060	Parvimonas	543311	G	352	33	385	0.00005
SRR6145060	Pandoraea	93217	G	333	14	347	0.00005
SRR6145060	Ochrobactrum	528	G	255	87	342	0.00005
SRR6145060	Myroides	76831	G	202	149	351	0.00005
SRR6145060	Mycoplasma	2093	G	409	0	409	0.00005
SRR6145060	Mycolicibacter	1073531	G	361	12	373	0.00005
SRR6145060	Microvirga	186650	G	399	14	413	0.00005
SRR6145060	Kitasatospora	2063	G	309	107	416	0.00005
SRR6145060	Jiangella	281472	G	364	6	370	0.00005
SRR6145060	Haematobacter	366614	G	322	71	393	0.00005
SRR6145060	Georgenia	154116	G	352	10	362	0.00005
SRR6145060	Erwinia	551	G	341	9	350	0.00005
SRR6145060	Cystobacter	42	G	314	39	353	0.00005
SRR6145060	Cnuibacter	1759331	G	78	294	372	0.00005
SRR6145060	Clavibacter	1573	G	363	20	383	0.00005
SRR6145060	Chroococcidiopsis	54298	G	288	54	342	0.00005
SRR6145060	Cellvibrio	10	G	363	2	365	0.00005
SRR6145060	Calothrix	1186	G	369	32	401	0.00005
SRR6145060	Arcobacter	28196	G	359	19	378	0.00005
SRR6145060	Turneriella	338321	G	6	327	333	0.00004
SRR6145060	Streptosporangium	2000	G	269	10	279	0.00004
SRR6145060	Shinella	323620	G	274	51	325	0.00004
SRR6145060	Selenomonas	970	G	275	0	275	0.00004
SRR6145060	Roseovarius	74030	G	269	38	307	0.00004
SRR6145060	Rhodovulum	34008	G	238	32	270	0.00004
SRR6145060	Rhizorhabdus	1649486	G	178	96	274	0.00004
SRR6145060	Propionimicrobium	203133	G	319	10	329	0.00004
SRR6145060	Phytohabitans	907364	G	305	8	313	0.00004
SRR6145060	Pedobacter	84567	G	338	3	341	0.00004
SRR6145060	Pectobacterium	122277	G	288	4	292	0.00004
SRR6145060	Pauljensenia	2740557	G	281	21	302	0.00004
SRR6145060	Nostoc	1177	G	263	63	326	0.00004
SRR6145060	Nocardiopsis	2013	G	320	12	332	0.00004
SRR6145060	Neorhizobium	1525371	G	320	14	334	0.00004
SRR6145060	Myxococcus	32	G	308	18	326	0.00004
SRR6145060	Mucilaginibacter	423349	G	339	0	339	0.00004
SRR6145060	Marinobacter	2742	G	285	5	290	0.00004
SRR6145060	Leucobacter	55968	G	278	10	288	0.00004
SRR6145060	Kineococcus	33981	G	315	10	325	0.00004
SRR6145060	Ensifer	106591	G	307	27	334	0.00004
SRR6145060	Devosia	46913	G	330	9	339	0.00004
SRR6145060	Celeribacter	875170	G	229	82	311	0.00004
SRR6145060	Arsenicicoccus	267408	G	267	18	285	0.00004
SRR6145060	Alicycliphilus	201096	G	156	140	296	0.00004
SRR6145060	Xylanimonas	186188	G	181	15	196	0.00003
SRR6145060	Synechococcus	1129	G	221	18	239	0.00003
SRR6145060	Starkeya	152053	G	202	22	224	0.00003
SRR6145060	Spiroplasma	2132	G	196	2	198	0.00003
SRR6145060	Sphingosinicella	335405	G	245	3	248	0.00003
SRR6145060	Serpentinomonas	2490452	G	211	10	221	0.00003
SRR6145060	Sanguibacter	60919	G	250	8	258	0.00003
SRR6145060	Rubrobacter	42255	G	261	0	261	0.00003
SRR6145060	Rubrivivax	28067	G	202	31	233	0.00003
SRR6145060	Rickettsia	780	G	226	0	226	0.00003
SRR6145060	Rhodanobacter	75309	G	225	20	245	0.00003
SRR6145060	Rhizobacter	212743	G	172	18	190	0.00003
SRR6145060	Ramlibacter	174951	G	215	17	232	0.00003
SRR6145060	Protaetiibacter	2680004	G	173	18	191	0.00003
SRR6145060	Polaribacter	52959	G	218	1	219	0.00003
SRR6145060	Pluralibacter	1330546	G	190	9	199	0.00003
SRR6145060	Plantactinospora	673534	G	249	14	263	0.00003
SRR6145060	Phreatobacter	1632780	G	252	7	259	0.00003
SRR6145060	Phaeobacter	302485	G	179	31	210	0.00003
SRR6145060	Peptoclostridium	1481960	G	3	223	226	0.00003
SRR6145060	Pannonibacter	227873	G	194	54	248	0.00003
SRR6145060	Mogibacterium	86331	G	184	50	234	0.00003
SRR6145060	Mixta	2100764	G	214	18	232	0.00003
SRR6145060	Mitsuaria	65047	G	230	27	257	0.00003
SRR6145060	Miniimonas	947525	G	201	13	214	0.00003
SRR6145060	Micropruina	116071	G	210	5	215	0.00003
SRR6145060	Methylocystis	133	G	191	6	197	0.00003
SRR6145060	Methylibium	316612	G	179	22	201	0.00003
SRR6145060	Magnetospirillum	13134	G	192	2	194	0.00003
SRR6145060	Luteipulveratus	745364	G	235	3	238	0.00003
SRR6145060	Liberibacter	34019	G	27	197	224	0.00003
SRR6145060	Komagataeibacter	1434011	G	185	10	195	0.00003
SRR6145060	Isoptericola	254250	G	224	15	239	0.00003
SRR6145060	Intrasporangium	53357	G	219	7	226	0.00003
SRR6145060	Halorubrum	56688	G	179	15	194	0.00003
SRR6145060	Gemmata	113	G	163	88	251	0.00003
SRR6145060	Frondihabitans	447237	G	196	7	203	0.00003
SRR6145060	Faecalibacterium	216851	G	193	31	224	0.00003
SRR6145060	Eikenella	538	G	228	13	241	0.00003
SRR6145060	Desulfovibrio	872	G	254	9	263	0.00003
SRR6145060	Defluviimonas	1097466	G	184	35	219	0.00003
SRR6145060	Cryobacterium	69578	G	185	5	190	0.00003
SRR6145060	Croceicoccus	1295327	G	141	114	255	0.00003
SRR6145060	Conexibacter	191494	G	210	2	212	0.00003
SRR6145060	Clostridioides	1870884	G	124	83	207	0.00003
SRR6145060	Chromobacterium	535	G	242	13	255	0.00003
SRR6145060	Chelatococcus	28209	G	212	15	227	0.00003
SRR6145060	Cardiobacterium	2717	G	224	4	228	0.00003
SRR6145060	Brochothrix	2755	G	241	3	244	0.00003
SRR6145060	Baekduia	2600304	G	253	3	256	0.00003
SRR6145060	Asticcacaulis	76890	G	134	60	194	0.00003
SRR6145060	Archangium	47	G	208	12	220	0.00003
SRR6145060	Aquabacterium	92793	G	203	33	236	0.00003
SRR6145060	Anaeromyxobacter	161492	G	211	1	212	0.00003
SRR6145060	Alteromonas	226	G	176	25	201	0.00003
SRR6145060	Alcanivorax	59753	G	202	5	207	0.00003
SRR6145060	Actinosynnema	40566	G	234	25	259	0.00003
SRR6145060	Actinoalloteichus	65496	G	258	6	264	0.00003
SRR6145060	Zhihengliuella	370735	G	123	60	183	0.00002
SRR6145060	Yersinia	629	G	145	10	155	0.00002
SRR6145060	Yangia	354203	G	172	9	181	0.00002
SRR6145060	Xylophilus	54066	G	114	18	132	0.00002
SRR6145060	Xanthobacter	279	G	161	23	184	0.00002
SRR6145060	Thiomonas	32012	G	122	2	124	0.00002
SRR6145060	Thioalkalivibrio	106633	G	128	5	133	0.00002
SRR6145060	Thermobispora	147067	G	84	77	161	0.00002
SRR6145060	Tetrasphaera	99479	G	174	8	182	0.00002
SRR6145060	Terasakiella	196080	G	4	162	166	0.00002
SRR6145060	Tenacibaculum	104267	G	137	1	138	0.00002
SRR6145060	Stella	93	G	121	2	123	0.00002
SRR6145060	Stappia	152161	G	116	3	119	0.00002
SRR6145060	Sphingosinithalassobacter	2676233	G	147	34	181	0.00002
SRR6145060	Sphingorhabdus	1434046	G	140	0	140	0.00002
SRR6145060	Sphaerotilus	34102	G	149	29	178	0.00002
SRR6145060	Sinomonas	596707	G	149	2	151	0.00002
SRR6145060	Scytonema	1203	G	97	18	115	0.00002
SRR6145060	Sandaracinus	1055688	G	114	0	114	0.00002
SRR6145060	Salipiger	263377	G	91	40	131	0.00002
SRR6145060	Sagittula	58842	G	106	55	161	0.00002
SRR6145060	Ruegeria	97050	G	137	9	146	0.00002
SRR6145060	Roseivivax	93682	G	95	25	120	0.00002
SRR6145060	Roseateles	93681	G	128	16	144	0.00002
SRR6145060	Rhodospirillum	1081	G	114	8	122	0.00002
SRR6145060	Qipengyuania	1855416	G	129	5	134	0.00002
SRR6145060	Pseudolabrys	556257	G	115	5	120	0.00002
SRR6145060	Providencia	586	G	130	9	139	0.00002
SRR6145060	Propioniciclava	1085622	G	152	10	162	0.00002
SRR6145060	Prochlorococcus	1218	G	127	4	131	0.00002
SRR6145060	Pontibacter	323449	G	122	3	125	0.00002
SRR6145060	Polymorphum	991903	G	108	9	117	0.00002
SRR6145060	Polaromonas	52972	G	164	4	168	0.00002
SRR6145060	Plantibacter	190323	G	173	5	178	0.00002
SRR6145060	Planctomyces	118	G	162	7	169	0.00002
SRR6145060	Pelagibaca	360528	G	84	30	114	0.00002
SRR6145060	Paraoceanicella	2683599	G	123	19	142	0.00002
SRR6145060	Parabacteroides	375288	G	76	50	126	0.00002
SRR6145060	Opitutus	178440	G	72	49	121	0.00002
SRR6145060	Olsenella	133925	G	153	6	159	0.00002
SRR6145060	Minicystis	1649470	G	137	3	140	0.00002
SRR6145060	Microterricola	518733	G	150	9	159	0.00002
SRR6145060	Microcella	337004	G	124	5	129	0.00002
SRR6145060	Methylotenera	359407	G	9	116	125	0.00002
SRR6145060	Methylosinus	425	G	115	7	122	0.00002
SRR6145060	Methanosarcina	2207	G	119	-2	117	0.00002
SRR6145060	Melittangium	44	G	154	19	173	0.00002
SRR6145060	Martelella	293088	G	141	15	156	0.00002
SRR6145060	Marinovum	367771	G	90	28	118	0.00002
SRR6145060	Mannheimia	75984	G	126	16	142	0.00002
SRR6145060	Luteimicrobium	754249	G	116	4	120	0.00002
SRR6145060	Luteibacter	242605	G	145	6	151	0.00002
SRR6145060	Listeria	1637	G	109	38	147	0.00002
SRR6145060	Leptothrix	88	G	132	23	155	0.00002
SRR6145060	Lentzea	165301	G	166	12	178	0.00002
SRR6145060	Leisingera	191028	G	138	16	154	0.00002
SRR6145060	Legionella	445	G	174	2	176	0.00002
SRR6145060	Lachnoanaerobaculum	1164882	G	145	2	147	0.00002
SRR6145060	Labrenzia	478070	G	164	1	165	0.00002
SRR6145060	Kutzneria	43356	G	156	10	166	0.00002
SRR6145060	Kribbella	182639	G	166	5	171	0.00002
SRR6145060	Kozakia	153497	G	122	7	129	0.00002
SRR6145060	Kosakonia	1330547	G	141	9	150	0.00002
SRR6145060	Kibdelosporangium	2029	G	173	6	179	0.00002
SRR6145060	Jatrophihabitans	1434010	G	84	98	182	0.00002
SRR6145060	Indioceanicola	2478349	G	64	68	132	0.00002
SRR6145060	Hypericibacter	2705399	G	127	2	129	0.00002
SRR6145060	Helicobacter	209	G	154	1	155	0.00002
SRR6145060	Geobacter	28231	G	144	4	148	0.00002
SRR6145060	Gemmatirosa	1706036	G	134	0	134	0.00002
SRR6145060	Filifactor	44259	G	113	9	122	0.00002
SRR6145060	Eiauvirus	1982111	G	1	117	118	0.00002
SRR6145060	Egibacter	1747770	G	59	118	177	0.00002
SRR6145060	Dokdonella	323413	G	117	4	121	0.00002
SRR6145060	Dickeya	204037	G	168	6	174	0.00002
SRR6145060	Cronobacter	413496	G	177	11	188	0.00002
SRR6145060	Collimonas	202907	G	152	4	156	0.00002
SRR6145060	Chitinophaga	79328	G	168	2	170	0.00002
SRR6145060	Catenulispora	414878	G	172	2	174	0.00002
SRR6145060	Carnobacterium	2747	G	143	3	146	0.00002
SRR6145060	Buchnera	32199	G	187	-3	184	0.00002
SRR6145060	Brasilonema	383614	G	132	24	156	0.00002
SRR6145060	Blastomonas	150203	G	149	5	154	0.00002
SRR6145060	Blastochloris	59282	G	136	10	146	0.00002
SRR6145060	Beutenbergia	84756	G	119	2	121	0.00002
SRR6145060	Azospira	146937	G	124	15	139	0.00002
SRR6145060	Azorhizobium	6	G	121	8	129	0.00002
SRR6145060	Aureimonas	414371	G	114	4	118	0.00002
SRR6145060	Auraticoccus	1278221	G	137	2	139	0.00002
SRR6145060	Ancylobacter	99	G	151	21	172	0.00002
SRR6145060	Anabaena	1163	G	42	137	179	0.00002
SRR6145060	Aminobacter	31988	G	146	29	175	0.00002
SRR6145060	Allokutzneria	1137960	G	160	12	172	0.00002
SRR6145060	Alloactinosynnema	674734	G	151	10	161	0.00002
SRR6145060	Alistipes	239759	G	117	27	144	0.00002
SRR6145060	Alcaligenes	507	G	139	9	148	0.00002
SRR6145060	Aerosticca	2707020	G	97	35	132	0.00002
SRR6145060	Actinobacillus	713	G	130	6	136	0.00002
SRR6145060	Acidiphilium	522	G	91	76	167	0.00002
SRR6145060	Youhaiella	1827478	G	63	3	66	0.00001
SRR6145060	Yoonia	2211641	G	42	9	51	0.00001
SRR6145060	Xylanimicrobium	289244	G	88	16	104	0.00001
SRR6145060	Xenorhabdus	626	G	53	0	53	0.00001
SRR6145060	Wolbachia	953	G	68	0	68	0.00001
SRR6145060	Winogradskyella	286104	G	75	1	76	0.00001
SRR6145060	Vogesella	57739	G	44	2	46	0.00001
SRR6145060	Vitreoscilla	59	G	44	1	45	0.00001
SRR6145060	Virgibacillus	84406	G	76	0	76	0.00001
SRR6145060	Verrucosispora	84593	G	88	15	103	0.00001
SRR6145060	Verrucomicrobium	2735	G	53	1	54	0.00001
SRR6145060	Verminephrobacter	364316	G	77	2	79	0.00001
SRR6145060	Variibacter	1649510	G	48	1	49	0.00001
SRR6145060	Vagococcus	2737	G	91	2	93	0.00001
SRR6145060	Undibacterium	401469	G	45	1	46	0.00001
SRR6145060	Trueperella	1069494	G	57	3	60	0.00001
SRR6145060	Truepera	332248	G	46	0	46	0.00001
SRR6145060	Trichodesmium	1205	G	41	2	43	0.00001
SRR6145060	Tomitella	741759	G	108	4	112	0.00001
SRR6145060	Tistrella	171436	G	65	7	72	0.00001
SRR6145060	Thiomicrorhabdus	2039723	G	51	0	51	0.00001
SRR6145060	Thiodictyon	53392	G	56	0	56	0.00001
SRR6145060	Thioclava	285107	G	97	8	105	0.00001
SRR6145060	Thermus	270	G	86	1	87	0.00001
SRR6145060	Thermomonospora	2019	G	93	8	101	0.00001
SRR6145060	Thermococcus	2263	G	66	0	66	0.00001
SRR6145060	Thermobifida	83677	G	46	1	47	0.00001
SRR6145060	Thermoanaerobacterium	28895	G	43	0	43	0.00001
SRR6145060	Thermoanaerobacter	1754	G	46	-1	45	0.00001
SRR6145060	Thermaerobacter	73918	G	67	0	67	0.00001
SRR6145060	Thalassospira	168934	G	50	1	51	0.00001
SRR6145060	Tetragenococcus	51668	G	93	3	96	0.00001
SRR6145060	Terriglobus	392733	G	61	2	63	0.00001
SRR6145060	Tatumella	82986	G	64	1	65	0.00001
SRR6145060	Tardiphaga	1395974	G	64	6	70	0.00001
SRR6145060	Tardibacter	2685927	G	70	43	113	0.00001
SRR6145060	Tabrizicola	1443919	G	78	2	80	0.00001
SRR6145060	Sulfurospirillum	57665	G	41	0	41	0.00001
SRR6145060	Sulfuritortus	1938335	G	26	62	88	0.00001
SRR6145060	Sulfurimonas	202746	G	39	0	39	0.00001
SRR6145060	Streptomonospora	104204	G	91	3	94	0.00001
SRR6145060	Streptacidiphilus	228398	G	103	4	107	0.00001
SRR6145060	Stigmatella	40	G	84	2	86	0.00001
SRR6145060	Stanieria	102115	G	43	10	53	0.00001
SRR6145060	Stackebrandtia	283810	G	95	0	95	0.00001
SRR6145060	Sporosarcina	1569	G	74	0	74	0.00001
SRR6145060	Spiribacter	1335745	G	38	38	76	0.00001
SRR6145060	Solitalea	929509	G	25	21	46	0.00001
SRR6145060	Solimonas	413435	G	100	0	100	0.00001
SRR6145060	Snodgrassella	1193515	G	21	20	41	0.00001
SRR6145060	Sneathia	168808	G	41	0	41	0.00001
SRR6145060	Simplicispira	352450	G	56	5	61	0.00001
SRR6145060	Simonsiella	71	G	73	2	75	0.00001
SRR6145060	Silicimonas	1955420	G	94	1	95	0.00001
SRR6145060	Shigella	620	G	11	39	50	0.00001
SRR6145060	Sepunavirus	1980928	G	76	5	81	0.00001
SRR6145060	Segniliparus	286801	G	44	0	44	0.00001
SRR6145060	Salinispora	168694	G	98	5	103	0.00001
SRR6145060	Salinibacterium	235888	G	105	3	108	0.00001
SRR6145060	Saccharibacillus	456492	G	38	0	38	0.00001
SRR6145060	Runella	105	G	69	0	69	0.00001
SRR6145060	Ruminococcus	1263	G	55	1	56	0.00001
SRR6145060	Rufibacter	1379908	G	51	4	55	0.00001
SRR6145060	Ruania	626119	G	78	1	79	0.00001
SRR6145060	Roseobacter	2433	G	54	0	54	0.00001
SRR6145060	Roseitalea	1915401	G	57	3	60	0.00001
SRR6145060	Roseimicrobium	1348508	G	39	0	39	0.00001
SRR6145060	Roseibacterium	159345	G	55	1	56	0.00001
SRR6145060	Roseburia	841	G	57	10	67	0.00001
SRR6145060	Romboutsia	1501226	G	40	0	40	0.00001
SRR6145060	Riemerella	34084	G	75	11	86	0.00001
SRR6145060	Rhodothermus	29548	G	40	1	41	0.00001
SRR6145060	Rhodoplanes	29407	G	76	2	78	0.00001
SRR6145060	Rhodomicrobium	1068	G	43	0	43	0.00001
SRR6145060	Raineyella	1911549	G	96	1	97	0.00001
SRR6145060	Rahnella	34037	G	76	1	77	0.00001
SRR6145060	Pyruvatibacter	1742974	G	35	17	52	0.00001
SRR6145060	Pulveribacter	2678886	G	82	11	93	0.00001
SRR6145060	Pseudorhodoplanes	1734920	G	43	1	44	0.00001
SRR6145060	Pseudodesulfovibrio	2035811	G	68	6	74	0.00001
SRR6145060	Pseudobacter	1860196	G	17	54	71	0.00001
SRR6145060	Pseudoarcobacter	2321113	G	17	31	48	0.00001
SRR6145060	Pseudescherichia	2055880	G	79	0	79	0.00001
SRR6145060	Pseudenhygromyxa	1324129	G	100	0	100	0.00001
SRR6145060	Pseudactinotalea	1926259	G	104	1	105	0.00001
SRR6145060	Proteiniphilum	294702	G	14	24	38	0.00001
SRR6145060	Prauserella	142577	G	80	2	82	0.00001
SRR6145060	Polynucleobacter	44013	G	94	3	97	0.00001
SRR6145060	Pleurocapsa	44474	G	6	32	38	0.00001
SRR6145060	Planococcus	1372	G	88	0	88	0.00001
SRR6145060	Pigmentiphaga	152267	G	97	3	100	0.00001
SRR6145060	Phytobacter	447792	G	40	32	72	0.00001
SRR6145060	Phycisphaera	666508	G	62	0	62	0.00001
SRR6145060	Photobacterium	657	G	48	2	50	0.00001
SRR6145060	Pelobacter	18	G	39	1	40	0.00001
SRR6145060	Pelagibacterium	1082930	G	40	1	41	0.00001
SRR6145060	Pediococcus	1253	G	56	3	59	0.00001
SRR6145060	Parvibaculum	256616	G	52	11	63	0.00001
SRR6145060	Paraprevotella	577309	G	64	31	95	0.00001
SRR6145060	Paraoerskovia	665568	G	63	2	65	0.00001
SRR6145060	Pandoravirus	2060084	G	38	7	45	0.00001
SRR6145060	Panacibacter	1874621	G	70	0	70	0.00001
SRR6145060	Paludisphaera	1763521	G	41	2	43	0.00001
SRR6145060	Paenarthrobacter	1742992	G	15	50	65	0.00001
SRR6145060	Oscillatoria	1158	G	30	10	40	0.00001
SRR6145060	Oryzomicrobium	1911577	G	45	1	46	0.00001
SRR6145060	Orrella	1921582	G	47	4	51	0.00001
SRR6145060	Oerskovia	162491	G	86	5	91	0.00001
SRR6145060	Odoribacter	283168	G	56	13	69	0.00001
SRR6145060	Octadecabacter	53945	G	74	3	77	0.00001
SRR6145060	Oceanicola	252301	G	66	1	67	0.00001
SRR6145060	Noviherbaspirillum	1344552	G	55	3	58	0.00001
SRR6145060	Nordella	169055	G	74	1	75	0.00001
SRR6145060	Nonlabens	363408	G	86	0	86	0.00001
SRR6145060	Niveispirillum	1543704	G	81	3	84	0.00001
SRR6145060	Nitrospirillum	1543705	G	76	2	78	0.00001
SRR6145060	Nitrospira	1234	G	55	0	55	0.00001
SRR6145060	Nitrosomonas	914	G	72	1	73	0.00001
SRR6145060	Nitrosococcus	1227	G	35	32	67	0.00001
SRR6145060	Nitrobacter	911	G	72	4	76	0.00001
SRR6145060	Nitratireductor	245876	G	105	7	112	0.00001
SRR6145060	Niabella	379899	G	55	1	56	0.00001
SRR6145060	Nesterenkonia	57494	G	59	0	59	0.00001
SRR6145060	Neomicrococcus	1868332	G	55	2	57	0.00001
SRR6145060	Neoasaia	320496	G	47	1	48	0.00001
SRR6145060	Natronolimnobius	253106	G	26	26	52	0.00001
SRR6145060	Natronococcus	29287	G	60	2	62	0.00001
SRR6145060	Natrinema	88723	G	67	6	73	0.00001
SRR6145060	Mycolicibacillus	2126281	G	91	10	101	0.00001
SRR6145060	Mycetocola	76634	G	46	1	47	0.00001
SRR6145060	Muricauda	111500	G	39	0	39	0.00001
SRR6145060	Murdochiella	1161127	G	45	5	50	0.00001
SRR6145060	Monaibacterium	2029873	G	35	6	41	0.00001
SRR6145060	Mobiluncus	2050	G	88	2	90	0.00001
SRR6145060	Mobilicoccus	984996	G	87	0	87	0.00001
SRR6145060	Microcystis	1125	G	57	10	67	0.00001
SRR6145060	Microchaete	188910	G	10	47	57	0.00001
SRR6145060	Microbulbifer	48073	G	87	1	88	0.00001
SRR6145060	Metrivirus	2560175	G	45	17	62	0.00001
SRR6145060	Methylovorus	81682	G	22	26	48	0.00001
SRR6145060	Methylomonas	416	G	61	0	61	0.00001
SRR6145060	Methyloligella	1485594	G	57	2	59	0.00001
SRR6145060	Methylococcus	413	G	45	0	45	0.00001
SRR6145060	Methylocella	120652	G	92	2	94	0.00001
SRR6145060	Methyloceanibacter	1484898	G	46	1	47	0.00001
SRR6145060	Methanococcus	2184	G	52	0	52	0.00001
SRR6145060	Methanobrevibacter	2172	G	43	0	43	0.00001
SRR6145060	Mesoplasma	46239	G	39	2	41	0.00001
SRR6145060	Melaminivora	1649468	G	75	19	94	0.00001
SRR6145060	Meiothermus	65551	G	64	1	65	0.00001
SRR6145060	Megamonas	158846	G	53	0	53	0.00001
SRR6145060	Mediterraneibacter	2316020	G	35	9	44	0.00001
SRR6145060	Marisediminicola	1230698	G	65	1	66	0.00001
SRR6145060	Marichromatium	85076	G	38	1	39	0.00001
SRR6145060	Maribius	387095	G	48	0	48	0.00001
SRR6145060	Maribacter	252356	G	63	0	63	0.00001
SRR6145060	Mameliella	1434019	G	81	13	94	0.00001
SRR6145060	Lysinimonas	1434018	G	87	8	95	0.00001
SRR6145060	Lysinibacillus	400634	G	91	1	92	0.00001
SRR6145060	Luteitalea	2004797	G	56	0	56	0.00001
SRR6145060	Longibaculum	1918538	G	20	32	52	0.00001
SRR6145060	Limnohabitans	665874	G	38	1	39	0.00001
SRR6145060	Limnoglobus	2731450	G	62	0	62	0.00001
SRR6145060	Lichenihabitans	2723776	G	43	1	44	0.00001
SRR6145060	Leptospira	171	G	78	-12	66	0.00001
SRR6145060	Leptolyngbya	47251	G	71	13	84	0.00001
SRR6145060	Lelliottia	1330545	G	64	5	69	0.00001
SRR6145060	Lacipirellula	2691417	G	41	22	63	0.00001
SRR6145060	Lacinutrix	291183	G	44	0	44	0.00001
SRR6145060	Lachnoclostridium	1506553	G	47	7	54	0.00001
SRR6145060	Labrys	204476	G	107	2	109	0.00001
SRR6145060	Labilithrix	1524217	G	105	1	106	0.00001
SRR6145060	Kushneria	504090	G	43	0	43	0.00001
SRR6145060	Kurthia	1649	G	71	1	72	0.00001
SRR6145060	Kochikohdavirus	2560160	G	1	52	53	0.00001
SRR6145060	Kluyvera	579	G	67	3	70	0.00001
SRR6145060	Kingella	32257	G	52	1	53	0.00001
SRR6145060	Ketogulonicigenium	92944	G	91	3	94	0.00001
SRR6145060	Kerstersia	257820	G	22	22	44	0.00001
SRR6145060	Kangiella	261963	G	41	0	41	0.00001
SRR6145060	Jeotgalibaca	1470540	G	59	2	61	0.00001
SRR6145060	Jeongeupia	885864	G	42	1	43	0.00001
SRR6145060	Inhella	644355	G	95	9	104	0.00001
SRR6145060	Immundisolibacter	1934947	G	44	0	44	0.00001
SRR6145060	Ilumatobacter	682522	G	56	0	56	0.00001
SRR6145060	Hyphomonas	85	G	69	0	69	0.00001
SRR6145060	Hyphomicrobium	81	G	103	2	105	0.00001
SRR6145060	Hylemonella	232523	G	44	2	46	0.00001
SRR6145060	Hydrogenophilus	70774	G	44	0	44	0.00001
SRR6145060	Hoyosella	697025	G	73	0	73	0.00001
SRR6145060	Hoeflea	274591	G	60	2	62	0.00001
SRR6145060	Herbiconiux	881616	G	79	4	83	0.00001
SRR6145060	Hartmannibacter	1572860	G	55	3	58	0.00001
SRR6145060	Halovulum	1844498	G	70	3	73	0.00001
SRR6145060	Haloterrigena	121871	G	55	2	57	0.00001
SRR6145060	Haloplanus	376170	G	74	2	76	0.00001
SRR6145060	Halomicrobium	203135	G	41	1	42	0.00001
SRR6145060	Haloferax	2251	G	73	0	73	0.00001
SRR6145060	Halobacterium	2239	G	69	12	81	0.00001
SRR6145060	Haloarcula	2237	G	64	-1	63	0.00001
SRR6145060	Haloactinobacterium	1331737	G	89	2	91	0.00001
SRR6145060	Halioglobus	1217416	G	28	19	47	0.00001
SRR6145060	Haliangium	162027	G	104	1	105	0.00001
SRR6145060	Gryllotalpicola	1195526	G	93	4	97	0.00001
SRR6145060	Granulicella	940557	G	49	1	50	0.00001
SRR6145060	Gramella	292691	G	69	0	69	0.00001
SRR6145060	Gluconacetobacter	89583	G	63	1	64	0.00001
SRR6145060	Gloeothece	28070	G	41	3	44	0.00001
SRR6145060	Glaesserella	2094023	G	52	56	108	0.00001
SRR6145060	Georhizobium	2661800	G	52	5	57	0.00001
SRR6145060	Geobacillus	129337	G	107	2	109	0.00001
SRR6145060	Gemmobacter	204456	G	83	4	87	0.00001
SRR6145060	Gemmatimonas	173479	G	62	0	62	0.00001
SRR6145060	Geminocystis	669357	G	87	8	95	0.00001
SRR6145060	Frateuria	70411	G	45	3	48	0.00001
SRR6145060	Francisella	262	G	104	1	105	0.00001
SRR6145060	Formosa	225842	G	101	1	102	0.00001
SRR6145060	Flavisolibacter	398041	G	107	2	109	0.00001
SRR6145060	Flavihumibacter	1004301	G	41	1	42	0.00001
SRR6145060	Flaviflexus	1522056	G	66	2	68	0.00001
SRR6145060	Flammeovirga	59739	G	39	26	65	0.00001
SRR6145060	Fischerella	1190	G	62	12	74	0.00001
SRR6145060	Fimbriimonas	1005038	G	24	14	38	0.00001
SRR6145060	Fictibacillus	1329200	G	63	0	63	0.00001
SRR6145060	Fibrella	861914	G	65	2	67	0.00001
SRR6145060	Ferrovibrio	1231242	G	47	0	47	0.00001
SRR6145060	Fastidiosipila	236752	G	74	5	79	0.00001
SRR6145060	Euzebya	908623	G	71	0	71	0.00001
SRR6145060	Erysipelothrix	1647	G	46	0	46	0.00001
SRR6145060	Epibacterium	1649279	G	37	10	47	0.00001
SRR6145060	Egicoccus	1755825	G	70	0	70	0.00001
SRR6145060	Eggerthella	84111	G	38	5	43	0.00001
SRR6145060	Edwardsiella	635	G	53	2	55	0.00001
SRR6145060	Echinicola	390846	G	42	1	43	0.00001
SRR6145060	Dyadobacter	120831	G	59	1	60	0.00001
SRR6145060	Duncaniella	2518495	G	33	17	50	0.00001
SRR6145060	Draconibacterium	1471399	G	36	19	55	0.00001
SRR6145060	Dolichospermum	748770	G	25	47	72	0.00001
SRR6145060	Dinoroseobacter	309512	G	71	28	99	0.00001
SRR6145060	Diaminobutyricimonas	1433997	G	65	2	67	0.00001
SRR6145060	Dialister	39948	G	47	0	47	0.00001
SRR6145060	Desulfosarcina	2299	G	53	1	54	0.00001
SRR6145060	Denitratisoma	311181	G	35	10	45	0.00001
SRR6145060	Dechloromonas	73029	G	40	46	86	0.00001
SRR6145060	Cytophaga	978	G	53	0	53	0.00001
SRR6145060	Cyanobium	167375	G	38	5	43	0.00001
SRR6145060	Crenobacter	1654931	G	46	2	48	0.00001
SRR6145060	Confluentimicrobium	1609958	G	63	31	94	0.00001
SRR6145060	Colwellia	28228	G	79	1	80	0.00001
SRR6145060	Collinsella	102106	G	73	7	80	0.00001
SRR6145060	Cohnella	329857	G	39	0	39	0.00001
SRR6145060	Citromicrobium	72173	G	79	18	97	0.00001
SRR6145060	Chondromyces	50	G	85	1	86	0.00001
SRR6145060	Chlamydia	810	G	40	0	40	0.00001
SRR6145060	Chelativorans	449972	G	55	2	57	0.00001
SRR6145060	Cellulophaga	104264	G	84	0	84	0.00001
SRR6145060	Cedecea	158483	G	43	1	44	0.00001
SRR6145060	Caldicellulosiruptor	44000	G	45	0	45	0.00001
SRR6145060	Butyricimonas	574697	G	43	47	90	0.00001
SRR6145060	Brucella	234	G	35	6	41	0.00001
SRR6145060	Brevirhabdus	1855413	G	65	23	88	0.00001
SRR6145060	Brevibacillus	55080	G	69	0	69	0.00001
SRR6145060	Breoghania	1406135	G	49	1	50	0.00001
SRR6145060	Brenneria	71655	G	41	0	41	0.00001
SRR6145060	Bradymonas	1779136	G	23	56	79	0.00001
SRR6145060	Brachyspira	29521	G	108	0	108	0.00001
SRR6145060	Borrelia	138	G	92	-4	88	0.00001
SRR6145060	Blautia	572511	G	85	10	95	0.00001
SRR6145060	Blattabacterium	34098	G	84	0	84	0.00001
SRR6145060	Betaretrovirus	140052	G	1	56	57	0.00001
SRR6145060	Bermanella	599651	G	72	0	72	0.00001
SRR6145060	Bergeyella	59735	G	56	0	56	0.00001
SRR6145060	Bdellovibrio	958	G	97	1	98	0.00001
SRR6145060	Bartonella	773	G	105	2	107	0.00001
SRR6145060	Bacteriovorax	146784	G	53	0	53	0.00001
SRR6145060	Azotobacter	352	G	145	-39	106	0.00001
SRR6145060	Austwickia	1184606	G	59	0	59	0.00001
SRR6145060	Auritidibacter	1160973	G	43	0	43	0.00001
SRR6145060	Auricoccus	2005363	G	48	1	49	0.00001
SRR6145060	Atopobium	1380	G	68	0	68	0.00001
SRR6145060	Atlantibacter	1903434	G	71	2	73	0.00001
SRR6145060	Arthrospira	35823	G	27	45	72	0.00001
SRR6145060	Aromatoleum	551759	G	44	26	70	0.00001
SRR6145060	Arenimonas	490567	G	84	4	88	0.00001
SRR6145060	Arachidicoccus	1769012	G	110	1	111	0.00001
SRR6145060	Aquitalea	407217	G	78	4	82	0.00001
SRR6145060	Aquisphaera	1511635	G	95	3	98	0.00001
SRR6145060	Aquimarina	290174	G	58	0	58	0.00001
SRR6145060	Apibacter	1778601	G	38	0	38	0.00001
SRR6145060	Anoxybacillus	150247	G	83	2	85	0.00001
SRR6145060	Anaerostipes	207244	G	49	4	53	0.00001
SRR6145060	Aminipila	2060094	G	39	14	53	0.00001
SRR6145060	Alkaliphilus	114627	G	23	24	47	0.00001
SRR6145060	Aliivibrio	511678	G	49	1	50	0.00001
SRR6145060	Alienimonas	2714737	G	39	0	39	0.00001
SRR6145060	Algibacter	261827	G	69	1	70	0.00001
SRR6145060	Akkermansia	239934	G	16	31	47	0.00001
SRR6145060	Afipia	1033	G	51	36	87	0.00001
SRR6145060	Actinotignum	1653174	G	47	0	47	0.00001
SRR6145060	Actinopolyspora	1849	G	46	0	46	0.00001
SRR6145060	Actinopolymorpha	117156	G	106	1	107	0.00001
SRR6145060	Acidithiobacillus	119977	G	46	-3	43	0.00001
SRR6145060	Acidimicrobium	53634	G	22	27	49	0.00001
SRR6145060	Acidihalobacter	1765964	G	60	1	61	0.00001
SRR6145060	Acidibrevibacterium	2603324	G	44	0	44	0.00001
SRR6145060	Zymomonas	541	G	18	5	23	0.00000
SRR6145060	Zunongwangia	417127	G	23	1	24	0.00000
SRR6145060	Zobellia	112040	G	18	0	18	0.00000
SRR6145060	Zobellella	347533	G	36	0	36	0.00000
SRR6145060	Zhongshania	1434050	G	7	0	7	0.00000
SRR6145060	Zetavirus	2733222	G	2	0	2	0.00000
SRR6145060	Yvonnevirus	2560257	G	1	0	1	0.00000
SRR6145060	Yuavirus	1299429	G	2	0	2	0.00000
SRR6145060	Yoloswagvirus	2733142	G	2	0	2	0.00000
SRR6145060	Yokenella	158876	G	13	0	13	0.00000
SRR6145060	Yatapoxvirus	10282	G	1	1	2	0.00000
SRR6145060	Xylella	2370	G	17	0	17	0.00000
SRR6145060	Wphvirus	1922327	G	2	0	2	0.00000
SRR6145060	Wolinella	843	G	2	0	2	0.00000
SRR6145060	Woeseia	1738655	G	17	0	17	0.00000
SRR6145060	Wizardvirus	2169658	G	4	0	4	0.00000
SRR6145060	Wigglesworthia	51228	G	10	7	17	0.00000
SRR6145060	Whispovirus	249585	G	2	0	2	0.00000
SRR6145060	Wenzhouxiangella	1676142	G	20	0	20	0.00000
SRR6145060	Wenyingzhuangia	1518147	G	14	0	14	0.00000
SRR6145060	Weeksella	1013	G	29	0	29	0.00000
SRR6145060	Webervirus	1920860	G	3	0	3	0.00000
SRR6145060	Weaselvirus	2560253	G	2	0	2	0.00000
SRR6145060	Waddlia	71666	G	3	0	3	0.00000
SRR6145060	Vulgatibacter	1524214	G	32	0	32	0.00000
SRR6145060	Vulcanisaeta	164450	G	7	0	7	0.00000
SRR6145060	Vividuovirus	2560251	G	1	-1	0	0.00000
SRR6145060	Vieuvirus	2560250	G	3	5	8	0.00000
SRR6145060	Victorivirus	674981	G	1	0	1	0.00000
SRR6145060	Vicosavirus	2560248	G	1	0	1	0.00000
SRR6145060	Vhulanivirus	2560247	G	2	0	2	0.00000
SRR6145060	Vendettavirus	2049885	G	1	-1	0	0.00000
SRR6145060	Velarivirus	1513308	G	1	0	1	0.00000
SRR6145060	Varicellovirus	10319	G	4	0	4	0.00000
SRR6145060	Vampirococcus	1930592	G	4	0	4	0.00000
SRR6145060	Ureibacillus	160795	G	10	1	11	0.00000
SRR6145060	Urechidicola	2700084	G	23	0	23	0.00000
SRR6145060	Ureaplasma	2129	G	13	0	13	0.00000
SRR6145060	Uliginvirus	2731677	G	1	0	1	0.00000
SRR6145060	Tymovirus	12148	G	1	0	1	0.00000
SRR6145060	Twortvirus	1857846	G	5	3	8	0.00000
SRR6145060	Tuwongella	2051044	G	11	0	11	0.00000
SRR6145060	Turicibacter	191303	G	16	0	16	0.00000
SRR6145060	Tunavirus	187217	G	1	1	2	0.00000
SRR6145060	Tumebacillus	432330	G	29	0	29	0.00000
SRR6145060	Tropheryma	2038	G	3	-3	0	0.00000
SRR6145060	Trichormus	264688	G	14	2	16	0.00000
SRR6145060	Tortellinivirus	2560240	G	1	0	1	0.00000
SRR6145060	Tolypothrix	111782	G	17	14	31	0.00000
SRR6145060	Tolumonas	43947	G	12	0	12	0.00000
SRR6145060	Tissierella	41273	G	19	11	30	0.00000
SRR6145060	Tinduovirus	1982569	G	2	0	2	0.00000
SRR6145060	Timquatrovirus	1623306	G	9	0	9	0.00000
SRR6145060	Thioploca	40751	G	9	0	9	0.00000
SRR6145060	Thiomicrospira	933	G	13	0	13	0.00000
SRR6145060	Thiolapillus	1608298	G	6	0	6	0.00000
SRR6145060	Thiohalobacter	1273155	G	31	1	32	0.00000
SRR6145060	Thioflavicoccus	156885	G	20	0	20	0.00000
SRR6145060	Thiocystis	13724	G	21	0	21	0.00000
SRR6145060	Thiobacillus	919	G	26	1	27	0.00000
SRR6145060	Thermovirga	336260	G	4	0	4	0.00000
SRR6145060	Thermovibrio	171868	G	1	0	1	0.00000
SRR6145060	Thermotoga	2335	G	7	0	7	0.00000
SRR6145060	Thermosynechococcus	146785	G	13	0	13	0.00000
SRR6145060	Thermosulfuriphilus	2033601	G	3	0	3	0.00000
SRR6145060	Thermosulfurimonas	1522431	G	5	0	5	0.00000
SRR6145060	Thermosulfidibacter	412592	G	6	0	6	0.00000
SRR6145060	Thermosphaera	54253	G	4	0	4	0.00000
SRR6145060	Thermosipho	2420	G	16	-8	8	0.00000
SRR6145060	Thermosediminibacter	291988	G	7	0	7	0.00000
SRR6145060	Thermoproteus	2270	G	11	0	11	0.00000
SRR6145060	Thermoplasma	2302	G	4	0	4	0.00000
SRR6145060	Thermomicrobium	499	G	4	0	4	0.00000
SRR6145060	Thermoleptolyngbya	2303528	G	10	8	18	0.00000
SRR6145060	Thermofilum	2268	G	6	0	6	0.00000
SRR6145060	Thermodesulfovibrio	28261	G	5	0	5	0.00000
SRR6145060	Thermodesulfobium	227388	G	15	6	21	0.00000
SRR6145060	Thermodesulfobacterium	1740	G	14	0	14	0.00000
SRR6145060	Thermodesulfatator	241192	G	4	0	4	0.00000
SRR6145060	Thermocrinis	75905	G	3	0	3	0.00000
SRR6145060	Thermoclostridium	2304691	G	9	1	10	0.00000
SRR6145060	Thermochromatium	85073	G	22	0	22	0.00000
SRR6145060	Thermobaculum	262406	G	5	0	5	0.00000
SRR6145060	Thermobacillus	76632	G	15	0	15	0.00000
SRR6145060	Thermoactinomyces	2023	G	9	0	9	0.00000
SRR6145060	Thermincola	278993	G	11	0	11	0.00000
SRR6145060	Thermanaerovibrio	81461	G	10	0	10	0.00000
SRR6145060	Thermanaeromonas	202949	G	2	0	2	0.00000
SRR6145060	Thermacetogenium	140458	G	1	0	1	0.00000
SRR6145060	Thalassotalea	1518149	G	19	0	19	0.00000
SRR6145060	Thalassolituus	187492	G	10	0	10	0.00000
SRR6145060	Thalassococcus	436357	G	33	0	33	0.00000
SRR6145060	Thalassobius	335927	G	31	0	31	0.00000
SRR6145060	Teseptimavirus	110456	G	2	2	4	0.00000
SRR6145060	Terribacillus	459532	G	11	0	11	0.00000
SRR6145060	Teredinibacter	2425	G	9	0	9	0.00000
SRR6145060	Terapinvirus	2733216	G	1	0	1	0.00000
SRR6145060	Tequintavirus	187218	G	1	-1	0	0.00000
SRR6145060	Tequatrovirus	10663	G	6	0	6	0.00000
SRR6145060	Tepidiforma	2682228	G	27	7	34	0.00000
SRR6145060	Tepidanaerobacter	499228	G	5	0	5	0.00000
SRR6145060	Tegunavirus	1921704	G	1	-1	0	0.00000
SRR6145060	Taylorella	29574	G	31	0	31	0.00000
SRR6145060	Tatlockia	465	G	6	0	6	0.00000
SRR6145060	Tateyamaria	299261	G	30	0	30	0.00000
SRR6145060	Taranisvirus	2733134	G	1	1	2	0.00000
SRR6145060	Tankvirus	1982566	G	1	0	1	0.00000
SRR6145060	Tamlana	393005	G	18	0	18	0.00000
SRR6145060	Taipeivirus	2731621	G	10	0	10	0.00000
SRR6145060	Syntrophus	43773	G	1	0	1	0.00000
SRR6145060	Syntrophothermus	129001	G	3	0	3	0.00000
SRR6145060	Syntrophomonas	862	G	4	0	4	0.00000
SRR6145060	Syntrophobotulus	51196	G	8	0	8	0.00000
SRR6145060	Syntrophobacter	29526	G	4	0	4	0.00000
SRR6145060	Synechocystis	1142	G	11	1	12	0.00000
SRR6145060	Symbiobacterium	2733	G	28	0	28	0.00000
SRR6145060	Swingsia	1649499	G	13	0	13	0.00000
SRR6145060	Suwonvirus	2732964	G	1	0	1	0.00000
SRR6145060	Sutterella	40544	G	31	0	31	0.00000
SRR6145060	Sulfurovum	265570	G	7	0	7	0.00000
SRR6145060	Sulfurivermis	2034504	G	18	2	20	0.00000
SRR6145060	Sulfuritalea	1054211	G	24	0	24	0.00000
SRR6145060	Sulfurisphaera	69655	G	10	0	10	0.00000
SRR6145060	Sulfurihydrogenibium	212790	G	9	0	9	0.00000
SRR6145060	Sulfurifustis	1692042	G	26	0	26	0.00000
SRR6145060	Sulfuriflexus	1860077	G	13	0	13	0.00000
SRR6145060	Sulfuriferula	1778653	G	28	1	29	0.00000
SRR6145060	Sulfuricurvum	286130	G	4	0	4	0.00000
SRR6145060	Sulfuricella	935200	G	18	0	18	0.00000
SRR6145060	Sulfuricaulis	1744881	G	30	0	30	0.00000
SRR6145060	Sulfuracidifex	2705406	G	4	0	4	0.00000
SRR6145060	Sulfolobus	2284	G	27	1	28	0.00000
SRR6145060	Sulfodiicoccus	2017961	G	2	0	2	0.00000
SRR6145060	Suipoxvirus	10275	G	1	0	1	0.00000
SRR6145060	Suicoccus	2689587	G	13	0	13	0.00000
SRR6145060	Sugarlandvirus	2560233	G	3	0	3	0.00000
SRR6145060	Succinivibrio	83770	G	8	0	8	0.00000
SRR6145060	Stygiolobus	41674	G	4	0	4	0.00000
SRR6145060	Streptobacillus	34104	G	29	0	29	0.00000
SRR6145060	Stopavirus	2731979	G	1	0	1	0.00000
SRR6145060	Sterolibacterium	157591	G	17	0	17	0.00000
SRR6145060	Steroidobacter	469322	G	21	1	22	0.00000
SRR6145060	Staphylothermus	2279	G	5	0	5	0.00000
SRR6145060	Staphylospora	2689589	G	7	0	7	0.00000
SRR6145060	Squashvirus	2733215	G	3	0	3	0.00000
SRR6145060	Sporomusa	2375	G	4	0	4	0.00000
SRR6145060	Sporolactobacillus	2077	G	11	4	15	0.00000
SRR6145060	Spongiibacter	630749	G	5	0	5	0.00000
SRR6145060	Spirochaeta	146	G	29	0	29	0.00000
SRR6145060	Sphaerospermopsis	752201	G	15	3	18	0.00000
SRR6145060	Sphaerochaeta	399320	G	13	0	13	0.00000
SRR6145060	Sphaerobacter	2056	G	31	0	31	0.00000
SRR6145060	Solibacillus	648800	G	28	0	28	0.00000
SRR6145060	Sodalis	84565	G	25	0	25	0.00000
SRR6145060	Slopekvirus	1985328	G	1	1	2	0.00000
SRR6145060	Slackia	84108	G	12	0	12	0.00000
SRR6145060	Skunavirus	1623305	G	11	1	12	0.00000
SRR6145060	Sinimarinibacterium	1861863	G	15	1	16	0.00000
SRR6145060	Singulisphaera	466152	G	29	0	29	0.00000
SRR6145060	Simplexvirus	10294	G	8	0	8	0.00000
SRR6145060	Simkania	34093	G	5	0	5	0.00000
SRR6145060	Simiduia	447467	G	8	0	8	0.00000
SRR6145060	Silviavirus	1857889	G	6	-6	0	0.00000
SRR6145060	Silvanigrella	2024975	G	11	0	11	0.00000
SRR6145060	Sideroxydans	314343	G	10	0	10	0.00000
SRR6145060	Siansivirga	1204360	G	13	0	13	0.00000
SRR6145060	Shimwellia	1335483	G	18	0	18	0.00000
SRR6145060	Shenzhenvirus	2732038	G	1	-1	0	0.00000
SRR6145060	Sextaecvirus	1922243	G	33	0	33	0.00000
SRR6145060	Seonamhaeicola	1649495	G	19	0	19	0.00000
SRR6145060	Sediminispirochaeta	1911556	G	3	0	3	0.00000
SRR6145060	Sediminicola	389486	G	10	0	10	0.00000
SRR6145060	Sedimentisphaera	2483368	G	6	1	7	0.00000
SRR6145060	Sedimenticola	349742	G	10	0	10	0.00000
SRR6145060	Sebaldella	32068	G	12	0	12	0.00000
SRR6145060	Scottvirus	2731973	G	2	0	2	0.00000
SRR6145060	Sciuripoxvirus	2733300	G	1	0	1	0.00000
SRR6145060	Schnabeltiervirus	2733211	G	2	0	2	0.00000
SRR6145060	Schizotequatrovirus	1198137	G	1	0	1	0.00000
SRR6145060	Schiekvirus	2732968	G	2	0	2	0.00000
SRR6145060	Scardovia	196081	G	4	0	4	0.00000
SRR6145060	Scapunavirus	2560225	G	2	0	2	0.00000
SRR6145060	Scandinavium	2726810	G	20	0	20	0.00000
SRR6145060	Sasquatchvirus	2733131	G	1	0	1	0.00000
SRR6145060	Saprospira	1007	G	5	0	5	0.00000
SRR6145060	Sansavirus	2733209	G	2	0	2	0.00000
SRR6145060	Sanovirus	2560222	G	4	0	4	0.00000
SRR6145060	Salmondvirus	2733130	G	2	0	2	0.00000
SRR6145060	Salivirus	688449	G	1	2	3	0.00000
SRR6145060	Salinivirga	1970191	G	16	0	16	0.00000
SRR6145060	Salinivibrio	51366	G	16	0	16	0.00000
SRR6145060	Salinispira	1616789	G	3	0	3	0.00000
SRR6145060	Salinisphaera	180541	G	34	0	34	0.00000
SRR6145060	Saliniradius	2661818	G	5	0	5	0.00000
SRR6145060	Salinimonas	288793	G	26	1	27	0.00000
SRR6145060	Salinigranum	1644057	G	37	0	37	0.00000
SRR6145060	Salinicola	404432	G	31	0	31	0.00000
SRR6145060	Salinicoccus	45669	G	27	0	27	0.00000
SRR6145060	Salinibaculum	2732368	G	14	3	17	0.00000
SRR6145060	Salinibacter	146918	G	37	0	37	0.00000
SRR6145060	Salinarchaeum	1269201	G	21	0	21	0.00000
SRR6145060	Salimicrobium	351195	G	6	0	6	0.00000
SRR6145060	Salicibibacter	2685905	G	11	0	11	0.00000
SRR6145060	Salegentibacter	143222	G	32	0	32	0.00000
SRR6145060	Salarchaeum	1075398	G	18	0	18	0.00000
SRR6145060	Salaquimonas	2712688	G	14	0	14	0.00000
SRR6145060	Saclayvirus	2733128	G	1	-1	0	0.00000
SRR6145060	Saccharospirillum	231683	G	13	0	13	0.00000
SRR6145060	Saccharophagus	316625	G	9	0	9	0.00000
SRR6145060	Saccharolobus	2100760	G	7	0	7	0.00000
SRR6145060	Ruthenibacterium	1905344	G	16	17	33	0.00000
SRR6145060	Rummeliibacillus	648802	G	5	0	5	0.00000
SRR6145060	Ruminiclostridium	1508657	G	14	0	14	0.00000
SRR6145060	Rudivirus	187213	G	2	0	2	0.00000
SRR6145060	Rubinisphaera	1649490	G	12	0	12	0.00000
SRR6145060	Rouxiella	1565532	G	29	0	29	0.00000
SRR6145060	Roseolovirus	40272	G	5	0	5	0.00000
SRR6145060	Rosenblumvirus	680287	G	4	0	4	0.00000
SRR6145060	Roseimaritima	1579506	G	24	0	24	0.00000
SRR6145060	Roseiflexus	120961	G	36	0	36	0.00000
SRR6145060	Rogerhendrixvirus	2733204	G	1	0	1	0.00000
SRR6145060	Rodentibacter	1960084	G	20	8	28	0.00000
SRR6145060	Robiginitalea	252306	G	19	0	19	0.00000
SRR6145060	Rivularia	373984	G	18	1	19	0.00000
SRR6145060	Rippkaea	2546365	G	18	1	19	0.00000
SRR6145060	Rickettsiella	59195	G	6	0	6	0.00000
SRR6145060	Rhodopirellula	265488	G	9	0	9	0.00000
SRR6145060	Rhodoluna	529883	G	21	0	21	0.00000
SRR6145060	Rhodocytophaga	455076	G	33	0	33	0.00000
SRR6145060	Rhodobaca	119541	G	31	0	31	0.00000
SRR6145060	Rhadinovirus	10379	G	4	0	4	0.00000
SRR6145060	Renibacterium	1645	G	12	0	12	0.00000
SRR6145060	Reinekea	230494	G	10	0	10	0.00000
SRR6145060	Redivirus	2169634	G	1	-1	0	0.00000
SRR6145060	Ravinvirus	308911	G	1	2	3	0.00000
SRR6145060	Raphidovirus	573012	G	2	0	2	0.00000
SRR6145060	Raphidiopsis	244599	G	18	3	21	0.00000
SRR6145060	Raleighvirus	2733203	G	1	0	1	0.00000
SRR6145060	Quhwahvirus	2733202	G	1	-1	0	0.00000
SRR6145060	Pyrolobus	54251	G	4	0	4	0.00000
SRR6145060	Pyrodictium	2308	G	1	0	1	0.00000
SRR6145060	Pyrococcus	2260	G	16	-2	14	0.00000
SRR6145060	Pyrobaculum	2276	G	16	0	16	0.00000
SRR6145060	Pusillimonas	305976	G	35	1	36	0.00000
SRR6145060	Psychroserpens	49277	G	21	2	23	0.00000
SRR6145060	Psychromonas	67572	G	17	0	17	0.00000
SRR6145060	Psychromicrobium	2078575	G	31	0	31	0.00000
SRR6145060	Psychroflexus	83612	G	20	0	20	0.00000
SRR6145060	Psychrobacillus	1221880	G	10	0	10	0.00000
SRR6145060	Pseudovibrio	258255	G	10	0	10	0.00000
SRR6145060	Pseudothermotoga	1643951	G	6	0	6	0.00000
SRR6145060	Pseudorhodobacter	238783	G	30	0	30	0.00000
SRR6145060	Pseudopedobacter	1649482	G	33	1	34	0.00000
SRR6145060	Pseudolysobacter	2709666	G	19	0	19	0.00000
SRR6145060	Pseudohongiella	1524249	G	10	6	16	0.00000
SRR6145060	Pseudohalocynthiibacter	1759417	G	31	4	35	0.00000
SRR6145060	Pseudogulbenkiania	568394	G	28	2	30	0.00000
SRR6145060	Pseudoclostridium	2304693	G	8	0	8	0.00000
SRR6145060	Pseudobutyrivibrio	46205	G	12	0	12	0.00000
SRR6145060	Pseudanabaena	1152	G	29	1	30	0.00000
SRR6145060	Prosthecochloris	1101	G	20	0	20	0.00000
SRR6145060	Proboscivirus	548689	G	2	1	3	0.00000
SRR6145060	Prasinovirus	181084	G	3	0	3	0.00000
SRR6145060	Pragia	82984	G	17	0	17	0.00000
SRR6145060	Pradoshia	2651279	G	15	0	15	0.00000
SRR6145060	Potexvirus	12176	G	1	0	1	0.00000
SRR6145060	Pontimonas	1434032	G	7	0	7	0.00000
SRR6145060	Pontibacillus	289201	G	9	0	9	0.00000
SRR6145060	Pollyceevirus	2560206	G	1	0	1	0.00000
SRR6145060	Polerovirus	119164	G	11	-11	0	0.00000
SRR6145060	Plotvirus	2169613	G	2	0	2	0.00000
SRR6145060	Plesiomonas	702	G	21	0	21	0.00000
SRR6145060	Planktothrix	54304	G	8	2	10	0.00000
SRR6145060	Planktomarina	1284657	G	7	0	7	0.00000
SRR6145060	Planctopirus	1649480	G	16	0	16	0.00000
SRR6145060	Pistricoccus	1897649	G	19	0	19	0.00000
SRR6145060	Piscirickettsia	1237	G	12	0	12	0.00000
SRR6145060	Pirellula	123	G	22	0	22	0.00000
SRR6145060	Pipefishvirus	1982899	G	1	-1	0	0.00000
SRR6145060	Picrophilus	46631	G	5	0	5	0.00000
SRR6145060	Picardvirus	2733201	G	1	0	1	0.00000
SRR6145060	Phyllobacterium	28100	G	28	1	29	0.00000
SRR6145060	Photorhabdus	29487	G	29	0	29	0.00000
SRR6145060	Phoenicibacter	1981050	G	14	0	14	0.00000
SRR6145060	Phimunavirus	2560202	G	2	0	2	0.00000
SRR6145060	Phikzvirus	680115	G	2	0	2	0.00000
SRR6145060	Phicbkvirus	1623296	G	3	0	3	0.00000
SRR6145060	Phascolarctobacterium	33024	G	15	0	15	0.00000
SRR6145060	Pettyvirus	2731671	G	1	0	1	0.00000
SRR6145060	Petrotoga	28236	G	9	0	9	0.00000
SRR6145060	Petrocella	2603323	G	10	0	10	0.00000
SRR6145060	Petrimonas	307628	G	13	2	15	0.00000
SRR6145060	Persephonella	182899	G	5	0	5	0.00000
SRR6145060	Permianibacter	1649479	G	18	6	24	0.00000
SRR6145060	Percavirus	548688	G	1	0	1	0.00000
SRR6145060	Pepyhexavirus	1982367	G	1	0	1	0.00000
SRR6145060	Peptacetobacter	2743582	G	19	0	19	0.00000
SRR6145060	Pelosinus	365348	G	32	1	33	0.00000
SRR6145060	Pelolinea	1649478	G	7	0	7	0.00000
SRR6145060	Pelodictyon	1099	G	10	0	10	0.00000
SRR6145060	Pelistega	106146	G	9	0	9	0.00000
SRR6145060	Pelagivirus	2731966	G	1	0	1	0.00000
SRR6145060	Peatvirus	2560201	G	1	0	1	0.00000
SRR6145060	Pbunavirus	1198980	G	1	-1	0	0.00000
SRR6145060	Parvularcula	208215	G	10	0	10	0.00000
SRR6145060	Parolsenella	2082587	G	10	10	20	0.00000
SRR6145060	Parashewanella	2547964	G	21	0	21	0.00000
SRR6145060	Parasedimentitalea	2738399	G	10	0	10	0.00000
SRR6145060	Parascardovia	196082	G	27	0	27	0.00000
SRR6145060	Parasaccharibacter	1602345	G	8	0	8	0.00000
SRR6145060	Pararhodospirillum	1612157	G	30	0	30	0.00000
SRR6145060	Parapoxvirus	10257	G	3	0	3	0.00000
SRR6145060	Paraphotobacterium	2042066	G	11	0	11	0.00000
SRR6145060	Paraliobacillus	200903	G	9	9	18	0.00000
SRR6145060	Paraglaciecola	1621534	G	26	0	26	0.00000
SRR6145060	Parageobacillus	1906945	G	20	0	20	0.00000
SRR6145060	Paraflavitalea	2698688	G	26	0	26	0.00000
SRR6145060	Paraclostridium	1849822	G	18	0	18	0.00000
SRR6145060	Parachlamydia	83551	G	11	0	11	0.00000
SRR6145060	Papyrusvirus	1982554	G	1	0	1	0.00000
SRR6145060	Pamexvirus	1982355	G	2	0	2	0.00000
SRR6145060	Paludibacter	346096	G	16	0	16	0.00000
SRR6145060	Pajaroellobacter	1882917	G	3	0	3	0.00000
SRR6145060	Pagevirus	1921184	G	1	0	1	0.00000
SRR6145060	Paenisporosarcina	651660	G	18	0	18	0.00000
SRR6145060	Paeniclostridium	1849828	G	18	0	18	0.00000
SRR6145060	Paenalcaligenes	1100891	G	4	0	4	0.00000
SRR6145060	Paadamvirus	2731961	G	1	0	1	0.00000
SRR6145060	Oxynema	1492710	G	10	2	12	0.00000
SRR6145060	Oxalobacter	846	G	10	0	10	0.00000
SRR6145060	Owenweeksia	267986	G	21	0	21	0.00000
SRR6145060	Otariodibacter	1249016	G	11	0	11	0.00000
SRR6145060	Oscillibacter	459786	G	4	3	7	0.00000
SRR6145060	Oryzopoxvirus	2733297	G	2	0	2	0.00000
SRR6145060	Orthopoxvirus	10242	G	3	-3	0	0.00000
SRR6145060	Orthohantavirus	1980442	G	1	0	1	0.00000
SRR6145060	Orthobunyavirus	11572	G	1	0	1	0.00000
SRR6145060	Ornithobacterium	28250	G	27	0	27	0.00000
SRR6145060	Orientia	69474	G	17	0	17	0.00000
SRR6145060	Orchidvirus	2560193	G	1	0	1	0.00000
SRR6145060	Orbus	743714	G	7	0	7	0.00000
SRR6145060	Oneupvirus	2733200	G	3	0	3	0.00000
SRR6145060	Omegavirus	1623292	G	2	0	2	0.00000
SRR6145060	Omegapapillomavirus	936061	G	1	0	1	0.00000
SRR6145060	Olleya	336276	G	31	1	32	0.00000
SRR6145060	Olivibacter	376469	G	6	22	28	0.00000
SRR6145060	Oligotropha	40136	G	47	-47	0	0.00000
SRR6145060	Oligella	90243	G	10	0	10	0.00000
SRR6145060	Oleispira	188907	G	10	0	10	0.00000
SRR6145060	Oleiphilus	141450	G	7	0	7	0.00000
SRR6145060	Oleavirus	154322	G	1	0	1	0.00000
SRR6145060	Oenococcus	46254	G	23	0	23	0.00000
SRR6145060	Oceanobacillus	182709	G	31	0	31	0.00000
SRR6145060	Oceanithermus	208447	G	26	0	26	0.00000
SRR6145060	Oceanispirochaeta	2035349	G	5	0	5	0.00000
SRR6145060	Oceanisphaera	225143	G	17	0	17	0.00000
SRR6145060	Oceanimonas	129577	G	10	0	10	0.00000
SRR6145060	Oceanihabitans	2045416	G	12	0	12	0.00000
SRR6145060	Oceanicoccus	1084558	G	13	0	13	0.00000
SRR6145060	Obolenskvirus	1915205	G	14	1	15	0.00000
SRR6145060	Oblitimonas	1849530	G	24	0	24	0.00000
SRR6145060	Obesumbacterium	82982	G	5	1	6	0.00000
SRR6145060	Nymphadoravirus	2169636	G	2	0	2	0.00000
SRR6145060	Nyceiraevirus	2560192	G	1	0	1	0.00000
SRR6145060	Noxifervirus	2560190	G	2	0	2	0.00000
SRR6145060	Novibacillus	1677050	G	4	0	4	0.00000
SRR6145060	Nonanavirus	1921122	G	14	0	14	0.00000
SRR6145060	Nonagvirus	1921117	G	1	0	1	0.00000
SRR6145060	Nodularia	159191	G	24	5	29	0.00000
SRR6145060	Nitrosospira	35798	G	12	0	12	0.00000
SRR6145060	Nitrososphaera	497726	G	9	0	9	0.00000
SRR6145060	Nitrosopumilus	338191	G	28	0	28	0.00000
SRR6145060	Nitrincola	267849	G	25	0	25	0.00000
SRR6145060	Nitratiruptor	269258	G	8	0	8	0.00000
SRR6145060	Nitratifractor	269260	G	1	0	1	0.00000
SRR6145060	Nissabacter	1964366	G	27	0	27	0.00000
SRR6145060	Nipunavirus	1982239	G	2	0	2	0.00000
SRR6145060	Nickievirus	2560188	G	1	0	1	0.00000
SRR6145060	Nibricoccus	2576890	G	20	0	20	0.00000
SRR6145060	Nibribacter	1649474	G	12	3	15	0.00000
SRR6145060	Niastella	354354	G	30	1	31	0.00000
SRR6145060	Neptunomonas	75687	G	11	0	11	0.00000
SRR6145060	Neorickettsia	33993	G	3	22	25	0.00000
SRR6145060	Neokomagataea	1223423	G	11	0	11	0.00000
SRR6145060	Neochlamydia	112987	G	7	0	7	0.00000
SRR6145060	Ndongobacter	1930845	G	22	14	36	0.00000
SRR6145060	Nazgulvirus	2560186	G	1	0	1	0.00000
SRR6145060	Nautilia	191291	G	22	0	22	0.00000
SRR6145060	Natronorubrum	134813	G	22	1	23	0.00000
SRR6145060	Natronomonas	63743	G	17	0	17	0.00000
SRR6145060	Natronobacterium	2256	G	11	0	11	0.00000
SRR6145060	Natrialba	63742	G	14	1	15	0.00000
SRR6145060	Natranaerobius	375928	G	3	0	3	0.00000
SRR6145060	Narnavirus	186767	G	1	0	1	0.00000
SRR6145060	Nankokuvirus	1925779	G	1	-1	0	0.00000
SRR6145060	Mycoavidus	1810868	G	8	0	8	0.00000
SRR6145060	Mycetohabitans	2571159	G	13	0	13	0.00000
SRR6145060	Muromegalovirus	10365	G	2	0	2	0.00000
SRR6145060	Muriicola	762641	G	2	0	2	0.00000
SRR6145060	Muribaculum	1918540	G	35	2	37	0.00000
SRR6145060	Mupapillomavirus	334202	G	3	0	3	0.00000
SRR6145060	Mucinivorans	1611681	G	18	0	18	0.00000
SRR6145060	Mosigvirus	1913652	G	3	2	5	0.00000
SRR6145060	Moritella	58050	G	23	0	23	0.00000
SRR6145060	Morganella	581	G	25	2	27	0.00000
SRR6145060	Moorella	44260	G	20	0	20	0.00000
SRR6145060	Moorea	1155738	G	34	1	35	0.00000
SRR6145060	Moonvirus	1985329	G	1	-1	0	0.00000
SRR6145060	Moineauvirus	1623304	G	3	0	3	0.00000
SRR6145060	Mimivirus	315393	G	10	6	16	0.00000
SRR6145060	Mieseafarmvirus	1980921	G	1	0	1	0.00000
SRR6145060	Microvirgula	57479	G	24	1	25	0.00000
SRR6145060	Microcoleus	44471	G	22	6	28	0.00000
SRR6145060	Micavibrio	213485	G	32	0	32	0.00000
SRR6145060	Methylovulum	762296	G	23	0	23	0.00000
SRR6145060	Methylovirgula	1156568	G	33	1	34	0.00000
SRR6145060	Methyloversatilis	378210	G	24	0	24	0.00000
SRR6145060	Methylophilus	16	G	23	4	27	0.00000
SRR6145060	Methylophaga	40222	G	10	0	10	0.00000
SRR6145060	Methylomusa	2093783	G	6	0	6	0.00000
SRR6145060	Methylomicrobium	39773	G	31	0	31	0.00000
SRR6145060	Methylocaldum	73778	G	21	0	21	0.00000
SRR6145060	Methylobacillus	404	G	10	0	10	0.00000
SRR6145060	Methylacidiphilum	511745	G	12	0	12	0.00000
SRR6145060	Methanotorris	196119	G	8	0	8	0.00000
SRR6145060	Methanothrix	2222	G	11	0	11	0.00000
SRR6145060	Methanothermus	2179	G	7	0	7	0.00000
SRR6145060	Methanothermococcus	155862	G	5	0	5	0.00000
SRR6145060	Methanothermobacter	145260	G	6	0	6	0.00000
SRR6145060	Methanospirillum	2202	G	1	0	1	0.00000
SRR6145060	Methanosphaerula	475087	G	5	0	5	0.00000
SRR6145060	Methanosphaera	2316	G	13	0	13	0.00000
SRR6145060	Methanosalsum	196136	G	2	0	2	0.00000
SRR6145060	Methanoregula	395331	G	5	0	5	0.00000
SRR6145060	Methanopyrus	2319	G	5	-1	4	0.00000
SRR6145060	Methanoplanus	2314	G	5	0	5	0.00000
SRR6145060	Methanomethylovorans	101191	G	2	0	2	0.00000
SRR6145060	Methanomassiliicoccus	1080709	G	2	0	2	0.00000
SRR6145060	Methanolacinia	230355	G	3	0	3	0.00000
SRR6145060	Methanohalophilus	2175	G	8	0	8	0.00000
SRR6145060	Methanohalobium	2321	G	4	0	4	0.00000
SRR6145060	Methanofollis	81416	G	6	0	6	0.00000
SRR6145060	Methanofervidicoccus	2607661	G	6	0	6	0.00000
SRR6145060	Methanoculleus	45989	G	13	0	13	0.00000
SRR6145060	Methanocorpusculum	2192	G	3	0	3	0.00000
SRR6145060	Methanococcoides	2225	G	3	0	3	0.00000
SRR6145060	Methanocella	570266	G	10	1	11	0.00000
SRR6145060	Methanocaldococcus	196118	G	33	0	33	0.00000
SRR6145060	Methanobacterium	2160	G	37	0	37	0.00000
SRR6145060	Metamorphoovirus	2733195	G	2	0	2	0.00000
SRR6145060	Metallosphaera	41980	G	6	0	6	0.00000
SRR6145060	Metakosakonia	2055876	G	3	9	12	0.00000
SRR6145060	Mesotoga	1184396	G	6	0	6	0.00000
SRR6145060	Mesoflavibacter	444051	G	22	-22	0	0.00000
SRR6145060	Mementomorivirus	2733194	G	1	0	1	0.00000
SRR6145060	Melissococcus	33969	G	15	0	15	0.00000
SRR6145060	Melioribacter	1134403	G	4	0	4	0.00000
SRR6145060	Megasphaera	906	G	32	0	32	0.00000
SRR6145060	Mastadenovirus	10509	G	4	0	4	0.00000
SRR6145060	Massilistercora	2717089	G	3	0	3	0.00000
SRR6145060	Marvinvirus	1982091	G	1	-1	0	0.00000
SRR6145060	Marthavirus	1980936	G	1	-1	0	0.00000
SRR6145060	Marseillevirus	1513458	G	1	0	1	0.00000
SRR6145060	Marivivens	1759396	G	9	3	12	0.00000
SRR6145060	Marivirga	869806	G	20	2	22	0.00000
SRR6145060	Maritalea	623276	G	11	0	11	0.00000
SRR6145060	Mariprofundus	377315	G	24	0	24	0.00000
SRR6145060	Marinomonas	28253	G	29	0	29	0.00000
SRR6145060	Marinobacterium	48075	G	18	0	18	0.00000
SRR6145060	Marinitoga	160798	G	8	-8	0	0.00000
SRR6145060	Marinithermus	186191	G	16	0	16	0.00000
SRR6145060	Marinirhabdus	1862153	G	10	0	10	0.00000
SRR6145060	Marinilactibacillus	191769	G	25	1	26	0.00000
SRR6145060	Mariniflexile	527198	G	24	0	24	0.00000
SRR6145060	Mariniblastus	2005380	G	5	0	5	0.00000
SRR6145060	Maricaulis	74317	G	16	0	16	0.00000
SRR6145060	Mamastrovirus	249588	G	1	0	1	0.00000
SRR6145060	Majavirus	2733191	G	1	0	1	0.00000
SRR6145060	Mahella	252965	G	19	0	19	0.00000
SRR6145060	Magnetospira	1182780	G	28	0	28	0.00000
SRR6145060	Magnetococcus	162171	G	10	0	10	0.00000
SRR6145060	Mageeibacillus	1637257	G	30	1	31	0.00000
SRR6145060	Machinavirus	2169624	G	1	0	1	0.00000
SRR6145060	Macavirus	548687	G	1	0	1	0.00000
SRR6145060	Lymphocryptovirus	10375	G	3	1	4	0.00000
SRR6145060	Luzseptimavirus	1982594	G	1	-1	0	0.00000
SRR6145060	Lutibacter	358023	G	29	0	29	0.00000
SRR6145060	Luteolibacter	518753	G	22	0	22	0.00000
SRR6145060	Luckytenvirus	2733189	G	2	0	2	0.00000
SRR6145060	Lonsdalea	1082702	G	15	0	15	0.00000
SRR6145060	Lokivirus	2560170	G	3	0	3	0.00000
SRR6145060	Litunavirus	1920762	G	1	-1	0	0.00000
SRR6145060	Litorilituus	1407056	G	4	0	4	0.00000
SRR6145060	Litoricola	418700	G	8	0	8	0.00000
SRR6145060	Litoreibacter	947567	G	22	0	22	0.00000
SRR6145060	Limnospira	2596745	G	1	5	6	0.00000
SRR6145060	Limnochorda	1676651	G	30	0	30	0.00000
SRR6145060	Limnobaculum	2172100	G	12	0	12	0.00000
SRR6145060	Limnobacter	131079	G	31	0	31	0.00000
SRR6145060	Limihaloglobus	2690160	G	4	0	4	0.00000
SRR6145060	Limestonevirus	2169534	G	1	-1	0	0.00000
SRR6145060	Limelightvirus	2731954	G	1	0	1	0.00000
SRR6145060	Limdunavirus	2169621	G	1	0	1	0.00000
SRR6145060	Likavirus	1982880	G	1	0	1	0.00000
SRR6145060	Lightbulbvirus	1918522	G	1	1	2	0.00000
SRR6145060	Liefievirus	1623288	G	6	-6	0	0.00000
SRR6145060	Libanicoccus	1935188	G	7	5	12	0.00000
SRR6145060	Leptospirillum	179	G	3	0	3	0.00000
SRR6145060	Lenusvirus	2733160	G	1	0	1	0.00000
SRR6145060	Lentilitoribacter	1649463	G	5	0	5	0.00000
SRR6145060	Lentibacillus	175304	G	4	0	4	0.00000
SRR6145060	Lentavirus	2733186	G	1	0	1	0.00000
SRR6145060	Leminorella	82980	G	12	0	12	0.00000
SRR6145060	Leeuwenhoekiella	283735	G	17	0	17	0.00000
SRR6145060	Leadbetterella	319458	G	22	1	23	0.00000
SRR6145060	Lawsonia	41707	G	6	-6	0	0.00000
SRR6145060	Laribacter	168470	G	29	4	33	0.00000
SRR6145060	Lacusarxvirus	2560165	G	2	0	2	0.00000
SRR6145060	Lacunisphaera	1961799	G	33	2	35	0.00000
SRR6145060	Lacrimispora	2719231	G	20	0	20	0.00000
SRR6145060	Lacimicrobium	1751872	G	7	0	7	0.00000
SRR6145060	Lachnospira	28050	G	23	0	23	0.00000
SRR6145060	Laceyella	292635	G	2	0	2	0.00000
SRR6145060	Labilibaculum	2060722	G	24	0	24	0.00000
SRR6145060	Kyrpidia	1129704	G	8	0	8	0.00000
SRR6145060	Ktedonosporobacter	2692417	G	12	0	12	0.00000
SRR6145060	Kroppenstedtia	1274351	G	4	0	4	0.00000
SRR6145060	Krischvirus	1913651	G	2	0	2	0.00000
SRR6145060	Krampusvirus	2733184	G	1	0	1	0.00000
SRR6145060	Koutsourovirus	2732938	G	1	0	1	0.00000
SRR6145060	Kostyavirus	1623284	G	2	0	2	0.00000
SRR6145060	Kosmotoga	651456	G	8	0	8	0.00000
SRR6145060	Kordia	221065	G	34	0	34	0.00000
SRR6145060	Kolesnikvirus	1985293	G	3	0	3	0.00000
SRR6145060	Kojivirus	2560161	G	1	0	1	0.00000
SRR6145060	Kiritimatiella	1921784	G	10	23	33	0.00000
SRR6145060	Kineobactrum	2678529	G	15	0	15	0.00000
SRR6145060	Ketobacter	2025617	G	11	0	11	0.00000
SRR6145060	Kayvirus	1857843	G	37	0	37	0.00000
SRR6145060	Kagunavirus	1910992	G	1	0	1	0.00000
SRR6145060	Jonquetella	428711	G	19	0	19	0.00000
SRR6145060	Jonesia	43673	G	11	0	11	0.00000
SRR6145060	Johnsonvirus	1982576	G	1	0	1	0.00000
SRR6145060	Jilinvirus	1918725	G	1	0	1	0.00000
SRR6145060	Jiaoyazivirus	2731945	G	1	0	1	0.00000
SRR6145060	Jiaodavirus	1985325	G	2	0	2	0.00000
SRR6145060	Jerseyvirus	1910991	G	1	0	1	0.00000
SRR6145060	Jeotgalicoccus	227979	G	30	0	30	0.00000
SRR6145060	Jeotgalibacillus	157226	G	24	0	24	0.00000
SRR6145060	Jedunavirus	2560154	G	2	0	2	0.00000
SRR6145060	Jannaschia	188905	G	31	0	31	0.00000
SRR6145060	Izhakiella	1780190	G	18	0	18	0.00000
SRR6145060	Ithacavirus	2169643	G	4	0	4	0.00000
SRR6145060	Isosphaera	127	G	16	0	16	0.00000
SRR6145060	Iodobacter	32014	G	8	0	8	0.00000
SRR6145060	Intestinimonas	1392389	G	3	29	32	0.00000
SRR6145060	Intestinibaculum	2679910	G	5	0	5	0.00000
SRR6145060	Ilyobacter	167639	G	15	0	15	0.00000
SRR6145060	Ignicoccus	54258	G	3	0	3	0.00000
SRR6145060	Ignavibacterium	795750	G	17	0	17	0.00000
SRR6145060	Idiomarina	135575	G	39	-3	36	0.00000
SRR6145060	Idaeovirus	39760	G	1	0	1	0.00000
SRR6145060	Ichthyobacterium	1755829	G	11	0	11	0.00000
SRR6145060	Ichnovirus	10483	G	4	0	4	0.00000
SRR6145060	Hyperthermus	54247	G	1	0	1	0.00000
SRR6145060	Hydrogenovibrio	28884	G	15	1	16	0.00000
SRR6145060	Hydrogenobaculum	168657	G	7	0	7	0.00000
SRR6145060	Hydrogenobacter	939	G	11	0	11	0.00000
SRR6145060	Hydrocarboniclastica	2650549	G	15	0	15	0.00000
SRR6145060	Hungatella	1649459	G	15	0	15	0.00000
SRR6145060	Hungateiclostridium	2304692	G	32	-7	25	0.00000
SRR6145060	Histophilus	214906	G	20	1	21	0.00000
SRR6145060	Hirschia	2723	G	2	0	2	0.00000
SRR6145060	Hippea	84404	G	13	0	13	0.00000
SRR6145060	Higrevirus	1513277	G	3	0	3	0.00000
SRR6145060	Herminiimonas	303379	G	25	4	29	0.00000
SRR6145060	Herbinix	1663717	G	15	1	16	0.00000
SRR6145060	Hepatovirus	12091	G	1	0	1	0.00000
SRR6145060	Heliorestis	79598	G	5	0	5	0.00000
SRR6145060	Heliobacterium	2697	G	2	0	2	0.00000
SRR6145060	Hedwigvirus	2560146	G	2	0	2	0.00000
SRR6145060	Hathewaya	1769729	G	16	0	16	0.00000
SRR6145060	Hapavirus	1972611	G	2	1	3	0.00000
SRR6145060	Halovivax	332951	G	14	0	14	0.00000
SRR6145060	Halothiobacillus	109262	G	24	0	24	0.00000
SRR6145060	Halothermothrix	32636	G	6	0	6	0.00000
SRR6145060	Halothece	76023	G	17	12	29	0.00000
SRR6145060	Halotalea	376488	G	33	0	33	0.00000
SRR6145060	Halostella	1843185	G	17	3	20	0.00000
SRR6145060	Halostagnicola	353799	G	16	0	16	0.00000
SRR6145060	Halorussus	1070314	G	30	0	30	0.00000
SRR6145060	Halorientalis	1073987	G	17	0	17	0.00000
SRR6145060	Halorhodospira	85108	G	35	0	35	0.00000
SRR6145060	Halorhabdus	146825	G	36	1	37	0.00000
SRR6145060	Haloquadratum	293431	G	7	17	24	0.00000
SRR6145060	Haloprofundus	1911573	G	17	0	17	0.00000
SRR6145060	Halopiger	387342	G	24	2	26	0.00000
SRR6145060	Halopenitus	1209988	G	12	1	13	0.00000
SRR6145060	Halomicronema	170610	G	9	0	9	0.00000
SRR6145060	Halohasta	1450140	G	7	1	8	0.00000
SRR6145060	Halogeometricum	60846	G	10	0	10	0.00000
SRR6145060	Halodesulfurarchaeum	1980514	G	6	18	24	0.00000
SRR6145060	Halocynthiibacter	1579315	G	9	0	9	0.00000
SRR6145060	Halocella	46466	G	23	0	23	0.00000
SRR6145060	Halobiforma	203193	G	29	4	33	0.00000
SRR6145060	Halobellus	1073986	G	33	3	36	0.00000
SRR6145060	Halobacteroides	42417	G	11	0	11	0.00000
SRR6145060	Halobacteriovorax	1652133	G	21	16	37	0.00000
SRR6145060	Halobacillus	45667	G	20	0	20	0.00000
SRR6145060	Haliscomenobacter	2349	G	11	0	11	0.00000
SRR6145060	Halarcobacter	2321115	G	20	0	20	0.00000
SRR6145060	Halapricum	1542963	G	12	9	21	0.00000
SRR6145060	Halanaerobium	2330	G	17	0	17	0.00000
SRR6145060	Halanaeroarchaeum	1656823	G	11	0	11	0.00000
SRR6145060	Halalkalicoccus	332246	G	22	0	22	0.00000
SRR6145060	Halalkaliarchaeum	2678343	G	8	0	8	0.00000
SRR6145060	Hahella	158481	G	20	12	32	0.00000
SRR6145060	Hafnia	568	G	28	2	30	0.00000
SRR6145060	Haematospirillum	1804663	G	6	0	6	0.00000
SRR6145060	Gynuella	1445504	G	7	0	7	0.00000
SRR6145060	Guyparkeria	2035712	G	34	1	35	0.00000
SRR6145060	Gustavvirus	2560144	G	1	0	1	0.00000
SRR6145060	Gudongella	2692382	G	2	0	2	0.00000
SRR6145060	Grimontia	246861	G	16	0	16	0.00000
SRR6145060	Granulosicoccus	437504	G	11	0	11	0.00000
SRR6145060	Granulibacter	364409	G	30	0	30	0.00000
SRR6145060	Gracilibacillus	74385	G	15	0	15	0.00000
SRR6145060	Gottschalkia	1505664	G	20	0	20	0.00000
SRR6145060	Gordonibacter	644652	G	33	3	36	0.00000
SRR6145060	Goodmanvirus	2733179	G	1	0	1	0.00000
SRR6145060	Glycocaulis	1433402	G	26	0	26	0.00000
SRR6145060	Gloeomargarita	1188227	G	3	0	3	0.00000
SRR6145060	Gloeocapsa	102231	G	30	6	36	0.00000
SRR6145060	Gloeobacter	33071	G	26	0	26	0.00000
SRR6145060	Glaciecola	89404	G	26	0	26	0.00000
SRR6145060	Gimesia	1649453	G	1	12	13	0.00000
SRR6145060	Gilvibacter	379070	G	10	0	10	0.00000
SRR6145060	Gillisia	244698	G	16	0	16	0.00000
SRR6145060	Gillianvirus	2733177	G	1	0	1	0.00000
SRR6145060	Gilliamella	1193503	G	14	1	15	0.00000
SRR6145060	Gibbsiella	929812	G	12	0	12	0.00000
SRR6145060	Ghunavirus	2732683	G	1	-1	0	0.00000
SRR6145060	Getalongvirus	2733156	G	7	2	9	0.00000
SRR6145060	Gequatrovirus	1910952	G	10	1	11	0.00000
SRR6145060	Geovibrio	46200	G	4	0	4	0.00000
SRR6145060	Geosporobacter	390805	G	22	0	22	0.00000
SRR6145060	Geoglobus	190818	G	3	0	3	0.00000
SRR6145060	Geoalkalibacter	392332	G	13	2	15	0.00000
SRR6145060	Gemykibivirus	1941236	G	2	1	3	0.00000
SRR6145060	Gelderlandvirus	1913653	G	4	0	4	0.00000
SRR6145060	Geitlerinema	63132	G	20	13	33	0.00000
SRR6145060	Gaprivervirus	1913654	G	2	-2	0	0.00000
SRR6145060	Gammatectivirus	2560136	G	1	1	2	0.00000
SRR6145060	Gammaretrovirus	153135	G	3	0	3	0.00000
SRR6145060	Gammapapillomavirus	325455	G	26	0	26	0.00000
SRR6145060	Gammainfluenzavirus	197913	G	1	0	1	0.00000
SRR6145060	Gammacoronavirus	694013	G	1	0	1	0.00000
SRR6145060	Gamaleyavirus	1920753	G	3	1	4	0.00000
SRR6145060	Galunavirus	2560135	G	9	0	9	0.00000
SRR6145060	Gallionella	96	G	5	0	5	0.00000
SRR6145060	Gallibacterium	155493	G	13	0	13	0.00000
SRR6145060	Gallaecimonas	745410	G	10	0	10	0.00000
SRR6145060	Gaiavirus	1982113	G	1	0	1	0.00000
SRR6145060	Fuerstia	1936111	G	6	0	6	0.00000
SRR6145060	Fromanvirus	186764	G	12	0	12	0.00000
SRR6145060	Frischella	1335631	G	12	1	13	0.00000
SRR6145060	Frederiksenia	1649317	G	11	0	11	0.00000
SRR6145060	Foturvirus	2731938	G	2	0	2	0.00000
SRR6145060	Fluviicola	332102	G	19	0	19	0.00000
SRR6145060	Fluviibacterium	2661844	G	19	2	21	0.00000
SRR6145060	Fluoribacter	461	G	6	-6	0	0.00000
SRR6145060	Flintibacter	1918454	G	8	0	8	0.00000
SRR6145060	Flexistipes	2351	G	3	0	3	0.00000
SRR6145060	Fletchervirus	1636618	G	3	0	3	0.00000
SRR6145060	Flavonifractor	946234	G	19	1	20	0.00000
SRR6145060	Flavivirus	11051	G	1	0	1	0.00000
SRR6145060	Flavivirga	1209327	G	30	0	30	0.00000
SRR6145060	Flaumdravirus	2560133	G	1	0	1	0.00000
SRR6145060	Flagellimonas	444459	G	12	0	12	0.00000
SRR6145060	Fipvunavirus	2560132	G	1	-1	0	0.00000
SRR6145060	Filomicrobium	119044	G	20	0	20	0.00000
SRR6145060	Filimonas	649460	G	21	0	21	0.00000
SRR6145060	Fijivirus	10988	G	1	0	1	0.00000
SRR6145060	Fibrobacter	832	G	18	0	18	0.00000
SRR6145060	Fervidobacterium	2422	G	18	0	18	0.00000
SRR6145060	Fervidicoccus	685950	G	3	0	3	0.00000
SRR6145060	Ferroplasma	74968	G	4	1	5	0.00000
SRR6145060	Ferroglobus	54260	G	4	0	4	0.00000
SRR6145060	Ferriphaselus	1443590	G	13	0	13	0.00000
SRR6145060	Ferrimonas	44011	G	25	0	25	0.00000
SRR6145060	Fermentimonas	1784836	G	20	2	22	0.00000
SRR6145060	Felixounavirus	1198140	G	2	0	2	0.00000
SRR6145060	Faecalitalea	1573534	G	10	1	11	0.00000
SRR6145060	Faecalibaculum	1729679	G	9	0	9	0.00000
SRR6145060	Fabibacter	446458	G	13	0	13	0.00000
SRR6145060	Eyrevirus	2560129	G	1	0	1	0.00000
SRR6145060	Euzebyella	1287916	G	15	0	15	0.00000
SRR6145060	Euhalothece	65097	G	21	5	26	0.00000
SRR6145060	Eubacterium	1730	G	24	0	24	0.00000
SRR6145060	Ethanoligenens	253238	G	11	0	11	0.00000
SRR6145060	Erysipelatoclostridium	1505663	G	11	14	25	0.00000
SRR6145060	Ereboglobus	2028344	G	9	0	9	0.00000
SRR6145060	Epseptimavirus	2732017	G	2	0	2	0.00000
SRR6145060	Ephemeroptericola	2680021	G	6	0	6	0.00000
SRR6145060	Entomoplasma	46238	G	14	0	14	0.00000
SRR6145060	Enterovibrio	188143	G	9	0	9	0.00000
SRR6145060	Enterocloster	2719313	G	26	6	32	0.00000
SRR6145060	Eneladusvirus	2560128	G	14	0	14	0.00000
SRR6145060	Endozoicomonas	305899	G	10	0	10	0.00000
SRR6145060	Endomicrobium	1408194	G	5	4	9	0.00000
SRR6145060	Emdodecavirus	1980937	G	1	-1	0	0.00000
SRR6145060	Emcibacter	1602338	G	24	0	24	0.00000
SRR6145060	Emalynvirus	2560127	G	1	0	1	0.00000
SRR6145060	Elvirus	1984786	G	2	0	2	0.00000
SRR6145060	Elusimicrobium	423604	G	6	0	6	0.00000
SRR6145060	Ehrlichia	943	G	28	-3	25	0.00000
SRR6145060	Edaphobacter	388463	G	14	0	14	0.00000
SRR6145060	Ectothiorhodospira	1051	G	26	0	26	0.00000
SRR6145060	Dysosmobacter	2591381	G	3	7	10	0.00000
SRR6145060	Dysgonomonas	156973	G	31	0	31	0.00000
SRR6145060	Dyosigmapapillomavirus	1513245	G	1	3	4	0.00000
SRR6145060	Drulisvirus	1920774	G	1	0	1	0.00000
SRR6145060	Dokdonia	326319	G	27	0	27	0.00000
SRR6145060	Dismasvirus	2560122	G	3	0	3	0.00000
SRR6145060	Dictyoglomus	13	G	13	0	13	0.00000
SRR6145060	Dichelobacter	869	G	5	0	5	0.00000
SRR6145060	Dhillonvirus	1623289	G	1	0	1	0.00000
SRR6145060	Dhakavirus	1914165	G	1	0	1	0.00000
SRR6145060	Devriesea	472568	G	22	0	22	0.00000
SRR6145060	Desulfuromonas	890	G	28	1	29	0.00000
SRR6145060	Desulfurococcus	2273	G	3	-2	1	0.00000
SRR6145060	Desulfurobacterium	64159	G	7	0	7	0.00000
SRR6145060	Desulfurivibrio	427922	G	10	0	10	0.00000
SRR6145060	Desulfurispirillum	393029	G	11	0	11	0.00000
SRR6145060	Desulfurella	33001	G	13	0	13	0.00000
SRR6145060	Desulfotomaculum	1562	G	29	0	29	0.00000
SRR6145060	Desulfotalea	109168	G	2	0	2	0.00000
SRR6145060	Desulfosporosinus	79206	G	30	0	30	0.00000
SRR6145060	Desulfomonile	2357	G	4	0	4	0.00000
SRR6145060	Desulfomicrobium	898	G	31	0	31	0.00000
SRR6145060	Desulfohalobium	45662	G	9	0	9	0.00000
SRR6145060	Desulfoglaeba	361106	G	9	0	9	0.00000
SRR6145060	Desulfofarcimen	2282742	G	7	0	7	0.00000
SRR6145060	Desulfocurvibacter	2582840	G	16	0	16	0.00000
SRR6145060	Desulfococcus	896	G	25	0	25	0.00000
SRR6145060	Desulfocapsa	53318	G	4	0	4	0.00000
SRR6145060	Desulfobulbus	893	G	31	0	31	0.00000
SRR6145060	Desulfobacula	28222	G	7	0	7	0.00000
SRR6145060	Desulfobacterium	2295	G	2	0	2	0.00000
SRR6145060	Desulfobacter	2289	G	25	0	25	0.00000
SRR6145060	Desulfobacca	60892	G	9	0	9	0.00000
SRR6145060	Desulfitobacterium	36853	G	25	0	25	0.00000
SRR6145060	Desulfatibacillum	218207	G	10	0	10	0.00000
SRR6145060	Desulfarculus	453229	G	30	3	33	0.00000
SRR6145060	Desulfallas	2282740	G	8	7	15	0.00000
SRR6145060	Dermatophilus	1862	G	29	0	29	0.00000
SRR6145060	Derbicusvirus	2733102	G	5	4	9	0.00000
SRR6145060	Denitrovibrio	117999	G	7	0	7	0.00000
SRR6145060	Denitrobacterium	79603	G	3	0	3	0.00000
SRR6145060	Demosthenesvirus	1982106	G	2	-2	0	0.00000
SRR6145060	Deltapolyomavirus	1891715	G	3	0	3	0.00000
SRR6145060	Deltaentomopoxvirus	2733302	G	1	0	1	0.00000
SRR6145060	Deltacoronavirus	1159901	G	1	0	1	0.00000
SRR6145060	Delepquintavirus	2560121	G	1	0	1	0.00000
SRR6145060	Dehalogenimonas	670486	G	9	0	9	0.00000
SRR6145060	Dehalococcoides	61434	G	5	0	5	0.00000
SRR6145060	Dehalobacterium	51514	G	6	0	6	0.00000
SRR6145060	Dehalobacter	56112	G	4	-4	0	0.00000
SRR6145060	Defluviitoga	1511648	G	7	0	7	0.00000
SRR6145060	Deferribacter	53572	G	16	0	16	0.00000
SRR6145060	Deefgea	400947	G	5	0	5	0.00000
SRR6145060	Dactylococcopsis	13034	G	1	0	1	0.00000
SRR6145060	Cytomegalovirus	10358	G	6	0	6	0.00000
SRR6145060	Cyprinivirus	692606	G	3	18	21	0.00000
SRR6145060	Cylindrospermum	56106	G	18	2	20	0.00000
SRR6145060	Cycloclasticus	34067	G	3	0	3	0.00000
SRR6145060	Cyclobacterium	68288	G	37	0	37	0.00000
SRR6145060	Cyanothece	43988	G	3	0	3	0.00000
SRR6145060	Cyanobacterium	102234	G	11	2	13	0.00000
SRR6145060	Curvibacter	281915	G	29	0	29	0.00000
SRR6145060	Cuniculiplasma	1747777	G	9	1	10	0.00000
SRR6145060	Cucumovirus	12304	G	1	0	1	0.00000
SRR6145060	Cryptobacterium	84162	G	8	8	16	0.00000
SRR6145060	Crocosphaera	263510	G	20	3	23	0.00000
SRR6145060	Croceibacter	216431	G	9	0	9	0.00000
SRR6145060	Crinalium	241421	G	28	8	36	0.00000
SRR6145060	Crateriforma	2714592	G	12	0	12	0.00000
SRR6145060	Crassaminicella	1848399	G	17	0	17	0.00000
SRR6145060	Coxiella	776	G	20	2	22	0.00000
SRR6145060	Cornellvirus	1910993	G	3	0	3	0.00000
SRR6145060	Coriobacterium	33870	G	8	8	16	0.00000
SRR6145060	Coralvirus	2733171	G	2	-2	0	0.00000
SRR6145060	Coraliomargarita	442430	G	8	0	8	0.00000
SRR6145060	Coopervirus	1982898	G	6	0	6	0.00000
SRR6145060	Congregibacter	393661	G	7	1	8	0.00000
SRR6145060	Conexivisphaera	2613912	G	2	0	2	0.00000
SRR6145060	Commensalibacter	1079922	G	7	0	7	0.00000
SRR6145060	Colossusvirus	2733153	G	3	0	3	0.00000
SRR6145060	Cohaesibacter	655352	G	7	0	7	0.00000
SRR6145060	Cobetia	204286	G	33	1	34	0.00000
SRR6145060	Closterovirus	12160	G	1	1	2	0.00000
SRR6145060	Cloacibacillus	508459	G	11	0	11	0.00000
SRR6145060	Citricoccus	169133	G	338	-338	0	0.00000
SRR6145060	Cimpunavirus	2560116	G	1	0	1	0.00000
SRR6145060	Chthonomonas	1077265	G	9	0	9	0.00000
SRR6145060	Chryseolinea	1433993	G	22	13	35	0.00000
SRR6145060	Chromohalobacter	42054	G	37	0	37	0.00000
SRR6145060	Christensenella	990721	G	16	0	16	0.00000
SRR6145060	Chondrocystis	268175	G	26	9	35	0.00000
SRR6145060	Chlorovirus	181083	G	3	0	3	0.00000
SRR6145060	Chloroherpeton	100715	G	3	0	3	0.00000
SRR6145060	Chloroflexus	1107	G	16	-9	7	0.00000
SRR6145060	Chlorobium	1091	G	22	0	22	0.00000
SRR6145060	Chlorobaculum	256319	G	26	0	26	0.00000
SRR6145060	Chloriridovirus	10491	G	10	0	10	0.00000
SRR6145060	Chloracidobacterium	458032	G	12	0	12	0.00000
SRR6145060	Chitinolyticbacter	1055692	G	32	0	32	0.00000
SRR6145060	Cheoctovirus	1623281	G	1	0	1	0.00000
SRR6145060	Charlievirus	1623280	G	2	-2	0	0.00000
SRR6145060	Chania	1745211	G	7	0	7	0.00000
SRR6145060	Changchengzhania	2049301	G	19	0	19	0.00000
SRR6145060	Chamaesiphon	217161	G	12	1	13	0.00000
SRR6145060	Cetovirus	2560112	G	1	1	2	0.00000
SRR6145060	Cetia	1775691	G	5	0	5	0.00000
SRR6145060	Certrevirus	1914850	G	7	2	9	0.00000
SRR6145060	Cepunavirus	1982583	G	1	28	29	0.00000
SRR6145060	Centapoxvirus	2005509	G	3	0	3	0.00000
SRR6145060	Cellulosilyticum	698776	G	29	0	29	0.00000
SRR6145060	Ceduovirus	186532	G	1	0	1	0.00000
SRR6145060	Cecivirus	1623290	G	1	3	4	0.00000
SRR6145060	Catenovulum	1172191	G	27	0	27	0.00000
SRR6145060	Castellaniella	359336	G	30	3	33	0.00000
SRR6145060	Casimicrobium	2706000	G	19	2	21	0.00000
SRR6145060	Carboxydothermus	129957	G	7	0	7	0.00000
SRR6145060	Carboxydocella	178898	G	3	0	3	0.00000
SRR6145060	Caproiciproducens	1738645	G	9	0	9	0.00000
SRR6145060	Capripoxvirus	10265	G	2	0	2	0.00000
SRR6145060	Candidatus Tremblaya	189384	G	1	-1	0	0.00000
SRR6145060	Candidatus Nitrosocaldus	498374	G	1	-1	0	0.00000
SRR6145060	Caminibacter	191301	G	7	0	7	0.00000
SRR6145060	Caloramator	44258	G	13	0	13	0.00000
SRR6145060	Caldivirga	76886	G	1	0	1	0.00000
SRR6145060	Caldithrix	187144	G	16	0	16	0.00000
SRR6145060	Calditerrivibrio	545865	G	8	0	8	0.00000
SRR6145060	Caldisphaera	200414	G	3	0	3	0.00000
SRR6145060	Caldisericum	693074	G	2	0	2	0.00000
SRR6145060	Caldimicrobium	444090	G	6	0	6	0.00000
SRR6145060	Caldilinea	233191	G	12	0	12	0.00000
SRR6145060	Caldanaerobacter	249529	G	4	0	4	0.00000
SRR6145060	Cafeteriavirus	1513234	G	3	0	3	0.00000
SRR6145060	Caballeronia	1827195	G	37	0	37	0.00000
SRR6145060	Bythopirellula	1400386	G	6	0	6	0.00000
SRR6145060	Butyrivibrio	830	G	26	0	26	0.00000
SRR6145060	Buttiauxella	82976	G	23	0	23	0.00000
SRR6145060	Busanvirus	2560109	G	1	0	1	0.00000
SRR6145060	Brussowvirus	1623303	G	2	0	2	0.00000
SRR6145060	Brujitavirus	2169611	G	2	1	3	0.00000
SRR6145060	Britbratvirus	2560107	G	2	0	2	0.00000
SRR6145060	Brigitvirus	2733097	G	1	0	1	0.00000
SRR6145060	Bridgettevirus	2733170	G	1	-1	0	0.00000
SRR6145060	Brevefilum	2019482	G	5	0	5	0.00000
SRR6145060	Bremerella	2714594	G	7	0	7	0.00000
SRR6145060	Bracovirus	10485	G	1	0	1	0.00000
SRR6145060	Boseongicola	1648497	G	23	0	23	0.00000
SRR6145060	Borreliella	64895	G	35	1	36	0.00000
SRR6145060	Bombella	1654741	G	5	0	5	0.00000
SRR6145060	Bocaparvovirus	1507401	G	1	0	1	0.00000
SRR6145060	Bixzunavirus	680114	G	1	-1	0	0.00000
SRR6145060	Biseptimavirus	1623274	G	8	11	19	0.00000
SRR6145060	Bingvirus	2560103	G	1	0	1	0.00000
SRR6145060	Bignuzvirus	1623277	G	1	0	1	0.00000
SRR6145060	Bibersteinia	476528	G	13	0	13	0.00000
SRR6145060	Betterkatzvirus	2560101	G	1	0	1	0.00000
SRR6145060	Betapolyomavirus	1891714	G	1	0	1	0.00000
SRR6145060	Betapapillomavirus	333922	G	14	0	14	0.00000
SRR6145060	Betanudivirus	1511854	G	1	0	1	0.00000
SRR6145060	Betaentomopoxvirus	10286	G	5	0	5	0.00000
SRR6145060	Betacoronavirus	694002	G	1	0	1	0.00000
SRR6145060	Betabaculovirus	558017	G	6	6	12	0.00000
SRR6145060	Bertelyvirus	2733152	G	2	1	3	0.00000
SRR6145060	Bernardetia	1937972	G	24	0	24	0.00000
SRR6145060	Bernalvirus	1982101	G	3	0	3	0.00000
SRR6145060	Bequatrovirus	1917990	G	2	0	2	0.00000
SRR6145060	Belliella	232244	G	22	0	22	0.00000
SRR6145060	Bellamyvirus	2733096	G	1	0	1	0.00000
SRR6145060	Beijerinckia	532	G	19	0	19	0.00000
SRR6145060	Begomovirus	10814	G	2	0	2	0.00000
SRR6145060	Beggiatoa	1021	G	15	0	15	0.00000
SRR6145060	Bastillevirus	1918010	G	1	-1	0	0.00000
SRR6145060	Basilea	1472344	G	9	0	9	0.00000
SRR6145060	Basfia	697331	G	19	0	19	0.00000
SRR6145060	Barnyardvirus	1623276	G	1	0	1	0.00000
SRR6145060	Barnesiella	397864	G	13	3	16	0.00000
SRR6145060	Baoshanvirus	2732969	G	8	0	8	0.00000
SRR6145060	Bantamvirus	2560096	G	1	0	1	0.00000
SRR6145060	Baltimorevirus	2169641	G	1	0	1	0.00000
SRR6145060	Baikalvirus	2733094	G	3	0	3	0.00000
SRR6145060	Bacterioplanes	1537406	G	6	0	6	0.00000
SRR6145060	Avulavirus	260963	G	1	0	1	0.00000
SRR6145060	Avipoxvirus	10260	G	4	0	4	0.00000
SRR6145060	Avibacterium	292486	G	20	0	20	0.00000
SRR6145060	Aureitalea	1176327	G	9	0	9	0.00000
SRR6145060	Aurantimicrobium	1705353	G	35	0	35	0.00000
SRR6145060	Attisvirus	2169652	G	3	-3	0	0.00000
SRR6145060	Athalassotoga	1769718	G	2	0	2	0.00000
SRR6145060	Atadenovirus	100953	G	2	0	2	0.00000
SRR6145060	Asfivirus	39743	G	3	0	3	0.00000
SRR6145060	Ascovirus	43680	G	4	0	4	0.00000
SRR6145060	Asaia	91914	G	17	0	17	0.00000
SRR6145060	Arsenophonus	637	G	23	0	23	0.00000
SRR6145060	Arequatrovirus	1982881	G	1	0	1	0.00000
SRR6145060	Arenibacter	178469	G	21	0	21	0.00000
SRR6145060	Arcticibacterium	2173039	G	10	0	10	0.00000
SRR6145060	Archaeoglobus	2233	G	10	-2	8	0.00000
SRR6145060	Arcanobacterium	28263	G	25	1	26	0.00000
SRR6145060	Arabia	2005386	G	26	0	26	0.00000
SRR6145060	Aquiflexum	280472	G	26	0	26	0.00000
SRR6145060	Aquifex	2713	G	2	0	2	0.00000
SRR6145060	Aquicella	254245	G	14	0	14	0.00000
SRR6145060	Aquaspirillum	187	G	36	1	37	0.00000
SRR6145060	Apricotvirus	2733166	G	1	1	2	0.00000
SRR6145060	Antarctobacter	74032	G	26	0	26	0.00000
SRR6145060	Antarcticibacterium	2058174	G	32	0	32	0.00000
SRR6145060	Anseongella	1773450	G	17	0	17	0.00000
SRR6145060	Anoxybacter	1769008	G	12	0	12	0.00000
SRR6145060	Aneurinibacillus	55079	G	14	6	20	0.00000
SRR6145060	Andhravirus	2732589	G	19	4	23	0.00000
SRR6145060	Anaplasma	768	G	3	0	3	0.00000
SRR6145060	Anaerotignum	2039240	G	8	0	8	0.00000
SRR6145060	Anaerolinea	233189	G	6	0	6	0.00000
SRR6145060	Anaerohalosphaera	2690159	G	8	15	23	0.00000
SRR6145060	Anaerocolumna	1843210	G	11	0	11	0.00000
SRR6145060	Anaerobutyricum	2569097	G	29	4	33	0.00000
SRR6145060	Anabaenopsis	110103	G	20	9	29	0.00000
SRR6145060	Amphibacillus	29331	G	12	0	12	0.00000
SRR6145060	Ammonifex	42837	G	7	0	7	0.00000
SRR6145060	Aminomonas	81411	G	12	0	12	0.00000
SRR6145060	Aminobacterium	81466	G	2	0	2	0.00000
SRR6145060	Alphavirus	11019	G	2	0	2	0.00000
SRR6145060	Alphatrevirus	1910951	G	5	0	5	0.00000
SRR6145060	Alphatorquevirus	687331	G	1	0	1	0.00000
SRR6145060	Alphasphaerolipovirus	1714268	G	1	22	23	0.00000
SRR6145060	Alpharetrovirus	153057	G	3	0	3	0.00000
SRR6145060	Alphapolyomavirus	1891713	G	8	0	8	0.00000
SRR6145060	Alphapapillomavirus	333750	G	3	0	3	0.00000
SRR6145060	Alphanudivirus	1511853	G	1	0	1	0.00000
SRR6145060	Alphafusellovirus	10475	G	2	0	2	0.00000
SRR6145060	Alphaendornavirus	2003394	G	1	0	1	0.00000
SRR6145060	Alphabaculovirus	558016	G	13	0	13	0.00000
SRR6145060	Allopseudarcicella	2676060	G	9	0	9	0.00000
SRR6145060	Alloprevotella	1283313	G	27	0	27	0.00000
SRR6145060	Allofrancisella	1869285	G	10	0	10	0.00000
SRR6145060	Allochromatium	85072	G	26	0	26	0.00000
SRR6145060	Alkalitalea	1193324	G	24	0	24	0.00000
SRR6145060	Alkalilimnicola	133193	G	22	0	22	0.00000
SRR6145060	Aliiarcobacter	2321111	G	29	1	30	0.00000
SRR6145060	Alicyclobacillus	29330	G	22	0	22	0.00000
SRR6145060	Algoriphagus	246875	G	26	0	26	0.00000
SRR6145060	Alexandravirus	2733088	G	11	0	11	0.00000
SRR6145060	Alcyoneusvirus	2560086	G	19	0	19	0.00000
SRR6145060	Ahniella	2233801	G	26	0	26	0.00000
SRR6145060	Agricanvirus	1984776	G	1	-1	0	0.00000
SRR6145060	Agatevirus	1910931	G	2	-2	0	0.00000
SRR6145060	Agarivorans	261825	G	11	0	11	0.00000
SRR6145060	Agarilytica	2036021	G	20	0	20	0.00000
SRR6145060	Aerosvirus	2732910	G	1	0	1	0.00000
SRR6145060	Aeropyrum	56635	G	1	0	1	0.00000
SRR6145060	Aeribacillus	1055323	G	19	0	19	0.00000
SRR6145060	Aequorivita	153265	G	33	0	33	0.00000
SRR6145060	Advenella	290425	G	25	0	25	0.00000
SRR6145060	Adlercreutzia	447020	G	22	2	24	0.00000
SRR6145060	Actinobaculum	76833	G	12	0	12	0.00000
SRR6145060	Aciduliprofundum	379546	G	7	0	7	0.00000
SRR6145060	Acidothermus	28048	G	23	0	23	0.00000
SRR6145060	Acidobacterium	33973	G	15	0	15	0.00000
SRR6145060	Acidisarcina	2608728	G	16	0	16	0.00000
SRR6145060	Acidilobus	105850	G	4	0	4	0.00000
SRR6145060	Acidiferrobacter	986106	G	11	0	11	0.00000
SRR6145060	Acidianus	12914	G	16	0	16	0.00000
SRR6145060	Acidaminococcus	904	G	5	0	5	0.00000
SRR6145060	Acholeplasma	2147	G	32	0	32	0.00000
SRR6145060	Acetomicrobium	49894	G	1	0	1	0.00000
SRR6145060	Acetohalobium	28186	G	10	0	10	0.00000
SRR6145060	Acetobacterium	33951	G	17	0	17	0.00000
SRR6145060	Acetoanaerobium	186831	G	6	0	6	0.00000
SRR6145060	Acaryochloris	155977	G	7	0	7	0.00000
SRR6145060	Absiella	2057233	G	21	0	21	0.00000
