sample	name	taxonomy_id	taxonomy_lvl	kraken_assigned_reads	added_reads	new_est_reads	fraction_total_reads
SRR6145060	Homo sapiens	9606	S	6039591	2789	6042380	0.79620
SRR6145060	Candidatus Saccharibacteria bacterium oral taxon 957	2572088	S	57	25	82	0.00001
SRR6145060	Candidatus Saccharibacteria bacterium oral taxon 955	2572087	S	12	15	27	0.00000
SRR6145060	Garrulus glandarius associated circular virus 1	2006642	S	1	0	1	0.00000
SRR6145060	Nostoc sp. 'Lobaria pulmonaria (5183) cyanobiont'	1618022	S	13	2	15	0.00000
SRR6145060	Blochmannia endosymbiont of Camponotus (Colobopsis) obliquus	1505597	S	2	0	2	0.00000
SRR6145060	Blochmannia endosymbiont of Polyrhachis (Hedomyrma) turneri	1505596	S	7	0	7	0.00000
SRR6145060	Deinococcus soli Cha et al. 2016	1309411	S	155	55	210	0.00003
SRR6145060	Nostoc sp. 'Peltigera membranacea cyanobiont' N6	1261031	S	18	4	22	0.00000
SRR6145060	Candidatus Saccharibacteria bacterium oral taxon 488	713059	S	156	54	210	0.00003
SRR6145060	Cutibacterium acnes	1747	S	357831	9085	366916	0.04835
SRR6145060	Sphingomonas ginsengisoli An et al. 2013	363835	S	193	3	196	0.00003
SRR6145060	Tomato yellow leaf curl Malaga virus	219744	S	1	1	2	0.00000
SRR6145060	Moraxella osloensis	34062	S	104885	2617	107502	0.01417
SRR6145060	Micrococcus luteus	1270	S	40014	24283	64297	0.00847
SRR6145060	Staphylococcus epidermidis	1282	S	44356	7340	51696	0.00681
SRR6145060	Staphylococcus hominis	1290	S	20771	1526	22297	0.00294
SRR6145060	Dermacoccus nishinomiyaensis	1274	S	17899	801	18700	0.00246
SRR6145060	Streptococcus mitis	28037	S	13132	2741	15873	0.00209
SRR6145060	Acinetobacter baumannii	470	S	3859	11406	15265	0.00201
SRR6145060	Halomonas hydrothermalis	115561	S	13155	1206	14361	0.00189
SRR6145060	Staphylococcus warneri	1292	S	6284	7797	14081	0.00186
SRR6145060	Staphylococcus capitis	29388	S	12927	934	13861	0.00183
SRR6145060	Paraburkholderia fungorum	134537	S	10962	857	11819	0.00156
SRR6145060	Staphylococcus aureus	1280	S	6303	5273	11576	0.00153
SRR6145060	Corynebacterium segmentosum	43990	S	10713	277	10990	0.00145
SRR6145060	Acinetobacter schindleri	108981	S	8292	1148	9440	0.00124
SRR6145060	Janibacter indicus	857417	S	7462	706	8168	0.00108
SRR6145060	Cutibacterium granulosum	33011	S	7155	296	7451	0.00098
SRR6145060	Staphylococcus saprophyticus	29385	S	6524	773	7297	0.00096
SRR6145060	Chryseobacterium taklimakanense	536441	S	6579	469	7048	0.00093
SRR6145060	Streptococcus pneumoniae	1313	S	3803	3232	7035	0.00093
SRR6145060	Acinetobacter junii	40215	S	6367	582	6949	0.00092
SRR6145060	Micrococcus sp. KBS0714	1179670	S	1730	6911	8641	0.00114
SRR6145060	Neisseria mucosa	488	S	5693	1025	6718	0.00089
SRR6145060	Streptococcus oralis	1303	S	4854	1819	6673	0.00088
SRR6145060	Finegoldia magna	1260	S	5907	612	6519	0.00086
SRR6145060	Paracoccus yeei	147645	S	3545	2788	6333	0.00083
SRR6145060	Pseudomonas stutzeri	316	S	5163	671	5834	0.00077
SRR6145060	Gemella haemolysans	1379	S	5637	189	5826	0.00077
SRR6145060	Haemophilus parainfluenzae	729	S	5390	332	5722	0.00075
SRR6145060	Corynebacterium ureicelerivorans	401472	S	5141	270	5411	0.00071
SRR6145060	Stenotrophomonas maltophilia	40324	S	3062	2141	5203	0.00069
SRR6145060	Acinetobacter lwoffii	28090	S	3140	2002	5142	0.00068
SRR6145060	Staphylococcus pasteuri	45972	S	1945	3030	4975	0.00066
SRR6145060	Staphylococcus sciuri	1296	S	4803	131	4934	0.00065
SRR6145060	Gordonia terrae	2055	S	3574	1278	4852	0.00064
SRR6145060	Staphylococcus haemolyticus	1283	S	4158	620	4778	0.00063
SRR6145060	Tsukamurella tyrosinosolvens	57704	S	4158	483	4641	0.00061
SRR6145060	Paracoccus sanguinis	1545044	S	4198	403	4601	0.00061
SRR6145060	Streptococcus sanguinis	1305	S	4315	201	4516	0.00060
SRR6145060	Pseudomonas aeruginosa	287	S	630	3690	4320	0.00057
SRR6145060	Actinomyces oris	544580	S	2294	1889	4183	0.00055
SRR6145060	Gordonia bronchialis	2054	S	3074	1029	4103	0.00054
SRR6145060	Porphyromonas asaccharolytica	28123	S	3872	29	3901	0.00051
SRR6145060	Actinomyces naeslundii	1655	S	2016	1738	3754	0.00049
SRR6145060	Acinetobacter indicus	756892	S	3392	360	3752	0.00049
SRR6145060	Streptococcus gordonii	1302	S	3422	197	3619	0.00048
SRR6145060	Methylobacterium radiotolerans	31998	S	1137	2425	3562	0.00047
SRR6145060	Kytococcus sedentarius	1276	S	3315	238	3553	0.00047
SRR6145060	Cutibacterium avidum	33010	S	3265	117	3382	0.00045
SRR6145060	Corynebacterium mycetoides	38302	S	3043	319	3362	0.00044
SRR6145060	Roseomonas mucosa	207340	S	1144	2216	3360	0.00044
SRR6145060	Acinetobacter johnsonii	40214	S	2225	1125	3350	0.00044
SRR6145060	Kocuria palustris	71999	S	3087	200	3287	0.00043
SRR6145060	Veillonella parvula	29466	S	3134	103	3237	0.00043
SRR6145060	Corallococcus coralloides	184914	S	3137	77	3214	0.00042
SRR6145060	Pseudomonas putida	303	S	2153	945	3098	0.00041
SRR6145060	Corynebacterium matruchotii	43768	S	3055	19	3074	0.00041
SRR6145060	Fusobacterium nucleatum	851	S	2681	388	3069	0.00040
SRR6145060	Rothia mucilaginosa	43675	S	2857	53	2910	0.00038
SRR6145060	Gordonia sp. JH63	2698900	S	2566	2898	5464	0.00072
SRR6145060	Chryseobacterium sp. H6466	2487072	S	2909	2752	5661	0.00075
SRR6145060	Staphylococcus cohnii	29382	S	2509	175	2684	0.00035
SRR6145060	Microbacterium aurum	36805	S	2447	200	2647	0.00035
SRR6145060	Acinetobacter ursingii	108980	S	2399	179	2578	0.00034
SRR6145060	Massilia oculi	945844	S	2302	243	2545	0.00034
SRR6145060	Acinetobacter pittii	48296	S	1702	836	2538	0.00033
SRR6145060	Rothia dentocariosa	2047	S	2443	92	2535	0.00033
SRR6145060	Methylobacterium mesophilicum	39956	S	2379	132	2511	0.00033
SRR6145060	Chryseobacterium haifense	421525	S	2232	255	2487	0.00033
SRR6145060	Deinococcus wulumuqiensis	980427	S	2181	257	2438	0.00032
SRR6145060	Klebsiella pneumoniae	573	S	403	2016	2419	0.00032
SRR6145060	Serratia marcescens	615	S	1477	921	2398	0.00032
SRR6145060	Streptococcus salivarius	1304	S	1402	979	2381	0.00031
SRR6145060	Chryseobacterium sp. F5649	2487071	S	2602	2381	4983	0.00066
SRR6145060	Corynebacterium sanguinis	2594913	S	2106	259	2365	0.00031
SRR6145060	Sphingobium yanoikuyae	13690	S	1124	1162	2286	0.00030
SRR6145060	Prevotella intermedia	28131	S	1825	451	2276	0.00030
SRR6145060	Sphingomonas melonis	152682	S	979	1176	2155	0.00028
SRR6145060	Escherichia coli	562	S	331	1809	2140	0.00028
SRR6145060	Pseudomonas oryzihabitans	47885	S	2090	49	2139	0.00028
SRR6145060	Chryseobacterium arthrosphaerae	651561	S	1946	160	2106	0.00028
SRR6145060	Streptococcus gwangjuense	1433513	S	1500	486	1986	0.00026
SRR6145060	Prevotella melaninogenica	28132	S	1527	446	1973	0.00026
SRR6145060	Neisseria subflava	28449	S	1608	295	1903	0.00025
SRR6145060	Kocuria indica	1049583	S	1031	828	1859	0.00024
SRR6145060	Methylobacterium sp. C1	1479019	S	705	1853	2558	0.00034
SRR6145060	Campylobacter ureolyticus	827	S	1784	33	1817	0.00024
SRR6145060	Methylorubrum populi	223967	S	1421	389	1810	0.00024
SRR6145060	Rothia aeria	172042	S	1711	62	1773	0.00023
SRR6145060	Corynebacterium glutamicum	1718	S	50	1676	1726	0.00023
SRR6145060	Brevundimonas diminuta	293	S	761	945	1706	0.00022
SRR6145060	Actinomyces viscosus	1656	S	1636	67	1703	0.00022
SRR6145060	Streptococcus cristatus	45634	S	1547	114	1661	0.00022
SRR6145060	Acinetobacter tandoii	202954	S	1619	35	1654	0.00022
SRR6145060	Dietzia timorensis	499555	S	1269	375	1644	0.00022
SRR6145060	Corynebacterium striatum	43770	S	1317	228	1545	0.00020
SRR6145060	Comamonas aquatica	225991	S	1410	132	1542	0.00020
SRR6145060	Rhizobium pusense	648995	S	408	1126	1534	0.00020
SRR6145060	Paracoccus contaminans	1945662	S	1401	127	1528	0.00020
SRR6145060	Methylobacterium brachiatum	269660	S	1314	203	1517	0.00020
SRR6145060	Lawsonella clevelandensis	1528099	S	1472	35	1507	0.00020
SRR6145060	Lautropia mirabilis	47671	S	1360	79	1439	0.00019
SRR6145060	Chryseobacterium indologenes	253	S	1333	105	1438	0.00019
SRR6145060	Methylobacterium sp. XJLW	739141	S	198	1422	1620	0.00021
SRR6145060	Janibacter limosus	53458	S	1335	85	1420	0.00019
SRR6145060	Chryseobacterium gleum	250	S	1214	192	1406	0.00019
SRR6145060	Brevundimonas naejangsanensis	588932	S	1242	146	1388	0.00018
SRR6145060	Sphingobacterium sp. G1-14	2003121	S	1378	1385	2763	0.00036
SRR6145060	Streptococcus pseudopneumoniae	257758	S	951	417	1368	0.00018
SRR6145060	Neisseria elongata	495	S	1246	115	1361	0.00018
SRR6145060	Haemophilus parahaemolyticus	735	S	1266	42	1308	0.00017
SRR6145060	Acinetobacter sp. ACNIH1	1636603	S	7468	1307	8775	0.00116
SRR6145060	Enterobacter hormaechei	158836	S	184	1118	1302	0.00017
SRR6145060	Friedmanniella sagamiharensis	546874	S	1225	58	1283	0.00017
SRR6145060	Staphylococcus caprae	29380	S	1191	86	1277	0.00017
SRR6145060	Corynebacterium simulans	146827	S	1087	178	1265	0.00017
SRR6145060	Halomonas meridiana	29570	S	1166	94	1260	0.00017
SRR6145060	Leuconostoc pseudomesenteroides	33968	S	1149	107	1256	0.00017
SRR6145060	Janibacter melonis	262209	S	1161	76	1237	0.00016
SRR6145060	Corynebacterium jeikeium	38289	S	806	418	1224	0.00016
SRR6145060	Corynebacterium kroppenstedtii	161879	S	1190	20	1210	0.00016
SRR6145060	Enterobacter cloacae	550	S	498	708	1206	0.00016
SRR6145060	Brevundimonas vesicularis	41276	S	602	598	1200	0.00016
SRR6145060	Dietzia lutea	546160	S	1056	133	1189	0.00016
SRR6145060	Corynebacterium diphtheriae	1717	S	342	843	1185	0.00016
SRR6145060	Rhodococcus sp. PBTS 1	1653478	S	1166	101	1267	0.00017
SRR6145060	Acinetobacter haemolyticus	29430	S	988	163	1151	0.00015
SRR6145060	Peptoniphilus harei	54005	S	1096	53	1149	0.00015
SRR6145060	Pasteurella multocida	747	S	858	273	1131	0.00015
SRR6145060	Schaalia odontolytica	1660	S	1084	45	1129	0.00015
SRR6145060	Streptococcus australis	113107	S	901	217	1118	0.00015
SRR6145060	Corynebacterium singulare	161899	S	984	101	1085	0.00014
SRR6145060	Acinetobacter nosocomialis	106654	S	890	192	1082	0.00014
SRR6145060	Neisseria meningitidis	487	S	447	629	1076	0.00014
SRR6145060	Gardnerella vaginalis	2702	S	1026	21	1047	0.00014
SRR6145060	Sulfitobacter donghicola	421000	S	8	1035	1043	0.00014
SRR6145060	Roseomonas sp. FDAARGOS_362	2018065	S	689	1035	1724	0.00023
SRR6145060	Lactobacillus iners	147802	S	986	37	1023	0.00013
SRR6145060	Bacillus cereus	1396	S	583	437	1020	0.00013
SRR6145060	Anaerococcus prevotii	33034	S	934	74	1008	0.00013
SRR6145060	Microbacterium paraoxydans	199592	S	245	760	1005	0.00013
SRR6145060	Haemophilus influenzae	727	S	576	420	996	0.00013
SRR6145060	Abiotrophia defectiva	46125	S	973	8	981	0.00013
SRR6145060	Gemella morbillorum	29391	S	877	103	980	0.00013
SRR6145060	Mycolicibacterium psychrotolerans	216929	S	897	79	976	0.00013
SRR6145060	Sphingobacterium sp. B29	1933220	S	1053	974	2027	0.00027
SRR6145060	Methylorubrum extorquens	408	S	469	501	970	0.00013
SRR6145060	Leptotrichia wadei	157687	S	832	128	960	0.00013
SRR6145060	Staphylococcus lugdunensis	28035	S	929	29	958	0.00013
SRR6145060	Brevundimonas vancanneytii	1325724	S	284	658	942	0.00012
SRR6145060	Aeromonas caviae	648	S	231	692	923	0.00012
SRR6145060	Haemophilus haemolyticus	726	S	794	121	915	0.00012
SRR6145060	Capnocytophaga sputigena	1019	S	821	94	915	0.00012
SRR6145060	Xanthomonas campestris	339	S	792	119	911	0.00012
SRR6145060	Clostridium botulinum	1491	S	837	69	906	0.00012
SRR6145060	Staphylococcus pettenkoferi	170573	S	848	19	867	0.00011
SRR6145060	Streptococcus anginosus	1328	S	411	443	854	0.00011
SRR6145060	Dolosigranulum pigrum	29394	S	837	15	852	0.00011
SRR6145060	Methylobacterium oryzae	334852	S	79	763	842	0.00011
SRR6145060	Cloacibacterium normanense	237258	S	810	27	837	0.00011
SRR6145060	Brevundimonas mediterranea	74329	S	726	109	835	0.00011
SRR6145060	Nocardia brasiliensis	37326	S	681	147	828	0.00011
SRR6145060	Tsukamurella paurometabola	2061	S	742	77	819	0.00011
SRR6145060	Corynebacterium aurimucosum	169292	S	762	48	810	0.00011
SRR6145060	Corynebacterium minutissimum	38301	S	767	42	809	0.00011
SRR6145060	Agrobacterium tumefaciens	358	S	545	260	805	0.00011
SRR6145060	Streptococcus sp. NPS 308	1902136	S	800	188	988	0.00013
SRR6145060	Nakamurella multipartita	53461	S	779	16	795	0.00010
SRR6145060	Staphylococcus sp. M0911	2025492	S	309	784	1093	0.00014
SRR6145060	Acinetobacter radioresistens	40216	S	745	36	781	0.00010
SRR6145060	Actinomyces radicidentis	111015	S	705	45	750	0.00010
SRR6145060	Acinetobacter towneri	202956	S	436	305	741	0.00010
SRR6145060	Fusobacterium pseudoperiodonticum	2663009	S	604	130	734	0.00010
SRR6145060	Mycobacteroides chelonae	1774	S	242	487	729	0.00010
SRR6145060	Aggregatibacter segnis	739	S	673	43	716	0.00009
SRR6145060	Streptococcus pyogenes	1314	S	238	471	709	0.00009
SRR6145060	Kocuria rhizophila	72000	S	221	481	702	0.00009
SRR6145060	Streptococcus thermophilus	1308	S	541	158	699	0.00009
SRR6145060	Massilia putida	1141883	S	558	128	686	0.00009
SRR6145060	Achromobacter xylosoxidans	85698	S	432	253	685	0.00009
SRR6145060	Kocuria sp. KD4	2719588	S	920	684	1604	0.00021
SRR6145060	Methylobacterium phyllosphaerae	418223	S	245	438	683	0.00009
SRR6145060	Lysobacter oculi	2698682	S	628	52	680	0.00009
SRR6145060	Veillonella dispar	39778	S	649	30	679	0.00009
SRR6145060	Zymobacter palmae	33074	S	669	9	678	0.00009
SRR6145060	Mycolicibacterium doricum	126673	S	504	172	676	0.00009
SRR6145060	Pseudoxanthomonas suwonensis	314722	S	599	76	675	0.00009
SRR6145060	Gemella sanguinis	84135	S	643	28	671	0.00009
SRR6145060	Prevotella jejuni	1177574	S	525	140	665	0.00009
SRR6145060	Nocardia cyriacigeorgica	135487	S	534	129	663	0.00009
SRR6145060	Mycolicibacterium gilvum	1804	S	469	192	661	0.00009
SRR6145060	Salmonella enterica	28901	S	104	554	658	0.00009
SRR6145060	Methylobacterium durans	2202825	S	631	27	658	0.00009
SRR6145060	Deinococcus radiodurans	1299	S	593	60	653	0.00009
SRR6145060	Roseomonas gilardii	257708	S	583	41	624	0.00008
SRR6145060	Lactococcus lactis	1358	S	506	117	623	0.00008
SRR6145060	Acinetobacter bereziniae	106648	S	611	8	619	0.00008
SRR6145060	Streptococcus parasanguinis	1318	S	528	90	618	0.00008
SRR6145060	Gordonia iterans	1004901	S	553	64	617	0.00008
SRR6145060	Mycobacterium sp. QIA-37	1561223	S	158	616	774	0.00010
SRR6145060	Brevundimonas sp. DS20	1532555	S	356	614	970	0.00013
SRR6145060	Prevotella dentalis	52227	S	529	81	610	0.00008
SRR6145060	Staphylococcus xylosus	1288	S	593	16	609	0.00008
SRR6145060	Staphylococcus phage StauST398-5	1308897	S	2	603	605	0.00008
SRR6145060	Epidermidibacterium keratini	1891644	S	592	7	599	0.00008
SRR6145060	Brevibacterium luteolum	199591	S	548	50	598	0.00008
SRR6145060	Acinetobacter soli	487316	S	581	15	596	0.00008
SRR6145060	Brevibacterium linens	1703	S	403	190	593	0.00008
SRR6145060	Gluconobacter oxydans	442	S	431	157	588	0.00008
SRR6145060	Modestobacter marinus	477641	S	533	44	577	0.00008
SRR6145060	Ezakiella massiliensis	1852374	S	508	67	575	0.00008
SRR6145060	Neisseria flavescens	484	S	443	130	573	0.00008
SRR6145060	Curtobacterium pusillum	69373	S	480	92	572	0.00008
SRR6145060	Marmoricola scoriae	642780	S	494	76	570	0.00008
SRR6145060	Mycolicibacterium aurum	1791	S	522	46	568	0.00007
SRR6145060	Methylobacterium aquaticum	270351	S	511	56	567	0.00007
SRR6145060	Porphyromonas gingivalis	837	S	445	111	556	0.00007
SRR6145060	Aggregatibacter aphrophilus	732	S	514	35	549	0.00007
SRR6145060	Empedobacter brevis	247	S	539	7	546	0.00007
SRR6145060	Corynebacterium xerosis	1725	S	504	42	546	0.00007
SRR6145060	Mycolicibacterium phocaicum	319706	S	463	81	544	0.00007
SRR6145060	Pseudomonas alcaligenes	43263	S	524	17	541	0.00007
SRR6145060	Streptococcus dysgalactiae	1334	S	130	410	540	0.00007
SRR6145060	Streptomyces venezuelae	54571	S	477	62	539	0.00007
SRR6145060	Streptomyces sp. RLB3-5	2594456	S	1	538	539	0.00007
SRR6145060	Methylobacterium terrae	2202827	S	479	58	537	0.00007
SRR6145060	Geodermatophilus obscurus	1861	S	489	47	536	0.00007
SRR6145060	Lysobacter enzymogenes	69	S	428	106	534	0.00007
SRR6145060	Brevundimonas sp. GW460-12-10-14-LB2	1827469	S	751	533	1284	0.00017
SRR6145060	Rhizobium oryzihabitans	2267833	S	65	462	527	0.00007
SRR6145060	Methylobacterium currus	2051553	S	453	73	526	0.00007
SRR6145060	Brevundimonas sp. 'scallop'	2562582	S	697	526	1223	0.00016
SRR6145060	Acinetobacter sp. NEB149	2725684	S	363	525	888	0.00012
SRR6145060	Stenotrophomonas acidaminiphila	128780	S	415	102	517	0.00007
SRR6145060	Macrococcus caseolyticus	69966	S	474	42	516	0.00007
SRR6145060	Klebsiella michiganensis	1134687	S	87	429	516	0.00007
SRR6145060	Sorangium cellulosum	56	S	498	15	513	0.00007
SRR6145060	Mycobacterium tuberculosis	1773	S	8	503	511	0.00007
SRR6145060	Streptococcus agalactiae	1311	S	85	424	509	0.00007
SRR6145060	Pseudomonas mendocina	300	S	471	37	508	0.00007
SRR6145060	Campylobacter showae	204	S	501	5	506	0.00007
SRR6145060	Rhizobium sp. S41	1869170	S	137	504	641	0.00008
SRR6145060	Pseudopropionibacterium propionicum	1750	S	498	5	503	0.00007
SRR6145060	Gordonia polyisoprenivorans	84595	S	487	16	503	0.00007
SRR6145060	Kocuria sp. BT304	1702043	S	231	502	733	0.00010
SRR6145060	Brachybacterium saurashtrense	556288	S	444	58	502	0.00007
SRR6145060	Rhodopseudomonas palustris	1076	S	440	61	501	0.00007
SRR6145060	Microbacterium hominis	162426	S	466	34	500	0.00007
SRR6145060	Elizabethkingia anophelis	1117645	S	415	83	498	0.00007
SRR6145060	Corynebacterium imitans	156978	S	471	25	496	0.00007
SRR6145060	Prevotella scopos	589437	S	346	149	495	0.00007
SRR6145060	Rhodobacter sphaeroides	1063	S	442	44	486	0.00006
SRR6145060	Capnocytophaga gingivalis	1017	S	468	16	484	0.00006
SRR6145060	Sphingomonas taxi	1549858	S	463	19	482	0.00006
SRR6145060	Rhodococcus opacus	37919	S	381	96	477	0.00006
SRR6145060	Brevundimonas sp. Bb-A	2560058	S	279	475	754	0.00010
SRR6145060	Rhizobium rhizoryzae	451876	S	454	19	473	0.00006
SRR6145060	Prevotella enoeca	76123	S	372	101	473	0.00006
SRR6145060	Aerococcus viridans	1377	S	373	100	473	0.00006
SRR6145060	Nocardia farcinica	37329	S	341	130	471	0.00006
SRR6145060	Staphylococcus arlettae	29378	S	440	26	466	0.00006
SRR6145060	Klebsiella aerogenes	548	S	403	62	465	0.00006
SRR6145060	Neisseria cinerea	483	S	376	88	464	0.00006
SRR6145060	Delftia tsuruhatensis	180282	S	243	219	462	0.00006
SRR6145060	Corynebacterium glaucum	187491	S	451	11	462	0.00006
SRR6145060	Sphingomonas koreensis	93064	S	357	102	459	0.00006
SRR6145060	Mycolicibacterium vanbaalenii	110539	S	345	110	455	0.00006
SRR6145060	Blastococcus saxobsidens	138336	S	414	36	450	0.00006
SRR6145060	Weissella confusa	1583	S	426	23	449	0.00006
SRR6145060	Microbacterium sp. PAMC 28756	1795053	S	448	311	759	0.00010
SRR6145060	Pantoea dispersa	59814	S	388	58	446	0.00006
SRR6145060	Acidovorax avenae	80867	S	312	134	446	0.00006
SRR6145060	Sphingomonas sp. NIC1	1961362	S	585	444	1029	0.00014
SRR6145060	Enterobacter roggenkampii	1812935	S	224	214	438	0.00006
SRR6145060	Veillonella atypica	39777	S	424	12	436	0.00006
SRR6145060	Dyella thiooxydans	445710	S	381	54	435	0.00006
SRR6145060	Sphingomonas insulae	424800	S	419	15	434	0.00006
SRR6145060	Nocardia asteroides	1824	S	303	130	433	0.00006
SRR6145060	Dietzia sp. DQ12-45-1b	912801	S	52	429	481	0.00006
SRR6145060	Klebsiella oxytoca	571	S	158	270	428	0.00006
SRR6145060	Brevundimonas sp. SGAir0440	2579977	S	1504	428	1932	0.00025
SRR6145060	Variovorax paradoxus	34073	S	341	85	426	0.00006
SRR6145060	Mycobacterium sp. KMS	189918	S	80	426	506	0.00007
SRR6145060	Methylobacterium sp. NI91	2696058	S	1	426	427	0.00006
SRR6145060	Nocardioides humi	449461	S	369	55	424	0.00006
SRR6145060	Mycobacterium grossiae	1552759	S	385	34	419	0.00006
SRR6145060	Leptotrichia buccalis	40542	S	362	56	418	0.00006
SRR6145060	Deinococcus gobiensis	502394	S	408	8	416	0.00005
SRR6145060	Paracoccus zhejiangensis	1077935	S	369	44	413	0.00005
SRR6145060	Mycobacterium paragordonae	1389713	S	404	7	411	0.00005
SRR6145060	Leclercia sp. 1106151	2681309	S	94	410	504	0.00007
SRR6145060	Sphingobacterium daejeonense	371142	S	372	34	406	0.00005
SRR6145060	Staphylococcus kloosii	29384	S	394	10	404	0.00005
SRR6145060	Caulobacter flavus	1679497	S	353	50	403	0.00005
SRR6145060	Staphylococcus nepalensis	214473	S	385	13	398	0.00005
SRR6145060	Arthrobacter sp. NEB 688	904039	S	397	22	419	0.00006
SRR6145060	Fusobacterium hwasookii	1583098	S	318	78	396	0.00005
SRR6145060	Proteus mirabilis	584	S	351	43	394	0.00005
SRR6145060	Prevotella denticola	28129	S	332	61	393	0.00005
SRR6145060	Haematobacter massiliensis	195105	S	322	71	393	0.00005
SRR6145060	Pseudomonas fluorescens	294	S	303	89	392	0.00005
SRR6145060	Nocardia terpenica	455432	S	350	40	390	0.00005
SRR6145060	Paracoccus pantotrophus	82367	S	347	39	386	0.00005
SRR6145060	Parvimonas micra	33033	S	352	33	385	0.00005
SRR6145060	Corynebacterium camporealensis	161896	S	370	15	385	0.00005
SRR6145060	Leclercia sp. LSNIH1	1920114	S	78	384	462	0.00006
SRR6145060	Clavibacter michiganensis	28447	S	363	20	383	0.00005
SRR6145060	Rhodococcus erythropolis	1833	S	81	301	382	0.00005
SRR6145060	Sphingomonas sanxanigenens	397260	S	311	67	378	0.00005
SRR6145060	Chryseobacterium shandongense	1493872	S	334	42	376	0.00005
SRR6145060	Leclercia adecarboxylata	83655	S	187	188	375	0.00005
SRR6145060	Prevotella fusca	589436	S	316	58	374	0.00005
SRR6145060	Dietzia psychralcaliphila	139021	S	348	26	374	0.00005
SRR6145060	Staphylococcus sp. AntiMn-1	1715860	S	16	373	389	0.00005
SRR6145060	Paracoccus aminovorans	34004	S	338	35	373	0.00005
SRR6145060	Cnuibacter physcomitrellae	1619308	S	78	294	372	0.00005
SRR6145060	Pimelobacter simplex	2045	S	311	60	371	0.00005
SRR6145060	Mycolicibacterium gadium	1794	S	300	71	371	0.00005
SRR6145060	Sphingobium cloacae	120107	S	207	163	370	0.00005
SRR6145060	Corynebacterium sp. ATCC 6931	1487956	S	369	97	466	0.00006
SRR6145060	Brevundimonas subvibrioides	74313	S	353	15	368	0.00005
SRR6145060	Paracoccus denitrificans	266	S	324	43	367	0.00005
SRR6145060	Mycolicibacterium poriferae	39694	S	105	262	367	0.00005
SRR6145060	Mycolicibacterium parafortuitum	39692	S	329	37	366	0.00005
SRR6145060	Brachybacterium faecium	43669	S	314	52	366	0.00005
SRR6145060	Prevotella oris	28135	S	317	48	365	0.00005
SRR6145060	Skermanella pratensis	2233999	S	347	13	360	0.00005
SRR6145060	Cupriavidus taiwanensis	164546	S	279	81	360	0.00005
SRR6145060	Anaerococcus mediterraneensis	1870984	S	311	48	359	0.00005
SRR6145060	Leptotrichia hofstadii	157688	S	300	58	358	0.00005
SRR6145060	Methylobacterium nodulans	114616	S	347	9	356	0.00005
SRR6145060	Mycolicibacterium chubuense	1800	S	313	40	353	0.00005
SRR6145060	Cystobacter fuscus	43	S	314	39	353	0.00005
SRR6145060	Azospirillum brasilense	192	S	256	94	350	0.00005
SRR6145060	Nocardioides dokdonensis	450734	S	273	76	349	0.00005
SRR6145060	Mycolicibacterium vaccae	1810	S	313	35	348	0.00005
SRR6145060	Gordonia alkanivorans	84096	S	117	230	347	0.00005
SRR6145060	Cupriavidus pauculus	82633	S	306	41	347	0.00005
SRR6145060	Pseudonocardia autotrophica	2074	S	306	40	346	0.00005
SRR6145060	Mycolicibacterium mageritense	53462	S	314	31	345	0.00005
SRR6145060	Corynebacterium genitalium	38288	S	332	11	343	0.00005
SRR6145060	Streptococcus mutans	1309	S	225	117	342	0.00005
SRR6145060	Chroococcidiopsis thermalis	54299	S	288	54	342	0.00005
SRR6145060	Leptotrichia shahii	157691	S	282	56	338	0.00004
SRR6145060	Sphingopyxis macrogoltabida	33050	S	270	67	337	0.00004
SRR6145060	Acetobacter orientalis	146474	S	331	6	337	0.00004
SRR6145060	Deinococcus ficus	317577	S	332	4	336	0.00004
SRR6145060	Brachybacterium ginsengisoli	1331682	S	288	48	336	0.00004
SRR6145060	Streptomyces lividans	1916	S	7	328	335	0.00004
SRR6145060	Streptococcus koreensis	2382163	S	173	162	335	0.00004
SRR6145060	Nocardia mangyaensis	2213200	S	257	76	333	0.00004
SRR6145060	Kocuria rosea	1275	S	316	17	333	0.00004
SRR6145060	Streptococcus sp. HSISS1	1316410	S	12	331	343	0.00005
SRR6145060	Pseudonocardia dioxanivorans	240495	S	303	28	331	0.00004
SRR6145060	Bradyrhizobium elkanii	29448	S	281	49	330	0.00004
SRR6145060	Sphingomonas paucimobilis	13689	S	301	28	329	0.00004
SRR6145060	Kineococcus radiotolerans	131568	S	315	10	325	0.00004
SRR6145060	Stenotrophomonas rhizophila	216778	S	279	45	324	0.00004
SRR6145060	Corynebacterium timonense	441500	S	314	8	322	0.00004
SRR6145060	Rhodococcus hoagii	43767	S	276	42	318	0.00004
SRR6145060	Nocardioides euryhalodurans	2518370	S	283	35	318	0.00004
SRR6145060	Leptotrichia trevisanii	109328	S	286	32	318	0.00004
SRR6145060	Staphylococcus equorum	246432	S	121	195	316	0.00004
SRR6145060	Novosphingobium resinovorum	158500	S	249	67	316	0.00004
SRR6145060	Lactobacillus crispatus	47770	S	202	114	316	0.00004
SRR6145060	Streptococcus sp. 1643	2576376	S	566	311	877	0.00012
SRR6145060	Lactobacillus plantarum	1590	S	145	166	311	0.00004
SRR6145060	Rhodococcus fascians	1828	S	269	41	310	0.00004
SRR6145060	Mycolicibacterium monacense	85693	S	46	262	308	0.00004
SRR6145060	Streptococcus intermedius	1338	S	244	62	306	0.00004
SRR6145060	Mycobacterium avium	1764	S	199	107	306	0.00004
SRR6145060	Aeromonas hydrophila	644	S	153	153	306	0.00004
SRR6145060	Burkholderia cenocepacia	95486	S	115	190	305	0.00004
SRR6145060	Paracoccus jeotgali	2065379	S	287	16	303	0.00004
SRR6145060	Corynebacterium riegelii	156976	S	291	12	303	0.00004
SRR6145060	Serinicoccus profundi	1078471	S	269	33	302	0.00004
SRR6145060	Pauljensenia hongkongensis	178339	S	281	21	302	0.00004
SRR6145060	Gordonia insulae	2420509	S	289	13	302	0.00004
SRR6145060	Sphingomonas panacis	1560345	S	294	6	300	0.00004
SRR6145060	Nocardia nova	37330	S	273	27	300	0.00004
SRR6145060	Streptococcus vestibularis	1343	S	243	55	298	0.00004
SRR6145060	Leptotrichia hongkongensis	554406	S	250	46	296	0.00004
SRR6145060	Alicycliphilus denitrificans	179636	S	156	140	296	0.00004
SRR6145060	Mycolicibacterium smegmatis	1772	S	238	56	294	0.00004
SRR6145060	Deinococcus actinosclerus	1768108	S	244	50	294	0.00004
SRR6145060	Phenylobacterium zucineum	284016	S	275	18	293	0.00004
SRR6145060	Paracoccus mutanolyticus	1499308	S	100	193	293	0.00004
SRR6145060	Corynebacterium flavescens	28028	S	284	9	293	0.00004
SRR6145060	Staphylococcus auricularis	29379	S	287	5	292	0.00004
SRR6145060	Microbacterium foliorum	104336	S	274	18	292	0.00004
SRR6145060	Xanthomonas citri	346	S	88	203	291	0.00004
SRR6145060	Rhodococcus ruber	1830	S	251	40	291	0.00004
SRR6145060	Acidovorax sp. JS42	232721	S	35	290	325	0.00004
SRR6145060	Ralstonia solanacearum	305	S	157	132	289	0.00004
SRR6145060	Ornithinimicrobium flavum	1288636	S	249	39	288	0.00004
SRR6145060	Nocardia arthritidis	228602	S	262	26	288	0.00004
SRR6145060	Comamonas testosteroni	285	S	185	103	288	0.00004
SRR6145060	Capnocytophaga leadbetteri	327575	S	226	62	288	0.00004
SRR6145060	Corynebacterium casei	160386	S	213	74	287	0.00004
SRR6145060	Sphingobium amiense	135719	S	152	132	284	0.00004
SRR6145060	Corynebacterium endometrii	2488819	S	278	5	283	0.00004
SRR6145060	Mycobacteroides abscessus	36809	S	181	101	282	0.00004
SRR6145060	Corynebacterium variabile	1727	S	249	31	280	0.00004
SRR6145060	Aeromonas sp. ASNIH7	1920107	S	42	279	321	0.00004
SRR6145060	Sphingomonas hengshuiensis	1609977	S	273	4	277	0.00004
SRR6145060	Pseudoxanthomonas spadix	415229	S	243	32	275	0.00004
SRR6145060	Kocuria turfanensis	388357	S	257	18	275	0.00004
SRR6145060	Brachybacterium vulturis	2017484	S	216	59	275	0.00004
SRR6145060	Bacillus thuringiensis	1428	S	98	177	275	0.00004
SRR6145060	Rhizorhabdus dicambivorans	1850238	S	178	96	274	0.00004
SRR6145060	Aerococcus urinaeequi	51665	S	235	39	274	0.00004
SRR6145060	Microbacterium chocolatum	84292	S	259	14	273	0.00004
SRR6145060	Tannerella forsythia	28112	S	185	86	271	0.00004
SRR6145060	Rhodococcus rhodochrous	1829	S	207	64	271	0.00004
SRR6145060	Mycolicibacterium arabiense	1286181	S	257	14	271	0.00004
SRR6145060	Nocardia seriolae	37332	S	210	60	270	0.00004
SRR6145060	Campylobacter hominis	76517	S	267	3	270	0.00004
SRR6145060	Agrococcus carbonis	684552	S	246	24	270	0.00004
SRR6145060	Streptococcus viridans	78535	S	202	64	266	0.00004
SRR6145060	Gordonia rubripertincta	36822	S	209	57	266	0.00004
SRR6145060	Brachybacterium avium	2017485	S	209	56	265	0.00003
SRR6145060	Rhizobium leguminosarum	384	S	215	48	263	0.00003
SRR6145060	Microbacterium sp. No. 7	1714373	S	262	28	290	0.00004
SRR6145060	Gluconobacter albidus	318683	S	256	6	262	0.00003
SRR6145060	Neisseria lactamica	486	S	163	98	261	0.00003
SRR6145060	Streptomyces hygroscopicus	1912	S	100	160	260	0.00003
SRR6145060	Phycicoccus dokdonensis	443156	S	243	14	257	0.00003
SRR6145060	Mycolicibacterium duvalii	39688	S	228	29	257	0.00003
SRR6145060	Leuconostoc mesenteroides	1245	S	205	52	257	0.00003
SRR6145060	Aeromicrobium choanae	1736691	S	237	20	257	0.00003
SRR6145060	Klebsiella variicola	244366	S	45	211	256	0.00003
SRR6145060	Baekduia soli	496014	S	253	3	256	0.00003
SRR6145060	Nocardioides seonyuensis	2518371	S	217	37	254	0.00003
SRR6145060	Mycolicibacterium rutilum	370526	S	207	47	254	0.00003
SRR6145060	Acinetobacter venetianus	52133	S	238	16	254	0.00003
SRR6145060	Saccharothrix syringae	103733	S	225	28	253	0.00003
SRR6145060	Nocardioides sp. KUDC 5002	2589074	S	253	28	281	0.00004
SRR6145060	Acidipropionibacterium acidipropionici	1748	S	201	52	253	0.00003
SRR6145060	Bacteroides fragilis	817	S	186	66	252	0.00003
SRR6145060	Sinorhizobium fredii	380	S	154	97	251	0.00003
SRR6145060	Nonomuraea sp. ATCC 55076	1909395	S	251	21	272	0.00004
SRR6145060	Nocardia otitidiscaviarum	1823	S	217	33	250	0.00003
SRR6145060	Brevibacterium aurantiacum	273384	S	202	48	250	0.00003
SRR6145060	Curtobacterium flaccumfaciens	2035	S	222	27	249	0.00003
SRR6145060	Pannonibacter phragmitetus	121719	S	194	54	248	0.00003
SRR6145060	Acinetobacter gyllenbergii	134534	S	242	6	248	0.00003
SRR6145060	Rhodococcus pyridinivorans	103816	S	54	192	246	0.00003
SRR6145060	Microbacterium oxydans	82380	S	219	27	246	0.00003
SRR6145060	Mycolicibacterium sediminis	1286180	S	227	18	245	0.00003
SRR6145060	Chryseobacterium indoltheticum	254	S	232	13	245	0.00003
SRR6145060	Bacteroides heparinolyticus	28113	S	174	71	245	0.00003
SRR6145060	Mycolicibacterium boenickei	146017	S	205	39	244	0.00003
SRR6145060	Corynebacterium resistens	258224	S	219	25	244	0.00003
SRR6145060	Brochothrix thermosphacta	2756	S	241	3	244	0.00003
SRR6145060	Rhodococcus aetherivorans	191292	S	37	206	243	0.00003
SRR6145060	Massilia sp. WG5	1707785	S	798	243	1041	0.00014
SRR6145060	Campylobacter concisus	199	S	242	1	243	0.00003
SRR6145060	Mycobacterium gallinarum	39689	S	204	38	242	0.00003
SRR6145060	Ochrobactrum anthropi	529	S	158	83	241	0.00003
SRR6145060	Kocuria flava	446860	S	227	14	241	0.00003
SRR6145060	Deinococcus metallilatus	1211322	S	234	6	240	0.00003
SRR6145060	Luteimonas yindakuii	2565782	S	219	20	239	0.00003
SRR6145060	Lysobacter capsici	435897	S	191	47	238	0.00003
SRR6145060	Luteipulveratus mongoliensis	571913	S	235	3	238	0.00003
SRR6145060	Streptomyces lydicus	47763	S	157	79	236	0.00003
SRR6145060	Aquabacterium olei	1296669	S	203	33	236	0.00003
SRR6145060	Acinetobacter dispersus	70348	S	231	5	236	0.00003
SRR6145060	Mycolicibacterium fortuitum	1766	S	205	30	235	0.00003
SRR6145060	Pseudonocardia sp. EC080610-09	1688404	S	3	234	237	0.00003
SRR6145060	Rubrivivax gelatinosus	28068	S	202	31	233	0.00003
SRR6145060	Ramlibacter tataouinensis	94132	S	215	17	232	0.00003
SRR6145060	Propionibacterium virus Pirate	1982303	S	41	232	273	0.00004
SRR6145060	Cellulosimicrobium cellulans	1710	S	136	96	232	0.00003
SRR6145060	Leuconostoc suionicum	1511761	S	202	29	231	0.00003
SRR6145060	Enterobacteriaceae bacterium ENNIH2	1920109	S	3	231	234	0.00003
SRR6145060	Nocardioides daphniae	402297	S	177	51	228	0.00003
SRR6145060	Cardiobacterium hominis	2718	S	224	4	228	0.00003
SRR6145060	Mycolicibacterium frederiksbergense	117567	S	175	52	227	0.00003
SRR6145060	Sphingopyxis granuli	267128	S	62	164	226	0.00003
SRR6145060	Intrasporangium calvum	53358	S	219	7	226	0.00003
SRR6145060	Faecalibacterium prausnitzii	853	S	193	31	224	0.00003
SRR6145060	Ensifer adhaerens	106592	S	210	14	224	0.00003
SRR6145060	Corynebacterium doosanense	1121358	S	204	18	222	0.00003
SRR6145060	Aeromicrobium erythreum	2041	S	204	18	222	0.00003
SRR6145060	Agrococcus jejuensis	399736	S	191	30	221	0.00003
SRR6145060	Actinomadura verrucosospora	46165	S	200	21	221	0.00003
SRR6145060	Humibacter sp. BT305	2282656	S	50	220	270	0.00004
SRR6145060	Archangium gephyra	48	S	208	12	220	0.00003
SRR6145060	Propionibacterium freudenreichii	1744	S	172	47	219	0.00003
SRR6145060	Defluviimonas alba	1335048	S	184	35	219	0.00003
SRR6145060	Capnocytophaga endodontalis	2708117	S	181	38	219	0.00003
SRR6145060	Pseudomonas luteola	47886	S	178	40	218	0.00003
SRR6145060	Mycolicibacterium litorale	758802	S	181	37	218	0.00003
SRR6145060	Friedmanniella luteola	546871	S	210	8	218	0.00003
SRR6145060	Mycolicibacterium aubagnense	319707	S	180	36	216	0.00003
SRR6145060	Acidipropionibacterium jensenii	1749	S	179	37	216	0.00003
SRR6145060	Serinicoccus marinus	247333	S	168	47	215	0.00003
SRR6145060	Raoultella terrigena	577	S	134	81	215	0.00003
SRR6145060	Micropruina glycogenica	75385	S	210	5	215	0.00003
SRR6145060	Bacteroides vulgatus	821	S	131	83	214	0.00003
SRR6145060	Pantoea agglomerans	549	S	186	26	212	0.00003
SRR6145060	Conexibacter woesei	191495	S	210	2	212	0.00003
SRR6145060	Acidovorax citrulli	80869	S	131	81	212	0.00003
SRR6145060	Paracoccus kondratievae	135740	S	195	16	211	0.00003
SRR6145060	Ottowia oryzae	2109914	S	198	13	211	0.00003
SRR6145060	Streptococcus sp. I-P16	1156433	S	132	210	342	0.00005
SRR6145060	Saccharopolyspora erythraea	1836	S	194	15	209	0.00003
SRR6145060	Rhodococcus sp. p52	935199	S	43	208	251	0.00003
SRR6145060	Mycobacterium dioxanotrophicus	482462	S	192	15	207	0.00003
SRR6145060	Clostridioides difficile	1496	S	124	83	207	0.00003
SRR6145060	Rhizobium sp. Y9	1914541	S	74	206	280	0.00004
SRR6145060	Eikenella corrodens	539	S	184	20	204	0.00003
SRR6145060	Acinetobacter sp. DUT-2	1809055	S	122	204	326	0.00004
SRR6145060	Sphingomonas sp. FARSPH	2219696	S	571	203	774	0.00010
SRR6145060	Pseudomonas chlororaphis	587753	S	162	41	203	0.00003
SRR6145060	Mycolicibacterium rhodesiae	36814	S	170	33	203	0.00003
SRR6145060	Mycolicibacterium madagascariense	212765	S	194	9	203	0.00003
SRR6145060	Gordonia sp. 135	2676309	S	111	203	314	0.00004
SRR6145060	Enterococcus faecalis	1351	S	186	17	203	0.00003
SRR6145060	Mycolicibacterium hassiacum	46351	S	148	54	202	0.00003
SRR6145060	Microbacterium testaceum	2033	S	194	8	202	0.00003
SRR6145060	Corynebacterium urealyticum	43771	S	171	31	202	0.00003
SRR6145060	Amycolatopsis methanolica	1814	S	180	21	201	0.00003
SRR6145060	Tessaracoccus flavescens	399497	S	182	18	200	0.00003
SRR6145060	Micromonospora aurantiaca	47850	S	29	171	200	0.00003
SRR6145060	Mycolicibacterium phlei	1771	S	159	40	199	0.00003
SRR6145060	Sphingomonas wittichii	160791	S	152	46	198	0.00003
SRR6145060	Amycolatopsis keratiniphila	129921	S	122	76	198	0.00003
SRR6145060	Leifsonia xyli	1575	S	176	20	196	0.00003
SRR6145060	Mesorhizobium loti	381	S	60	135	195	0.00003
SRR6145060	Pseudomonas oleovorans	301	S	111	83	194	0.00003
SRR6145060	Luteimonas sp. YGD11-2	2508168	S	1723	194	1917	0.00025
SRR6145060	Dermabacter vaginalis	1630135	S	162	32	194	0.00003
SRR6145060	Acinetobacter wuhouensis	1879050	S	176	18	194	0.00003
SRR6145060	Streptococcus sp. 116-D4	2598453	S	1126	193	1319	0.00017
SRR6145060	Sphingobium baderi	1332080	S	115	77	192	0.00003
SRR6145060	Pseudomonas monteilii	76759	S	119	73	192	0.00003
SRR6145060	Mycolicibacterium goodii	134601	S	161	31	192	0.00003
SRR6145060	Bradyrhizobium lablabi	722472	S	66	126	192	0.00003
SRR6145060	Protaetiibacter intestinalis	2419774	S	173	18	191	0.00003
SRR6145060	Herbaspirillum huttiense	863372	S	159	32	191	0.00003
SRR6145060	Rhizobacter gummiphilus	946333	S	172	18	190	0.00003
SRR6145060	Paracoccus aminophilus	34003	S	182	8	190	0.00003
SRR6145060	Microvirga ossetica	1882682	S	180	10	190	0.00003
SRR6145060	Corynebacterium glyciniphilum	1404244	S	187	2	189	0.00002
SRR6145060	Serpentinomonas mccroryi	1458426	S	167	21	188	0.00002
SRR6145060	Mycolicibacterium chitae	1792	S	160	28	188	0.00002
SRR6145060	Klebsiella quasipneumoniae	1463165	S	45	143	188	0.00002
SRR6145060	Rhodococcus coprophilus	38310	S	175	11	186	0.00002
SRR6145060	Pseudomonas psychrotolerans	237610	S	182	4	186	0.00002
SRR6145060	Microlunatus phosphovorus	29405	S	183	3	186	0.00002
SRR6145060	Caulobacter vibrioides	155892	S	146	40	186	0.00002
SRR6145060	Burkholderia thailandensis	57975	S	28	158	186	0.00002
SRR6145060	Neisseria polysaccharea	489	S	101	84	185	0.00002
SRR6145060	Xanthobacter autotrophicus	280	S	161	23	184	0.00002
SRR6145060	Sphingobacterium hotanense	649196	S	176	8	184	0.00002
SRR6145060	Mycobacterium sp. THAF192	2587868	S	80	184	264	0.00003
SRR6145060	Buchnera aphidicola	9	S	187	-3	184	0.00002
SRR6145060	Microbacterium sediminis	904291	S	163	20	183	0.00002
SRR6145060	Leuconostoc citreum	33964	S	168	15	183	0.00002
SRR6145060	Jiangella alkaliphila	419479	S	160	23	183	0.00002
SRR6145060	Actinosynnema pretiosum	42197	S	79	104	183	0.00002
SRR6145060	Streptomyces albus	1888	S	172	10	182	0.00002
SRR6145060	Bosea vaviloviae	1526658	S	162	20	182	0.00002
SRR6145060	Saccharothrix espanaensis	103731	S	162	18	180	0.00002
SRR6145060	Pluralibacter gergoviae	61647	S	172	8	180	0.00002
SRR6145060	Corynebacterium stationis	1705	S	170	10	180	0.00002
SRR6145060	arsenite-oxidising bacterium NT-25	97707	S	4	179	183	0.00002
SRR6145060	Staphylococcus argenteus	985002	S	31	148	179	0.00002
SRR6145060	Kibdelosporangium phytohabitans	860235	S	173	6	179	0.00002
SRR6145060	Corynebacterium vitaeruminis	38305	S	162	17	179	0.00002
SRR6145060	Amycolatopsis albispora	1804986	S	130	49	179	0.00002
SRR6145060	Streptococcus sp. I-G2	1156431	S	111	178	289	0.00004
SRR6145060	Sphingobacterium lactis	797291	S	166	12	178	0.00002
SRR6145060	Sphaerotilus natans	34103	S	149	29	178	0.00002
SRR6145060	Lentzea guizhouensis	1586287	S	166	12	178	0.00002
SRR6145060	Bradyrhizobium erythrophlei	1437360	S	172	6	178	0.00002
SRR6145060	Aeromonas sp. ASNIH1	1636606	S	35	178	213	0.00003
SRR6145060	Rhodobacteraceae bacterium	1904441	S	127	49	176	0.00002
SRR6145060	Phytohabitans suffuscus	624315	S	155	21	176	0.00002
SRR6145060	Mycolicibacterium tokaiense	39695	S	167	9	176	0.00002
SRR6145060	Methylobacterium sp. DM1	2067957	S	184	176	360	0.00005
SRR6145060	Celeribacter indicus	1208324	S	116	60	176	0.00002
SRR6145060	Pseudomonas nitroreducens	46680	S	132	43	175	0.00002
SRR6145060	Corynebacterium frankenforstense	1230998	S	170	5	175	0.00002
SRR6145060	Streptomyces alfalfae	1642299	S	4	170	174	0.00002
SRR6145060	Mycobacterium chimaera	222805	S	85	89	174	0.00002
SRR6145060	Lysobacter maris	1605891	S	155	19	174	0.00002
SRR6145060	Catenulispora acidiphila	304895	S	172	2	174	0.00002
SRR6145060	Burkholderia cepacia	292	S	101	73	174	0.00002
SRR6145060	Sphingopyxis fribergensis	1515612	S	139	34	173	0.00002
SRR6145060	Melittangium boletus	83453	S	154	19	173	0.00002
SRR6145060	Lysobacter antibioticus	84531	S	145	28	173	0.00002
SRR6145060	Gordonia phthalatica	1136941	S	158	15	173	0.00002
SRR6145060	Erythrobacter flavus	192812	S	104	69	173	0.00002
SRR6145060	Azospirillum lipoferum	193	S	127	46	173	0.00002
SRR6145060	Caulobacter segnis	88688	S	143	29	172	0.00002
SRR6145060	Allokutzneria albata	211114	S	160	12	172	0.00002
SRR6145060	Streptococcus equinus	1335	S	87	84	171	0.00002
SRR6145060	Serinicoccus chungangensis	767452	S	151	20	171	0.00002
SRR6145060	Pseudoalteromonas nigrifaciens	28109	S	57	114	171	0.00002
SRR6145060	Massilia violaceinigra	2045208	S	162	9	171	0.00002
SRR6145060	Lactobacillus paracasei	1597	S	14	157	171	0.00002
SRR6145060	Kribbella flavida	182640	S	166	5	171	0.00002
SRR6145060	Chryseobacterium bernardetii	1241978	S	149	22	171	0.00002
SRR6145060	Caulobacter rhizosphaerae	2010972	S	141	30	171	0.00002
SRR6145060	Sphingomonas sp. MM-1	745310	S	221	169	390	0.00005
SRR6145060	Dermabacter jinjuensis	1667168	S	91	78	169	0.00002
SRR6145060	Chryseobacterium balustinum	246	S	155	14	169	0.00002
SRR6145060	Burkholderia gladioli	28095	S	156	13	169	0.00002
SRR6145060	Acinetobacter sp. WCHA45	2004644	S	1085	169	1254	0.00017
SRR6145060	Sphingobium hydrophobicum	1673076	S	110	58	168	0.00002
SRR6145060	Corynebacterium phocae	161895	S	167	1	168	0.00002
SRR6145060	Streptococcus milleri	33040	S	82	85	167	0.00002
SRR6145060	Rhodanobacter denitrificans	666685	S	146	20	166	0.00002
SRR6145060	Pseudonocardia sp. EC080625-04	1096868	S	7	166	173	0.00002
SRR6145060	Kutzneria albida	43357	S	156	10	166	0.00002
SRR6145060	Neisseria gonorrhoeae	485	S	89	76	165	0.00002
SRR6145060	Ralstonia pickettii	329	S	105	59	164	0.00002
SRR6145060	Mycolicibacterium confluentis	28047	S	155	9	164	0.00002
SRR6145060	Actinoplanes teichomyceticus	1867	S	145	19	164	0.00002
SRR6145060	Streptococcus suis	1307	S	154	9	163	0.00002
SRR6145060	Sphingomonas indica	941907	S	160	3	163	0.00002
SRR6145060	Caulobacter mirabilis	69666	S	154	9	163	0.00002
SRR6145060	Bradyrhizobium japonicum	375	S	55	108	163	0.00002
SRR6145060	Nocardiopsis dassonvillei	2014	S	152	10	162	0.00002
SRR6145060	Mixta calida	665913	S	139	23	162	0.00002
SRR6145060	Lysobacter lycopersici	1324796	S	151	11	162	0.00002
SRR6145060	Jiangella sp. DSM 45060	1798224	S	162	25	187	0.00002
SRR6145060	Diaphorobacter polyhydroxybutyrativorans	1546149	S	30	132	162	0.00002
SRR6145060	Acinetobacter sp. SWBY1	2079596	S	205	162	367	0.00005
SRR6145060	Mycolicibacterium moriokaense	39691	S	153	8	161	0.00002
SRR6145060	Pseudomonas plecoglossicida	70775	S	94	66	160	0.00002
SRR6145060	Streptococcus pseudoporcinus	361101	S	66	93	159	0.00002
SRR6145060	Microterricola viridarii	412690	S	150	9	159	0.00002
SRR6145060	Mycolicibacterium thermoresistibile	1797	S	132	26	158	0.00002
SRR6145060	Mycolicibacterium fallax	1793	S	128	30	158	0.00002
SRR6145060	Acidovorax carolinensis	553814	S	115	43	158	0.00002
SRR6145060	Corynebacterium humireducens	1223514	S	152	5	157	0.00002
SRR6145060	Brasilonema sennae	1397703	S	1	155	156	0.00002
SRR6145060	Streptomyces spectabilis	68270	S	132	23	155	0.00002
SRR6145060	Leptothrix cholodnii	34029	S	132	23	155	0.00002
SRR6145060	Amycolatopsis sp. YIM 10	2653857	S	155	23	178	0.00002
SRR6145060	Actinoplanes derwentensis	113562	S	149	6	155	0.00002
SRR6145060	Actinomadura amylolytica	1411117	S	140	15	155	0.00002
SRR6145060	Sanguibacter keddieii	60920	S	150	4	154	0.00002
SRR6145060	Lysobacter gummosus	262324	S	122	32	154	0.00002
SRR6145060	Mycolicibacterium celeriflavum	1249101	S	136	16	152	0.00002
SRR6145060	Chryseobacterium carnipullorum	1124835	S	138	14	152	0.00002
SRR6145060	Sinomonas atrocyanea	37927	S	149	2	151	0.00002
SRR6145060	Mycobacterium intracellulare	1767	S	41	110	151	0.00002
SRR6145060	Cellulomonas fimi	1708	S	116	35	151	0.00002
SRR6145060	Streptococcus periodonticum	2490633	S	69	81	150	0.00002
SRR6145060	Rhodoferax koreense	1842727	S	127	23	150	0.00002
SRR6145060	Paraburkholderia aromaticivorans	2026199	S	132	18	150	0.00002
SRR6145060	Frankia inefficax	298654	S	148	2	150	0.00002
SRR6145060	Bosea sp. PAMC 26642	1792307	S	150	16	166	0.00002
SRR6145060	Streptosporangium roseum	2001	S	134	15	149	0.00002
SRR6145060	Xanthomonas translucens	343	S	134	14	148	0.00002
SRR6145060	Diaphorobacter sp. JS3050	2735554	S	17	148	165	0.00002
SRR6145060	Rathayibacter festucae	110937	S	80	67	147	0.00002
SRR6145060	Lachnoanaerobaculum umeaense	617123	S	145	2	147	0.00002
SRR6145060	Streptomyces chartreusis	1969	S	124	22	146	0.00002
SRR6145060	Cellulomonas shaoxiangyii	2566013	S	134	12	146	0.00002
SRR6145060	Actinoplanes missouriensis	1866	S	129	17	146	0.00002
SRR6145060	Paracoccus sp. Arc7-R13	2500532	S	1229	145	1374	0.00018
SRR6145060	Myxococcus xanthus	34	S	125	20	145	0.00002
SRR6145060	Corynebacterium ammoniagenes	1697	S	138	7	145	0.00002
SRR6145060	Xanthomonas sacchari	56458	S	126	18	144	0.00002
SRR6145060	Roseateles depolymerans	76731	S	128	16	144	0.00002
SRR6145060	Lysobacter soli	453783	S	132	12	144	0.00002
SRR6145060	Citrobacter freundii	546	S	39	105	144	0.00002
SRR6145060	Bacillus subtilis	1423	S	36	108	144	0.00002
SRR6145060	Tessaracoccus aquimaris	1332264	S	134	9	143	0.00002
SRR6145060	Rhizobium sp. IRBG74	424182	S	43	143	186	0.00002
SRR6145060	Paraoceanicella profunda	2579971	S	123	19	142	0.00002
SRR6145060	Massilia armeniaca	2072590	S	107	35	142	0.00002
SRR6145060	Agromyces aureus	453304	S	124	18	142	0.00002
SRR6145060	Acinetobacter guillouiae	106649	S	140	2	142	0.00002
SRR6145060	Massilia albidiflava	321983	S	114	27	141	0.00002
SRR6145060	Croceicoccus naphthovorans	1348774	S	66	75	141	0.00002
SRR6145060	Corynebacterium marinum	349751	S	131	10	141	0.00002
SRR6145060	Sphingobium sp. RSMS	520734	S	48	140	188	0.00002
SRR6145060	Minicystis rosea	888845	S	137	3	140	0.00002
SRR6145060	Actinomyces slackii	52774	S	138	2	140	0.00002
SRR6145060	Streptomyces viridifaciens	48665	S	29	110	139	0.00002
SRR6145060	Mycolicibacterium anyangense	1431246	S	131	8	139	0.00002
SRR6145060	Corynebacterium testudinoris	136857	S	135	4	139	0.00002
SRR6145060	Corynebacterium maris	575200	S	137	2	139	0.00002
SRR6145060	Corynebacterium halotolerans	225326	S	135	4	139	0.00002
SRR6145060	Auraticoccus monumenti	675864	S	137	2	139	0.00002
SRR6145060	Actinoplanes friuliensis	196914	S	134	5	139	0.00002
SRR6145060	Streptococcus sp. FDAARGOS_192	1839799	S	85	138	223	0.00003
SRR6145060	Porphyrobacter sp. CACIAM 03H1	2003315	S	138	21	159	0.00002
SRR6145060	Lactococcus garvieae	1363	S	118	20	138	0.00002
SRR6145060	Deinococcus geothermalis	68909	S	131	7	138	0.00002
SRR6145060	Campylobacter rectus	203	S	137	1	138	0.00002
SRR6145060	Beijerinckiaceae bacterium RH AL1	2572036	S	138	10	148	0.00002
SRR6145060	Agrobacterium larrymoorei	160699	S	133	5	138	0.00002
SRR6145060	Streptomyces niveus	193462	S	123	14	137	0.00002
SRR6145060	Stenotrophomonas sp. ASS1	2282124	S	82	137	219	0.00003
SRR6145060	Mycobacterium parmense	185642	S	128	9	137	0.00002
SRR6145060	Halomonas sp. JS92-SW72	2306583	S	285	137	422	0.00006
SRR6145060	Phytohabitans flavus	1076124	S	123	13	136	0.00002
SRR6145060	Asticcacaulis excentricus	78587	S	134	2	136	0.00002
SRR6145060	Aeromonas sp. ASNIH5	1758179	S	32	136	168	0.00002
SRR6145060	Deinococcus swuensis	1182571	S	133	2	135	0.00002
SRR6145060	Qipengyuania sediminis	1532023	S	129	5	134	0.00002
SRR6145060	Pseudomonas syringae	317	S	67	67	134	0.00002
SRR6145060	Glutamicibacter creatinolyticus	162496	S	132	2	134	0.00002
SRR6145060	Gemmatirosa kalamazoonesis	861299	S	134	0	134	0.00002
SRR6145060	Alcaligenes faecalis	511	S	121	13	134	0.00002
SRR6145060	Sinorhizobium meliloti	382	S	118	15	133	0.00002
SRR6145060	Rhodococcus sp. 008	1723645	S	19	133	152	0.00002
SRR6145060	Mycobacterium conspicuum	44010	S	130	3	133	0.00002
SRR6145060	Massilia flava	871742	S	120	13	133	0.00002
SRR6145060	Erythrobacter litoralis	39960	S	95	38	133	0.00002
SRR6145060	Streptomyces bingchenggensis	379067	S	126	6	132	0.00002
SRR6145060	Kitasatospora setae	2066	S	125	7	132	0.00002
SRR6145060	Aerosticca soli	2010829	S	97	35	132	0.00002
SRR6145060	Salipiger profundus	1229727	S	91	40	131	0.00002
SRR6145060	Rhizobium flavum	1335061	S	89	42	131	0.00002
SRR6145060	Pantoea vagans	470934	S	87	44	131	0.00002
SRR6145060	Nocardioides sp. CF8	110319	S	322	131	453	0.00006
SRR6145060	Mycolicibacterium helvum	1534349	S	120	11	131	0.00002
SRR6145060	Microbacterium lemovicicum	1072463	S	125	6	131	0.00002
SRR6145060	Burkholderia pseudomallei	28450	S	46	85	131	0.00002
SRR6145060	Rhodovulum sulfidophilum	35806	S	93	37	130	0.00002
SRR6145060	Mycolicibacterium pulveris	36813	S	119	11	130	0.00002
SRR6145060	Mycolicibacterium alvei	67081	S	106	24	130	0.00002
SRR6145060	Mogibacterium diversum	114527	S	124	6	130	0.00002
SRR6145060	Microlunatus soli	630515	S	126	4	130	0.00002
SRR6145060	Streptococcus sp. LPB0220	2610896	S	364	129	493	0.00006
SRR6145060	Staphylococcus simulans	1286	S	125	4	129	0.00002
SRR6145060	Paraburkholderia caffeinilytica	1761016	S	120	9	129	0.00002
SRR6145060	Microcella alkaliphila	279828	S	124	5	129	0.00002
SRR6145060	Kozakia baliensis	153496	S	122	7	129	0.00002
SRR6145060	Azorhizobium caulinodans	7	S	121	8	129	0.00002
SRR6145060	Actinomyces howellii	52771	S	128	1	129	0.00002
SRR6145060	Acinetobacter calcoaceticus	471	S	122	7	129	0.00002
SRR6145060	Streptococcus sp. HSISM1	1316408	S	375	128	503	0.00007
SRR6145060	Microbacterium oryzae	743009	S	122	6	128	0.00002
SRR6145060	Microbacterium oleivorans	273677	S	123	5	128	0.00002
SRR6145060	Cupriavidus necator	106590	S	106	22	128	0.00002
SRR6145060	Brevibacterium sandarakinum	629680	S	114	14	128	0.00002
SRR6145060	Sphingopyxis lindanitolerans	2054227	S	99	28	127	0.00002
SRR6145060	Neorhizobium galegae	399	S	123	4	127	0.00002
SRR6145060	Chryseobacterium carnis	1241979	S	122	5	127	0.00002
SRR6145060	Acinetobacter cumulans	2136182	S	119	8	127	0.00002
SRR6145060	Sphingobium sp. PAMC28499	2565554	S	139	126	265	0.00003
SRR6145060	Mycolicibacterium sarraceniae	1534348	S	114	12	126	0.00002
SRR6145060	Massilia umbonata	864828	S	102	24	126	0.00002
SRR6145060	Capnocytophaga ochracea	1018	S	77	49	126	0.00002
SRR6145060	Saccharomonospora marina	632569	S	103	22	125	0.00002
SRR6145060	Rhodococcus sp. NJ-530	2490853	S	18	125	143	0.00002
SRR6145060	Rhodococcus jostii	132919	S	100	25	125	0.00002
SRR6145060	Hydrogenophaga sp. NH-16	2184519	S	130	125	255	0.00003
SRR6145060	Cupriavidus metallidurans	119219	S	89	36	125	0.00002
SRR6145060	Bordetella bronchiseptica	518	S	20	105	125	0.00002
SRR6145060	Moraxella catarrhalis	480	S	123	1	124	0.00002
SRR6145060	Massilia sp. NR 4-1	1678028	S	124	12	136	0.00002
SRR6145060	Janthinobacterium agaricidamnosum	55508	S	104	20	124	0.00002
SRR6145060	Chryseobacterium glaciei	1685010	S	118	6	124	0.00002
SRR6145060	Aeromicrobium marinum	219314	S	115	9	124	0.00002
SRR6145060	Acinetobacter defluvii	1871111	S	110	14	124	0.00002
SRR6145060	Stella humosa	94	S	121	2	123	0.00002
SRR6145060	Rhodobacter blasticus	1075	S	119	4	123	0.00002
SRR6145060	Nakamurella panacisegetis	1090615	S	122	1	123	0.00002
SRR6145060	Mycobacterium saskatchewanense	220927	S	119	4	123	0.00002
SRR6145060	Chryseobacterium aureum	2497456	S	119	4	123	0.00002
SRR6145060	Xanthomonas euvesicatoria	456327	S	12	110	122	0.00002
SRR6145060	Micromonospora echinofusca	47858	S	104	18	122	0.00002
SRR6145060	Filifactor alocis	143361	S	113	9	122	0.00002
SRR6145060	Dermabacter hominis	36740	S	72	50	122	0.00002
SRR6145060	Aeromonas sp. ASNIH3	1636608	S	30	122	152	0.00002
SRR6145060	Acinetobacter sp. FDAARGOS_493	2420300	S	8	122	130	0.00002
SRR6145060	Mycobacterium branderi	43348	S	118	3	121	0.00002
SRR6145060	Mesorhizobium ciceri	39645	S	33	88	121	0.00002
SRR6145060	Isoptericola variabilis	139208	S	111	10	121	0.00002
SRR6145060	Dokdonella koreensis	323415	S	117	4	121	0.00002
SRR6145060	Burkholderia multivorans	87883	S	97	24	121	0.00002
SRR6145060	Beutenbergia cavernae	84757	S	119	2	121	0.00002
SRR6145060	Streptomyces tsukubensis	83656	S	113	7	120	0.00002
SRR6145060	Streptomyces griseorubiginosus	67304	S	105	15	120	0.00002
SRR6145060	Streptomyces albulus	68570	S	108	12	120	0.00002
SRR6145060	Luteimicrobium xylanilyticum	1133546	S	116	4	120	0.00002
SRR6145060	Corynebacterium efficiens	152794	S	118	2	120	0.00002
SRR6145060	Azospirillum sp. CFH 70021	2202148	S	120	9	129	0.00002
SRR6145060	Pseudomonas citronellolis	53408	S	108	11	119	0.00002
SRR6145060	Propionibacterium acidifaciens	556499	S	112	7	119	0.00002
SRR6145060	Cellulomonas flavigena	1711	S	111	8	119	0.00002
SRR6145060	Campylobacter gracilis	824	S	119	0	119	0.00002
SRR6145060	Tessaracoccus flavus	1610493	S	110	8	118	0.00002
SRR6145060	Marinovum algicola	42444	S	90	28	118	0.00002
SRR6145060	Isoptericola dokdonensis	372663	S	111	7	118	0.00002
SRR6145060	Cupriavidus oxalaticus	96344	S	97	21	118	0.00002
SRR6145060	Acidovorax ebreus	721785	S	16	102	118	0.00002
SRR6145060	Achromobacter spanius	217203	S	104	14	118	0.00002
SRR6145060	Streptomyces griseus	1911	S	89	28	117	0.00002
SRR6145060	Pseudomonas sihuiensis	1274359	S	83	34	117	0.00002
SRR6145060	Polymorphum gilvum	991904	S	108	9	117	0.00002
SRR6145060	Corynebacterium uterequi	1072256	S	116	1	117	0.00002
SRR6145060	Acidovorax cattleyae	80868	S	79	38	117	0.00002
SRR6145060	Iamiaceae bacterium SCSIO 58843	2664374	S	116	1	117	0.00002
SRR6145060	Cupriavidus gilardii	82541	S	82	34	116	0.00002
SRR6145060	Achromobacter sp. MFA1 R4	1881016	S	116	14	130	0.00002
SRR6145060	Variovorax boronicumulans	436515	S	66	49	115	0.00002
SRR6145060	Streptococcus sp. FDAARGOS_522	2420310	S	2	115	117	0.00002
SRR6145060	Rhizobium phaseoli	396	S	47	68	115	0.00002
SRR6145060	Mycobacterium kansasii	1768	S	112	3	115	0.00002
SRR6145060	Methylibium petroleiphilum	105560	S	62	53	115	0.00002
SRR6145060	Erwinia billingiae	182337	S	67	48	115	0.00002
SRR6145060	[Polyangium] brachysporum	413882	S	108	6	114	0.00002
SRR6145060	Xylophilus sp. KACC 21265	2697032	S	114	18	132	0.00002
SRR6145060	Sandaracinus amylolyticus	927083	S	114	0	114	0.00002
SRR6145060	Pelagibaca abyssi	1250539	S	84	30	114	0.00002
SRR6145060	Microbacterium pygmaeum	370764	S	112	2	114	0.00002
SRR6145060	Frankia alni	1859	S	89	25	114	0.00002
SRR6145060	Enterococcus faecium	1352	S	62	52	114	0.00002
SRR6145060	Croceicoccus marinus	450378	S	75	39	114	0.00002
SRR6145060	Corynebacterium ulcerans	65058	S	110	4	114	0.00002
SRR6145060	Tardibacter chloracetimidivorans	1921510	S	70	43	113	0.00001
SRR6145060	Streptomyces cattleya	29303	S	108	5	113	0.00001
SRR6145060	Pseudarthrobacter phenanthrenivorans	361575	S	103	10	113	0.00001
SRR6145060	Burkholderia vietnamiensis	60552	S	32	81	113	0.00001
SRR6145060	Bradyrhizobium sp.	376	S	34	79	113	0.00001
SRR6145060	Yangia pacifica	311180	S	103	9	112	0.00001
SRR6145060	Treponema denticola	158	S	103	9	112	0.00001
SRR6145060	Streptomyces sp. CC0208	2306165	S	2	112	114	0.00002
SRR6145060	Saccharomonospora azurea	40988	S	92	20	112	0.00001
SRR6145060	Rhodobacter capsulatus	1061	S	102	10	112	0.00001
SRR6145060	Pseudomonas sp. phDV1	253237	S	89	112	201	0.00003
SRR6145060	Porphyrobacter neustonensis	1112	S	103	9	112	0.00001
SRR6145060	Gluconobacter thailandicus	257438	S	83	29	112	0.00001
SRR6145060	Fusobacterium periodonticum	860	S	57	55	112	0.00001
SRR6145060	Delftia acidovorans	80866	S	42	70	112	0.00001
SRR6145060	Comamonas thiooxydans	363952	S	63	49	112	0.00001
SRR6145060	Sphingobacterium thalpophilum	259	S	101	10	111	0.00001
SRR6145060	Leucobacter triazinivorans	1784719	S	102	9	111	0.00001
SRR6145060	Enterobacter asburiae	61645	S	48	63	111	0.00001
SRR6145060	Corynebacterium nuruki	1032851	S	108	3	111	0.00001
SRR6145060	Chryseobacterium sp. NBC 122	2547600	S	111	1	112	0.00001
SRR6145060	Campylobacter jejuni	197	S	33	78	111	0.00001
SRR6145060	Agromyces flavus	589382	S	98	13	111	0.00001
SRR6145060	Starkeya novella	921	S	94	16	110	0.00001
SRR6145060	Rhodococcus qingshengii	334542	S	15	95	110	0.00001
SRR6145060	Microbacterium protaetiae	2509458	S	105	5	110	0.00001
SRR6145060	Corallococcus macrosporus	35	S	88	22	110	0.00001
SRR6145060	Bacillus megaterium	1404	S	90	20	110	0.00001
SRR6145060	Nocardioides sp. HDW12A	2714938	S	198	109	307	0.00004
SRR6145060	Labrys neptuniae	376174	S	107	2	109	0.00001
SRR6145060	Corynebacterium sphenisci	191493	S	106	3	109	0.00001
SRR6145060	Chryseobacterium sp. NEB161	2724619	S	642	109	751	0.00010
SRR6145060	Amycolatopsis orientalis	31958	S	91	18	109	0.00001
SRR6145060	Mycolicibacter sinensis	875328	S	98	10	108	0.00001
SRR6145060	Mycobacterium florentinum	292462	S	96	12	108	0.00001
SRR6145060	Cellulomonas gilvus	11	S	99	9	108	0.00001
SRR6145060	Bacteroides dorei	357276	S	65	43	108	0.00001
SRR6145060	Streptacidiphilus bronchialis	2126346	S	103	4	107	0.00001
SRR6145060	Lactobacillus gasseri	1596	S	24	83	107	0.00001
SRR6145060	Actinopolymorpha singaporensis	117157	S	106	1	107	0.00001
SRR6145060	Acetobacter persici	1076596	S	105	2	107	0.00001
SRR6145060	Pseudomonas entomophila	312306	S	101	5	106	0.00001
SRR6145060	Pseudomonas azotoformans	47878	S	84	22	106	0.00001
SRR6145060	Novosphingobium pentaromativorans	205844	S	48	58	106	0.00001
SRR6145060	Myxococcus stipitatus	83455	S	104	2	106	0.00001
SRR6145060	Mycobacterium colombiense	339268	S	104	2	106	0.00001
SRR6145060	Microbacterium sp. str. 'China'	2103230	S	106	388	494	0.00007
SRR6145060	Massilia lutea	321985	S	91	15	106	0.00001
SRR6145060	Labilithrix luteola	1391654	S	105	1	106	0.00001
SRR6145060	Chryseobacterium gallinarum	1324352	S	102	4	106	0.00001
SRR6145060	Bradyrhizobium guangzhouense	1325095	S	76	30	106	0.00001
SRR6145060	Azospirillum thiophilum	528244	S	90	16	106	0.00001
SRR6145060	Aeromonas veronii	654	S	92	14	106	0.00001
SRR6145060	Acidipropionibacterium virtanenii	2057246	S	97	9	106	0.00001
SRR6145060	Achromobacter denitrificans	32002	S	79	27	106	0.00001
SRR6145060	Thioclava nitratireducens	1915078	S	97	8	105	0.00001
SRR6145060	Pseudomonas otitidis	319939	S	103	2	105	0.00001
SRR6145060	Pseudoalteromonas haloplanktis	228	S	32	73	105	0.00001
SRR6145060	Novosphingobium sp. Gsoil 351	2675225	S	105	2	107	0.00001
SRR6145060	Mycolicibacterium insubricum	444597	S	92	13	105	0.00001
SRR6145060	Micromonospora echinaurantiaca	47857	S	87	18	105	0.00001
SRR6145060	Microbacterium sp. SGAir0570	2070348	S	40	105	145	0.00002
SRR6145060	Haliangium ochraceum	80816	S	104	1	105	0.00001
SRR6145060	Enterobacter kobei	208224	S	28	77	105	0.00001
SRR6145060	Deinococcus proteolyticus	55148	S	103	2	105	0.00001
SRR6145060	Calothrix sp. NIES-2100	1954172	S	24	105	129	0.00002
SRR6145060	Weissella paramesenteroides	1249	S	98	6	104	0.00001
SRR6145060	Streptomyces fungicidicus	68203	S	87	17	104	0.00001
SRR6145060	Rhodococcus sp. 2G	1570939	S	29	104	133	0.00002
SRR6145060	Micromonospora krabiensis	307121	S	92	12	104	0.00001
SRR6145060	Inhella inkyongensis	392593	S	95	9	104	0.00001
SRR6145060	Arthrobacter alpinus	656366	S	64	40	104	0.00001
SRR6145060	Verrucosispora maris	1003110	S	88	15	103	0.00001
SRR6145060	Streptomyces avermitilis	33903	S	93	10	103	0.00001
SRR6145060	Staphylococcus succinus	61015	S	102	1	103	0.00001
SRR6145060	Salmonella bongori	54736	S	7	96	103	0.00001
SRR6145060	Mycobacterium heidelbergense	53376	S	96	7	103	0.00001
SRR6145060	Lysobacter alkalisoli	2591633	S	95	8	103	0.00001
SRR6145060	Lachnospiraceae bacterium	1898203	S	5	98	103	0.00001
SRR6145060	Spirosoma pollinicola	2057025	S	97	5	102	0.00001
SRR6145060	Sphingopyxis sp. MG	1866325	S	21	102	123	0.00002
SRR6145060	Sphingopyxis alaskensis	117207	S	94	8	102	0.00001
SRR6145060	Micromonospora auratinigra	261654	S	83	19	102	0.00001
SRR6145060	Methylobacterium sp. 17Sr1-43	2202828	S	1436	102	1538	0.00020
SRR6145060	Chryseobacterium camelliae	1265445	S	97	5	102	0.00001
SRR6145060	Campylobacter fetus	196	S	93	9	102	0.00001
SRR6145060	Thermomonospora curvata	2020	S	93	8	101	0.00001
SRR6145060	Sphingobium sp. LF-16	2185111	S	10	101	111	0.00001
SRR6145060	Rickettsia felis	42862	S	93	8	101	0.00001
SRR6145060	Propionibacterium phage PHL085N00	1500812	S	4	101	105	0.00001
SRR6145060	Mycolicibacillus koreensis	1069220	S	91	10	101	0.00001
SRR6145060	Mycobacterium stomatepiae	470076	S	88	13	101	0.00001
SRR6145060	Mycobacterium cookii	1775	S	100	1	101	0.00001
SRR6145060	Streptomyces rimosus	1927	S	94	6	100	0.00001
SRR6145060	Streptomyces actuosus	1885	S	86	14	100	0.00001
SRR6145060	Saccharomonospora cyanea	40989	S	73	27	100	0.00001
SRR6145060	Nocardiopsis alba	53437	S	95	5	100	0.00001
SRR6145060	Micromonospora narathiwatensis	299146	S	82	18	100	0.00001
SRR6145060	Clostridium perfringens	1502	S	98	2	100	0.00001
SRR6145060	Clostridium beijerinckii	1520	S	59	41	100	0.00001
SRR6145060	Xylanimonas allomyrinae	2509459	S	90	9	99	0.00001
SRR6145060	Streptomyces sp. SCSIO 03032	1109743	S	99	2	101	0.00001
SRR6145060	Raoultella ornithinolytica	54291	S	27	72	99	0.00001
SRR6145060	Prochlorococcus marinus	1219	S	87	12	99	0.00001
SRR6145060	Phreatobacter stygius	1940610	S	96	3	99	0.00001
SRR6145060	Micromonospora terminaliae	1914461	S	81	18	99	0.00001
SRR6145060	Elizabethkingia meningoseptica	238	S	98	1	99	0.00001
SRR6145060	Dinoroseobacter shibae	215813	S	71	28	99	0.00001
SRR6145060	Chryseobacterium sp. SNU WT5	2594269	S	99	7	106	0.00001
SRR6145060	Phreatobacter cathodiphilus	1868589	S	92	6	98	0.00001
SRR6145060	Mycolicibacter hiberniae	29314	S	91	7	98	0.00001
SRR6145060	Mycobacterium sp. WY10	1920667	S	40	98	138	0.00002
SRR6145060	Micromonospora viridifaciens	1881	S	82	16	98	0.00001
SRR6145060	Bacillus flexus	86664	S	97	1	98	0.00001
SRR6145060	Aquisphaera giovannonii	406548	S	95	3	98	0.00001
SRR6145060	Parabacteroides distasonis	823	S	47	50	97	0.00001
SRR6145060	Mycolicibacterium aichiense	1799	S	81	16	97	0.00001
SRR6145060	Micromonospora inositola	47865	S	80	17	97	0.00001
SRR6145060	Micromonospora echinospora	1877	S	89	8	97	0.00001
SRR6145060	Methylorubrum zatmanii	29429	S	13	84	97	0.00001
SRR6145060	Methylobacterium sp. AMS5	925818	S	170	97	267	0.00004
SRR6145060	Chryseobacterium lactis	1241981	S	86	11	97	0.00001
SRR6145060	Chryseobacterium jeonii	266749	S	97	0	97	0.00001
SRR6145060	Aerococcus urinae	1376	S	95	2	97	0.00001
SRR6145060	Xylanimonas cellulosilytica	186189	S	87	9	96	0.00001
SRR6145060	Streptomyces griseochromogenes	68214	S	86	10	96	0.00001
SRR6145060	Streptomyces aureoverticillatus	66871	S	87	9	96	0.00001
SRR6145060	Streptomyces albireticuli	1940	S	89	7	96	0.00001
SRR6145060	Streptococcus sp. A12	1759399	S	390	96	486	0.00006
SRR6145060	Rhizobium pseudoryzae	379684	S	92	4	96	0.00001
SRR6145060	Mycobacteroides saopaulense	1578165	S	91	5	96	0.00001
SRR6145060	Mesorhizobium oceanicum	1670800	S	90	6	96	0.00001
SRR6145060	Massilia plicata	321984	S	85	11	96	0.00001
SRR6145060	Kitasatospora aureofaciens	1894	S	16	80	96	0.00001
SRR6145060	Hymenobacter sp. PAMC 26554	1484116	S	96	3	99	0.00001
SRR6145060	Anaeromyxobacter dehalogenans	161493	S	74	22	96	0.00001
SRR6145060	Altererythrobacter dongtanensis	692370	S	87	9	96	0.00001
SRR6145060	Weissella cibaria	137591	S	91	4	95	0.00001
SRR6145060	Streptomyces vietnamensis	362257	S	83	12	95	0.00001
SRR6145060	Streptomyces aquilus	2548456	S	84	11	95	0.00001
SRR6145060	Stackebrandtia nassauensis	283811	S	95	0	95	0.00001
SRR6145060	Silicimonas algicola	1826607	S	94	1	95	0.00001
SRR6145060	Paraprevotella xylaniphila	454155	S	64	31	95	0.00001
SRR6145060	Hymenobacter sedentarius	1411621	S	90	5	95	0.00001
SRR6145060	Frondihabitans sp. PAMC 28766	1795630	S	95	4	99	0.00001
SRR6145060	Comamonas serinivorans	1082851	S	88	7	95	0.00001
SRR6145060	Agrobacterium fabrum	1176649	S	81	14	95	0.00001
SRR6145060	Streptomyces collinus	42684	S	81	13	94	0.00001
SRR6145060	Streptomyces ambofaciens	1889	S	76	18	94	0.00001
SRR6145060	Psychrobacter alimentarius	261164	S	3	91	94	0.00001
SRR6145060	Paucibacter sp. KCTC 42545	1768242	S	94	10	104	0.00001
SRR6145060	Paracoccus sp. AK26	2589076	S	1814	94	1908	0.00025
SRR6145060	Mycobacterium simiae	1784	S	92	2	94	0.00001
SRR6145060	Mycobacterium shigaense	722731	S	88	6	94	0.00001
SRR6145060	Micromonospora purpureochromogenes	47872	S	76	18	94	0.00001
SRR6145060	Mameliella alba	561184	S	81	13	94	0.00001
SRR6145060	Leifsonia sp. 21MFCrub1.1	1798223	S	84	94	178	0.00002
SRR6145060	Exiguobacterium mexicanum	340146	S	92	2	94	0.00001
SRR6145060	Corynebacterium callunae	1721	S	88	6	94	0.00001
SRR6145060	Xanthomonas phaseoli	1985254	S	15	78	93	0.00001
SRR6145060	Streptomyces sp. YIM 121038	2136401	S	93	17	110	0.00001
SRR6145060	Streptococcus equi	1336	S	90	3	93	0.00001
SRR6145060	Sphingomonas sp. C8-2	2492837	S	145	93	238	0.00003
SRR6145060	Rathayibacter sp. VKM Ac-2759	2609252	S	93	14	107	0.00001
SRR6145060	Pulveribacter suum	2116657	S	82	11	93	0.00001
SRR6145060	Pseudomonas sp. BJP69	2597770	S	75	93	168	0.00002
SRR6145060	Listeria monocytogenes	1639	S	49	44	93	0.00001
SRR6145060	Bradyrhizobium guangdongense	1325090	S	60	33	93	0.00001
SRR6145060	Tessaracoccus timonensis	2161816	S	86	6	92	0.00001
SRR6145060	Streptomyces globosus	68209	S	83	9	92	0.00001
SRR6145060	Streptomyces globisporus	1908	S	59	33	92	0.00001
SRR6145060	Streptomyces formicae	1616117	S	74	18	92	0.00001
SRR6145060	Stenotrophomonas sp. pho	2211160	S	31	92	123	0.00002
SRR6145060	Pseudomonas fragi	296	S	54	38	92	0.00001
SRR6145060	Corynebacterium renale	1724	S	92	0	92	0.00001
SRR6145060	Corynebacterium cystitidis	35757	S	92	0	92	0.00001
SRR6145060	Citrobacter sp. SL156	2079228	S	1	92	93	0.00001
SRR6145060	Bradyrhizobium diazoefficiens	1355477	S	26	66	92	0.00001
SRR6145060	Actinoplanes sp. OR16	946334	S	134	92	226	0.00003
SRR6145060	Acinetobacter oleivorans	1148157	S	83	9	92	0.00001
SRR6145060	Micromonospora siamensis	299152	S	76	15	91	0.00001
SRR6145060	Micromonospora coxensis	356852	S	73	18	91	0.00001
SRR6145060	Microbacterium wangchenii	2541726	S	86	5	91	0.00001
SRR6145060	Elizabethkingia miricola	172045	S	54	37	91	0.00001
SRR6145060	Anabaena sp. YBS01	2490939	S	2	91	93	0.00001
SRR6145060	Agromyces protaetiae	2509455	S	79	12	91	0.00001
SRR6145060	Thauera humireducens	1134435	S	81	9	90	0.00001
SRR6145060	Streptomyces griseoviridis	45398	S	82	8	90	0.00001
SRR6145060	Streptomyces asterosporus	285570	S	75	15	90	0.00001
SRR6145060	Novosphingobium aromaticivorans	48935	S	78	12	90	0.00001
SRR6145060	Mobiluncus curtisii	2051	S	88	2	90	0.00001
SRR6145060	Duganella sp. GN2-R2	2728020	S	527	90	617	0.00008
SRR6145060	Curtobacterium sp. SGAir0471	2070337	S	306	90	396	0.00005
SRR6145060	Curtobacterium sp. MR_MD2014	1561023	S	309	90	399	0.00005
SRR6145060	Chelatococcus daeguensis	444444	S	66	24	90	0.00001
SRR6145060	Butyricimonas faecalis	2093856	S	43	47	90	0.00001
SRR6145060	Bifidobacterium longum	216816	S	62	28	90	0.00001
SRR6145060	Streptomyces lavendulae	1914	S	78	11	89	0.00001
SRR6145060	Staphylococcus virus CNPH82	398839	S	7	89	96	0.00001
SRR6145060	Shewanella algae	38313	S	79	10	89	0.00001
SRR6145060	Rhodococcus sp. YL-1	1045808	S	13	89	102	0.00001
SRR6145060	Pseudomonas balearica	74829	S	70	19	89	0.00001
SRR6145060	Pectobacterium carotovorum	554	S	64	25	89	0.00001
SRR6145060	Haemophilus pittmaniae	249188	S	87	2	89	0.00001
SRR6145060	Corynebacterium lactis	1231000	S	88	1	89	0.00001
SRR6145060	Corynebacterium atypicum	191610	S	85	4	89	0.00001
SRR6145060	Burkholderia lata	482957	S	59	30	89	0.00001
SRR6145060	Agrobacterium sp. MA01	2664893	S	46	89	135	0.00002
SRR6145060	Treponema sp. OMZ 804	120683	S	88	5	93	0.00001
SRR6145060	Streptomyces luteoverticillatus	66425	S	82	6	88	0.00001
SRR6145060	Micromonospora rifamycinica	291594	S	74	14	88	0.00001
SRR6145060	Luteibacter pinisoli	2589080	S	83	5	88	0.00001
SRR6145060	Burkholderia ubonensis	101571	S	54	34	88	0.00001
SRR6145060	Brevirhabdus pacifica	1267768	S	65	23	88	0.00001
SRR6145060	Bosea sp. ANAM02	2020412	S	357	88	445	0.00006
SRR6145060	Arenimonas daejeonensis	370777	S	84	4	88	0.00001
SRR6145060	Aeromonas media	651	S	54	34	88	0.00001
SRR6145060	Sulfitobacter pseudonitzschiae	1402135	S	73	14	87	0.00001
SRR6145060	Streptomyces sp. VN1	1821625	S	17	87	104	0.00001
SRR6145060	Streptomyces ficellus	1977088	S	79	8	87	0.00001
SRR6145060	Sphingobium sp. YBL2	484429	S	38	87	125	0.00002
SRR6145060	Shewanella putrefaciens	24	S	40	47	87	0.00001
SRR6145060	Roseovarius indicus	540747	S	66	21	87	0.00001
SRR6145060	Rhodococcus sp. PBTS 2	1653479	S	87	57	144	0.00002
SRR6145060	Pseudomonas sp. AK6U	1978467	S	2	87	89	0.00001
SRR6145060	Pseudomonas alcaliphila	101564	S	62	25	87	0.00001
SRR6145060	Propionibacterium virus PHL037M02	1982275	S	1	87	88	0.00001
SRR6145060	Pectobacterium brasiliense	180957	S	47	40	87	0.00001
SRR6145060	Mycolicibacter terrae	1788	S	75	12	87	0.00001
SRR6145060	Lysinimonas sp. KACC 19322	2592654	S	87	8	95	0.00001
SRR6145060	Elizabethkingia bruuniana	1756149	S	33	54	87	0.00001
SRR6145060	Amycolatopsis japonica	208439	S	46	41	87	0.00001
SRR6145060	Streptomyces xinghaiensis	1038928	S	81	5	86	0.00001
SRR6145060	Stigmatella aurantiaca	41	S	84	2	86	0.00001
SRR6145060	Stenotrophomonas sp. Pemsol	2040586	S	35	86	121	0.00002
SRR6145060	Riemerella anatipestifer	34085	S	75	11	86	0.00001
SRR6145060	Pseudomonas fulva	47880	S	68	18	86	0.00001
SRR6145060	Micromonospora chokoriensis	356851	S	76	10	86	0.00001
SRR6145060	Leucobacter sp. DSM 101948	1935379	S	86	7	93	0.00001
SRR6145060	Corynebacterium aquilae	203263	S	85	1	86	0.00001
SRR6145060	Chondromyces crocatus	52	S	85	1	86	0.00001
SRR6145060	Arthrobacter crystallopoietes	37928	S	85	1	86	0.00001
SRR6145060	Thermobispora bispora	2006	S	84	1	85	0.00001
SRR6145060	Selenomonas sputigena	69823	S	85	0	85	0.00001
SRR6145060	Nocardioides sp. zg-579	2663857	S	328	85	413	0.00005
SRR6145060	Micromonospora coriariae	285665	S	74	11	85	0.00001
SRR6145060	Microbacterium sp. TPU 3598	1938334	S	85	7	92	0.00001
SRR6145060	Herbaspirillum robiniae	2014887	S	74	11	85	0.00001
SRR6145060	Devosia ginsengisoli	400770	S	80	5	85	0.00001
SRR6145060	Clostridium tetani	1513	S	82	3	85	0.00001
SRR6145060	Bradyrhizobium guangxiense	1325115	S	60	25	85	0.00001
SRR6145060	Xanthomonas hyacinthi	56455	S	70	14	84	0.00001
SRR6145060	Streptomyces rubrolavendulae	285473	S	11	73	84	0.00001
SRR6145060	Streptomyces cacaoi	1898	S	75	9	84	0.00001
SRR6145060	Streptomyces alboflavus	67267	S	76	8	84	0.00001
SRR6145060	Niveispirillum cyanobacteriorum	1612173	S	81	3	84	0.00001
SRR6145060	Klebsiella huaxiensis	2153354	S	75	9	84	0.00001
SRR6145060	Gemmataceae bacterium	2052164	S	81	3	84	0.00001
SRR6145060	Deinococcus maricopensis	309887	S	84	0	84	0.00001
SRR6145060	Deinococcus irradiatisoli	2202254	S	83	1	84	0.00001
SRR6145060	Corynebacterium provencense	1737425	S	82	2	84	0.00001
SRR6145060	Calothrix sp. NIES-2098	1954171	S	19	84	103	0.00001
SRR6145060	Streptomyces cyaneochromogenes	2496836	S	74	9	83	0.00001
SRR6145060	Streptomyces albidoflavus	1886	S	8	75	83	0.00001
SRR6145060	Rhodospirillum centenum	34018	S	77	6	83	0.00001
SRR6145060	Herbaspirillum seropedicae	964	S	71	12	83	0.00001
SRR6145060	Chryseobacterium nakagawai	1241982	S	61	22	83	0.00001
SRR6145060	Actinoalloteichus hoggarensis	1470176	S	80	3	83	0.00001
SRR6145060	Streptomyces scabiei	1930	S	74	8	82	0.00001
SRR6145060	Streptomyces olivaceus	47716	S	13	69	82	0.00001
SRR6145060	Streptomyces malaysiensis	92644	S	18	64	82	0.00001
SRR6145060	Stappia indica	538381	S	79	3	82	0.00001
SRR6145060	Pseudomonas multiresinivorans	95301	S	67	15	82	0.00001
SRR6145060	Prauserella marina	530584	S	80	2	82	0.00001
SRR6145060	Gemmata obscuriglobus	114	S	81	1	82	0.00001
SRR6145060	Burkholderia contaminans	488447	S	55	27	82	0.00001
SRR6145060	Streptomyces nodosus	40318	S	76	5	81	0.00001
SRR6145060	Streptomyces fodineus	1904616	S	70	11	81	0.00001
SRR6145060	Sphingobium indicum	332055	S	37	44	81	0.00001
SRR6145060	Pantoea ananatis	553	S	76	5	81	0.00001
SRR6145060	Myroides phaeus	702745	S	78	3	81	0.00001
SRR6145060	Micromonospora zamorensis	709883	S	72	9	81	0.00001
SRR6145060	Hypericibacter adhaerens	2602016	S	77	4	81	0.00001
SRR6145060	Bradyrhizobium ottawaense	931866	S	8	73	81	0.00001
SRR6145060	[Mycobacterium] stephanolepidis	1520670	S	65	15	80	0.00001
SRR6145060	Tabrizicola piscis	2494374	S	78	2	80	0.00001
SRR6145060	Streptomyces subrutilus	36818	S	70	10	80	0.00001
SRR6145060	Streptomyces seoulensis	73044	S	71	9	80	0.00001
SRR6145060	Streptomyces olivoreticuli	68246	S	75	5	80	0.00001
SRR6145060	Streptomyces clavuligerus	1901	S	77	3	80	0.00001
SRR6145060	Sphingobium herbicidovorans	76947	S	60	20	80	0.00001
SRR6145060	Macrococcus canis	1855823	S	78	2	80	0.00001
SRR6145060	Deinococcus deserti	310783	S	79	1	80	0.00001
SRR6145060	Corynebacterium epidermidicanis	1050174	S	79	1	80	0.00001
SRR6145060	Collinsella aerofaciens	74426	S	73	7	80	0.00001
SRR6145060	Brevibacterium siliguriense	1136497	S	67	13	80	0.00001
SRR6145060	Actinomyces gaoshouyii	1960083	S	77	3	80	0.00001
SRR6145060	Verminephrobacter eiseniae	364317	S	77	2	79	0.00001
SRR6145060	Tetragenococcus halophilus	51669	S	75	4	79	0.00001
SRR6145060	Streptomyces xiamenensis	408015	S	77	2	79	0.00001
SRR6145060	Streptomyces gilvosporeus	553510	S	72	7	79	0.00001
SRR6145060	Rubrobacter sp. SCSIO 52915	2653852	S	79	1	80	0.00001
SRR6145060	Rhodanobacter glycinis	582702	S	72	7	79	0.00001
SRR6145060	Pseudescherichia vulneris	566	S	79	0	79	0.00001
SRR6145060	Propionibacterium virus PHL071N05	1982280	S	68	79	147	0.00002
SRR6145060	Mycobacterium xenopi	1789	S	77	2	79	0.00001
SRR6145060	Fastidiosipila sanguinis	236753	S	74	5	79	0.00001
SRR6145060	Streptomyces leeuwenhoekii	1437453	S	48	30	78	0.00001
SRR6145060	Rubrobacter sp. SCSIO 52909	2653851	S	78	0	78	0.00001
SRR6145060	Rathayibacter sp. VKM Ac-2760	2609253	S	78	30	108	0.00001
SRR6145060	Nocardioides baekrokdamisoli	1804624	S	76	2	78	0.00001
SRR6145060	Nitrospirillum amazonense	28077	S	76	2	78	0.00001
SRR6145060	Mycolicibacter minnesotensis	1118379	S	74	4	78	0.00001
SRR6145060	Leuconostoc lactis	1246	S	58	20	78	0.00001
SRR6145060	Leuconostoc gelidum	1244	S	77	1	78	0.00001
SRR6145060	Azospirillum humicireducens	1226968	S	54	24	78	0.00001
SRR6145060	Thauera sp. MZ1T	85643	S	236	77	313	0.00004
SRR6145060	Streptomyces qaidamensis	1783515	S	66	11	77	0.00001
SRR6145060	Streptomyces coeruleorubidus	116188	S	62	15	77	0.00001
SRR6145060	Sphingosinicella microcystinivorans	335406	S	76	1	77	0.00001
SRR6145060	Schaalia meyeri	52773	S	75	2	77	0.00001
SRR6145060	Mycobacterium lacus	169765	S	77	0	77	0.00001
SRR6145060	Microlunatus sp. Gsoil 973	2672569	S	77	1	78	0.00001
SRR6145060	Lactobacillus delbrueckii	1584	S	73	4	77	0.00001
SRR6145060	Enterobacter bugandensis	881260	S	64	13	77	0.00001
SRR6145060	Corynebacterium terpenotabidum	89154	S	74	3	77	0.00001
SRR6145060	Bradyrhizobium sp. CCBAU 051011	858422	S	77	8	85	0.00001
SRR6145060	Bradyrhizobium icense	1274631	S	72	5	77	0.00001
SRR6145060	Blastochloris tepida	2233851	S	69	8	77	0.00001
SRR6145060	Acinetobacter lactucae	1785128	S	65	12	77	0.00001
SRR6145060	Streptomyces nitrosporeus	28894	S	70	6	76	0.00001
SRR6145060	Streptomyces nigra	1827580	S	66	10	76	0.00001
SRR6145060	Rhodococcus sp. S2-17	1990687	S	83	76	159	0.00002
SRR6145060	Rhodococcus biphenylivorans	1500843	S	9	67	76	0.00001
SRR6145060	Novosphingobium ginsenosidimutans	1176536	S	75	1	76	0.00001
SRR6145060	Mycobacterium marseillense	701042	S	71	5	76	0.00001
SRR6145060	Corynebacterium argentoratense	42817	S	75	1	76	0.00001
SRR6145060	Actinosynnema mirum	40567	S	8	68	76	0.00001
SRR6145060	Actinoalloteichus fjordicus	1612552	S	6	70	76	0.00001
SRR6145060	Streptomyces sampsonii	42239	S	8	67	75	0.00001
SRR6145060	Simonsiella muelleri	72	S	73	2	75	0.00001
SRR6145060	Phaeobacter gallaeciensis	60890	S	52	23	75	0.00001
SRR6145060	Myxococcus hansupus	1297742	S	66	9	75	0.00001
SRR6145060	Kitasatospora albolonga	68173	S	59	16	75	0.00001
SRR6145060	Bradyrhizobium sp. ORS 285	115808	S	75	9	84	0.00001
SRR6145060	Bacteroides ovatus	28116	S	46	29	75	0.00001
SRR6145060	Arthrobacter dokdonellae	2211210	S	74	1	75	0.00001
SRR6145060	Aminobacter aminovorans	83263	S	62	13	75	0.00001
SRR6145060	Acetobacteraceae bacterium	1909293	S	75	0	75	0.00001
SRR6145060	Variovorax sp. PAMC 28711	1795631	S	74	4	78	0.00001
SRR6145060	Streptomyces parvulus	146923	S	61	13	74	0.00001
SRR6145060	Streptomyces exfoliatus	1905	S	65	9	74	0.00001
SRR6145060	Sphingobium chlorophenolicum	46429	S	60	14	74	0.00001
SRR6145060	Sphingobacterium mizutaii	1010	S	73	1	74	0.00001
SRR6145060	Nordella sp. HKS 07	2712222	S	74	1	75	0.00001
SRR6145060	Mycobacteroides immunogenum	83262	S	66	8	74	0.00001
SRR6145060	Mycobacterium mantenii	560555	S	73	1	74	0.00001
SRR6145060	Cupriavidus campinensis	151783	S	61	13	74	0.00001
SRR6145060	Ancylobacter pratisalsi	1745854	S	67	7	74	0.00001
SRR6145060	Acinetobacter baylyi	202950	S	73	1	74	0.00001
SRR6145060	Streptomyces galilaeus	33899	S	65	8	73	0.00001
SRR6145060	Streptomyces antibioticus	1890	S	64	9	73	0.00001
SRR6145060	Streptococcus sobrinus	1310	S	72	1	73	0.00001
SRR6145060	Streptococcus phage phiARI0468-2	1701828	S	1	73	74	0.00001
SRR6145060	Rhodococcus sp. WAY2	2663121	S	84	73	157	0.00002
SRR6145060	Pseudomonas denitrificans (nomen rejiciendum)	43306	S	73	4	77	0.00001
SRR6145060	Mucilaginibacter rubeus	2027860	S	25	48	73	0.00001
SRR6145060	Komagataeibacter xylinus	28448	S	49	24	73	0.00001
SRR6145060	Hoyosella subflava	639313	S	73	0	73	0.00001
SRR6145060	Halovulum dunhuangense	1505036	S	70	3	73	0.00001
SRR6145060	Flavobacterium johnsoniae	986	S	66	7	73	0.00001
SRR6145060	Flavobacterium anhuiense	459526	S	62	11	73	0.00001
SRR6145060	Cupriavidus basilensis	68895	S	68	5	73	0.00001
SRR6145060	Bradymonas sediminis	1548548	S	23	50	73	0.00001
SRR6145060	Bacteroides zoogleoformans	28119	S	52	21	73	0.00001
SRR6145060	Atlantibacter hermannii	565	S	71	2	73	0.00001
SRR6145060	Tistrella mobilis	171437	S	65	7	72	0.00001
SRR6145060	Streptomyces sp. WAC 01438	2203204	S	72	9	81	0.00001
SRR6145060	Streptomyces roseochromogenus	285450	S	63	9	72	0.00001
SRR6145060	Streptomyces davaonensis	348043	S	65	7	72	0.00001
SRR6145060	Porphyrobacter sp. YT40	2547601	S	135	72	207	0.00003
SRR6145060	Bermanella marisrubri	207949	S	72	0	72	0.00001
SRR6145060	Bacteroides thetaiotaomicron	818	S	58	14	72	0.00001
SRR6145060	Arthrospira platensis	118562	S	27	45	72	0.00001
SRR6145060	Alteromonas macleodii	28108	S	68	4	72	0.00001
SRR6145060	Agromyces sp. KACC 19306	2592652	S	72	9	81	0.00001
SRR6145060	Xanthomonas oryzae	347	S	64	7	71	0.00001
SRR6145060	Xanthomonas arboricola	56448	S	49	22	71	0.00001
SRR6145060	Streptomyces vinaceus	1960	S	62	9	71	0.00001
SRR6145060	Streptomyces sp. WAC00288	2094021	S	10	71	81	0.00001
SRR6145060	Rhizobium etli	29449	S	58	13	71	0.00001
SRR6145060	Mycobacterium noviomagense	459858	S	71	0	71	0.00001
SRR6145060	Microbacterium sp. 1S1	2606451	S	232	71	303	0.00004
SRR6145060	Methylosinus trichosporium	426	S	64	7	71	0.00001
SRR6145060	Hymenobacter sp. PAMC 26628	1484118	S	71	18	89	0.00001
SRR6145060	Curtobacterium sp. BH-2-1-1	1905847	S	313	71	384	0.00005
SRR6145060	Chryseobacterium sp.	1871047	S	67	4	71	0.00001
SRR6145060	Caulobacter henricii	69395	S	65	6	71	0.00001
SRR6145060	Burkholderia plantarii	41899	S	65	6	71	0.00001
SRR6145060	Bradyrhizobium symbiodeficiens	1404367	S	57	14	71	0.00001
SRR6145060	Bradyrhizobium oligotrophicum	44255	S	66	5	71	0.00001
SRR6145060	Staphylococcus virus PH15	399185	S	14	70	84	0.00001
SRR6145060	Rhodoferax sediminis	2509614	S	66	4	70	0.00001
SRR6145060	Ralstonia mannitolilytica	105219	S	47	23	70	0.00001
SRR6145060	Propionibacterium virus PHL009M11	1982273	S	62	70	132	0.00002
SRR6145060	Panacibacter ginsenosidivorans	1813871	S	70	0	70	0.00001
SRR6145060	Mycobacterium shinjukuense	398694	S	69	1	70	0.00001
SRR6145060	Micromonospora tulbaghiae	479978	S	40	30	70	0.00001
SRR6145060	Egicoccus halophilus	1670830	S	70	0	70	0.00001
SRR6145060	Cronobacter sakazakii	28141	S	49	21	70	0.00001
SRR6145060	Corynebacterium deserti	1408191	S	65	5	70	0.00001
SRR6145060	Azotobacter chroococcum	353	S	53	17	70	0.00001
SRR6145060	Aeromonas sp. ASNIH2	1636607	S	18	70	88	0.00001
SRR6145060	Actinobacteria bacterium YIM 96077	2487353	S	70	0	70	0.00001
SRR6145060	Actinoalloteichus hymeniacidonis	340345	S	69	1	70	0.00001
SRR6145060	Streptomyces viridosporus	67581	S	58	11	69	0.00001
SRR6145060	Streptomyces koyangensis	188770	S	40	29	69	0.00001
SRR6145060	Odoribacter splanchnicus	28118	S	56	13	69	0.00001
SRR6145060	Blastochloris viridis	1079	S	64	5	69	0.00001
SRR6145060	Alcanivorax pacificus	1306787	S	67	2	69	0.00001
SRR6145060	Aggregatibacter actinomycetemcomitans	714	S	65	4	69	0.00001
SRR6145060	Streptomyces violaceusniger	68280	S	43	25	68	0.00001
SRR6145060	Staphylococcus pseudintermedius	283734	S	58	10	68	0.00001
SRR6145060	Ruegeria pomeroyi	89184	S	66	2	68	0.00001
SRR6145060	Pseudomonas parafulva	157782	S	61	7	68	0.00001
SRR6145060	Nocardiopsis gilva	280236	S	66	2	68	0.00001
SRR6145060	Hymenobacter swuensis	1446467	S	56	12	68	0.00001
SRR6145060	Dyella japonica	231455	S	63	5	68	0.00001
SRR6145060	Collimonas fungivorans	158899	S	60	8	68	0.00001
SRR6145060	Blastomonas fulva	1550728	S	34	34	68	0.00001
SRR6145060	Atopobium parvulum	1382	S	68	0	68	0.00001
SRR6145060	Streptomyces kanamyceticus	1967	S	55	12	67	0.00001
SRR6145060	Streptococcus phage phiARI0004	1701811	S	1	67	68	0.00001
SRR6145060	Rathayibacter sp. VKM Ac-2804	2609257	S	67	48	115	0.00002
SRR6145060	Nocardioides sp. R-3366	2712223	S	524	67	591	0.00008
SRR6145060	Microbacterium paludicola	300019	S	18	49	67	0.00001
SRR6145060	Klebsiella grimontii	2058152	S	5	62	67	0.00001
SRR6145060	Indioceanicola profundi	2220096	S	64	3	67	0.00001
SRR6145060	Dechlorosoma suillum	146939	S	35	32	67	0.00001
SRR6145060	Chryseobacterium antarcticum	266748	S	67	0	67	0.00001
SRR6145060	Brevibacterium sp. YB235	1496080	S	101	67	168	0.00002
SRR6145060	Bradyrhizobium sp. ORS 278	114615	S	67	8	75	0.00001
SRR6145060	Bradyrhizobium paxllaeri	190148	S	60	7	67	0.00001
SRR6145060	Bordetella hinzii	103855	S	59	8	67	0.00001
SRR6145060	Altererythrobacter mangrovi	1982042	S	63	4	67	0.00001
SRR6145060	Agrobacterium sp. RAC06	1842536	S	34	67	101	0.00001
SRR6145060	Acidovorax sp. KKS102	358220	S	221	67	288	0.00004
SRR6145060	Youhaiella tibetensis	1447062	S	63	3	66	0.00001
SRR6145060	Streptomyces atratus	1893	S	63	3	66	0.00001
SRR6145060	Sphingomonas sp. CL5.1	2653203	S	576	66	642	0.00008
SRR6145060	Pseudomonas psychrophila	122355	S	64	2	66	0.00001
SRR6145060	Pseudolabrys taiwanensis	331696	S	62	4	66	0.00001
SRR6145060	Marisediminicola antarctica	674079	S	65	1	66	0.00001
SRR6145060	Frankia casuarinae	106370	S	64	2	66	0.00001
SRR6145060	Cellulosimicrobium sp. 72-3	2731680	S	30	66	96	0.00001
SRR6145060	Burkholderia glumae	337	S	58	8	66	0.00001
SRR6145060	Bradyrhizobium sp. TM102	2599819	S	7	66	73	0.00001
SRR6145060	Bradyrhizobium sp. SK17	2057741	S	342	66	408	0.00005
SRR6145060	Streptomyces violaceoruber	1935	S	54	11	65	0.00001
SRR6145060	Streptomyces anulatus	1892	S	49	16	65	0.00001
SRR6145060	Rathayibacter tanaceti	1671680	S	58	7	65	0.00001
SRR6145060	Rahnella aquatilis	34038	S	24	41	65	0.00001
SRR6145060	Pseudarthrobacter chlorophenolicus	85085	S	57	8	65	0.00001
SRR6145060	Paraoerskovia marina	545619	S	63	2	65	0.00001
SRR6145060	Paenarthrobacter aurescens	43663	S	15	50	65	0.00001
SRR6145060	Nocardioides sp. S-1144	2582905	S	392	65	457	0.00006
SRR6145060	Cryobacterium arcticum	670052	S	47	18	65	0.00001
SRR6145060	Chryseobacterium joostei	112234	S	58	7	65	0.00001
SRR6145060	Streptomyces tendae	1932	S	56	8	64	0.00001
SRR6145060	Streptomyces sp. RLB1-9	2594454	S	3	64	67	0.00001
SRR6145060	Streptomyces autolyticus	75293	S	14	50	64	0.00001
SRR6145060	Pseudomonas savastanoi	29438	S	1	63	64	0.00001
SRR6145060	Prevotella ruminicola	839	S	64	0	64	0.00001
SRR6145060	Nocardia sp. CFHS0054	2382165	S	220	64	284	0.00004
SRR6145060	Lactococcus piscium	1364	S	62	2	64	0.00001
SRR6145060	Lactobacillus casei	1582	S	15	49	64	0.00001
SRR6145060	Gluconacetobacter diazotrophicus	33996	S	63	1	64	0.00001
SRR6145060	Ensifer sojae	716925	S	46	18	64	0.00001
SRR6145060	Cupriavidus malaysiensis	367825	S	7	57	64	0.00001
SRR6145060	Streptomyces sp. DSM 40868	2721173	S	63	8	71	0.00001
SRR6145060	Streptomyces fradiae	1906	S	9	54	63	0.00001
SRR6145060	Saccharomonospora glauca	40990	S	50	13	63	0.00001
SRR6145060	Rubrobacter xylanophilus	49319	S	63	0	63	0.00001
SRR6145060	Ralstonia insidiosa	190721	S	53	10	63	0.00001
SRR6145060	Pseudonocardia sp. AL041005-10	445576	S	418	63	481	0.00006
SRR6145060	Parvibaculum lavamentivorans	256618	S	52	11	63	0.00001
SRR6145060	Marinobacter hydrocarbonoclasticus	2743	S	58	5	63	0.00001
SRR6145060	Magnetospirillum gryphiswaldense	55518	S	62	1	63	0.00001
SRR6145060	Leptotrichia goodfellowii	157692	S	63	0	63	0.00001
SRR6145060	Herbaspirillum rubrisubalbicans	80842	S	54	9	63	0.00001
SRR6145060	Corynebacterium geronticis	2079234	S	61	2	63	0.00001
SRR6145060	Bosea sp. Tri-49	1867715	S	533	63	596	0.00008
SRR6145060	Streptomyces lincolnensis	1915	S	56	6	62	0.00001
SRR6145060	Streptomyces katrae	68223	S	54	8	62	0.00001
SRR6145060	Streptomyces cyaneogriseus	68192	S	37	25	62	0.00001
SRR6145060	Sphingobium sp. TKS	1315974	S	103	62	165	0.00002
SRR6145060	Rhodococcus sp. WB1	1033922	S	7	62	69	0.00001
SRR6145060	Rhodococcus imtechensis	262776	S	29	33	62	0.00001
SRR6145060	Pseudomonas sp. THAF7b	2587845	S	73	62	135	0.00002
SRR6145060	Pseudomonas oryzae	1392877	S	60	2	62	0.00001
SRR6145060	Pseudomonas knackmussii	65741	S	54	8	62	0.00001
SRR6145060	Plantibacter flavus	150123	S	36	26	62	0.00001
SRR6145060	Phycisphaera mikurensis	547188	S	62	0	62	0.00001
SRR6145060	Nocardioides sp. dk884	2662361	S	256	62	318	0.00004
SRR6145060	Nocardia sp. CS682	1047172	S	250	62	312	0.00004
SRR6145060	Natronococcus occultus	29288	S	60	2	62	0.00001
SRR6145060	Luteibacter rhizovicinus	242606	S	59	3	62	0.00001
SRR6145060	Limnoglobus roseus	2598579	S	62	0	62	0.00001
SRR6145060	Bradyrhizobium sp. LCT2	2493093	S	16	62	78	0.00001
SRR6145060	Variovorax sp. SRS16	282217	S	35	61	96	0.00001
SRR6145060	Streptomyces qinzhouensis	2599401	S	56	5	61	0.00001
SRR6145060	Streptomyces pactum	68249	S	51	10	61	0.00001
SRR6145060	Streptomyces noursei	1971	S	39	22	61	0.00001
SRR6145060	Staphylococcus vitulinus	71237	S	60	1	61	0.00001
SRR6145060	Sphingobium japonicum	332056	S	31	30	61	0.00001
SRR6145060	Simplicispira suum	2109915	S	56	5	61	0.00001
SRR6145060	Propionibacterium australiense	119981	S	58	3	61	0.00001
SRR6145060	Polaromonas naphthalenivorans	216465	S	58	3	61	0.00001
SRR6145060	Plantactinospora sp. BC1	2108470	S	32	61	93	0.00001
SRR6145060	Mycobacterium haemophilum	29311	S	61	0	61	0.00001
SRR6145060	Leisingera aquaemixtae	1396826	S	57	4	61	0.00001
SRR6145060	Hydrogenophaga pseudoflava	47421	S	37	24	61	0.00001
SRR6145060	Halomonas socia	1081866	S	61	0	61	0.00001
SRR6145060	Glutamicibacter mishrai	1775880	S	57	4	61	0.00001
SRR6145060	Cellulosimicrobium sp. TH-20	1980001	S	26	61	87	0.00001
SRR6145060	Bordetella bronchialis	463025	S	59	2	61	0.00001
SRR6145060	Azospirillum oryzae	286727	S	35	26	61	0.00001
SRR6145060	Aeromonas salmonicida	645	S	45	16	61	0.00001
SRR6145060	Zhihengliuella sp. ISTPL4	2058657	S	123	60	183	0.00002
SRR6145060	Streptomyces spongiicola	1690221	S	53	7	60	0.00001
SRR6145060	Streptomyces pluripotens	1355015	S	57	3	60	0.00001
SRR6145060	Streptomyces lunaelactis	1535768	S	57	3	60	0.00001
SRR6145060	Streptomyces glaucescens	1907	S	51	9	60	0.00001
SRR6145060	Staphylococcus condimenti	70255	S	57	3	60	0.00001
SRR6145060	Roseitalea porphyridii	1852022	S	57	3	60	0.00001
SRR6145060	Pseudomonas sp. VLB120	69328	S	8	60	68	0.00001
SRR6145060	Phaeobacter inhibens	221822	S	44	16	60	0.00001
SRR6145060	Nocardioides sp. 603	2483798	S	261	60	321	0.00004
SRR6145060	Mycobacterium seoulense	386911	S	57	3	60	0.00001
SRR6145060	Mycobacterium paraseoulense	590652	S	58	2	60	0.00001
SRR6145060	Leuconostoc carnosum	1252	S	54	6	60	0.00001
SRR6145060	Dyadobacter fermentans	94254	S	59	1	60	0.00001
SRR6145060	Burkholderia stabilis	95485	S	39	21	60	0.00001
SRR6145060	Actinoplanes sp. N902-109	649831	S	167	60	227	0.00003
SRR6145060	Actinomyces qiguomingii	2057800	S	59	1	60	0.00001
SRR6145060	Streptococcus sp. HSISS2	1316411	S	43	59	102	0.00001
SRR6145060	Porphyrobacter sp. LM 6	1896196	S	59	10	69	0.00001
SRR6145060	Mycobacteroides salmoniphilum	404941	S	57	2	59	0.00001
SRR6145060	Mogibacterium pumilum	86332	S	57	2	59	0.00001
SRR6145060	Egibacter rhizosphaerae	1670831	S	59	0	59	0.00001
SRR6145060	Corynebacterium pelargi	1471400	S	55	4	59	0.00001
SRR6145060	Chromobacterium vaccinii	1108595	S	50	9	59	0.00001
SRR6145060	Austwickia chelonae	100225	S	59	0	59	0.00001
SRR6145060	Acinetobacter sp. WCHA55	2004646	S	244	59	303	0.00004
SRR6145060	Vibrio alginolyticus	663	S	23	35	58	0.00001
SRR6145060	Streptomyces sp. SM17	565560	S	5	58	63	0.00001
SRR6145060	Streptomyces pristinaespiralis	38300	S	42	16	58	0.00001
SRR6145060	Pseudomonas synxantha	47883	S	44	14	58	0.00001
SRR6145060	Pseudomonas mosselii	78327	S	29	29	58	0.00001
SRR6145060	Paraburkholderia xenovorans	36873	S	44	14	58	0.00001
SRR6145060	Paraburkholderia terricola	169427	S	54	4	58	0.00001
SRR6145060	Hartmannibacter diazotrophicus	1482074	S	55	3	58	0.00001
SRR6145060	Glutamicibacter arilaitensis	256701	S	53	5	58	0.00001
SRR6145060	Enterobacter soli	885040	S	56	2	58	0.00001
SRR6145060	Deinococcus puniceus	1182568	S	58	0	58	0.00001
SRR6145060	Bradyrhizobium zhanjiangense	1325107	S	52	6	58	0.00001
SRR6145060	Bdellovibrio bacteriovorus	959	S	54	4	58	0.00001
SRR6145060	Treponema sp. OMZ 838	1539298	S	57	3	60	0.00001
SRR6145060	Streptomyces hundungensis	1077946	S	54	3	57	0.00001
SRR6145060	Streptomyces antimycoticus	68175	S	39	18	57	0.00001
SRR6145060	Staphylococcus schweitzeri	1654388	S	48	9	57	0.00001
SRR6145060	Sphingomonas sp. IC081	304378	S	203	57	260	0.00003
SRR6145060	Neomicrococcus aestuarii	556325	S	55	2	57	0.00001
SRR6145060	Methylocella silvestris	199596	S	56	1	57	0.00001
SRR6145060	Georhizobium profundi	2341112	S	52	5	57	0.00001
SRR6145060	Bifidobacterium adolescentis	1680	S	53	4	57	0.00001
SRR6145060	Altererythrobacter marensis	543877	S	54	3	57	0.00001
SRR6145060	Actinomyces pacaensis	1852377	S	57	0	57	0.00001
SRR6145060	Variovorax sp. PBL-E5	434014	S	28	56	84	0.00001
SRR6145060	Thauera chlorobenzoica	96773	S	41	15	56	0.00001
SRR6145060	Streptomyces platensis	58346	S	35	21	56	0.00001
SRR6145060	Streptomyces coelicolor	1902	S	6	50	56	0.00001
SRR6145060	Staphylococcus simiae	308354	S	55	1	56	0.00001
SRR6145060	Shewanella baltica	62322	S	35	21	56	0.00001
SRR6145060	Salinispora arenicola	168697	S	50	6	56	0.00001
SRR6145060	Roseibacterium elongatum	159346	S	55	1	56	0.00001
SRR6145060	Rathayibacter tritici	33888	S	46	10	56	0.00001
SRR6145060	Phaeobacter piscinae	1580596	S	32	24	56	0.00001
SRR6145060	Paraburkholderia phytofirmans	261302	S	45	11	56	0.00001
SRR6145060	Luteitalea pratensis	1855912	S	56	0	56	0.00001
SRR6145060	Ilumatobacter coccineus	467094	S	56	0	56	0.00001
SRR6145060	Exiguobacterium acetylicum	41170	S	36	20	56	0.00001
SRR6145060	Corynebacterium pseudopelargi	2080757	S	52	4	56	0.00001
SRR6145060	Capnocytophaga sp. FDAARGOS_737	2545799	S	216	56	272	0.00004
SRR6145060	Bergeyella cardium	1585976	S	56	0	56	0.00001
SRR6145060	Bacteroides uniformis	820	S	30	26	56	0.00001
SRR6145060	Altererythrobacter atlanticus	1267766	S	36	20	56	0.00001
SRR6145060	Achromobacter insolitus	217204	S	51	5	56	0.00001
SRR6145060	Streptomyces prasinus	67345	S	50	5	55	0.00001
SRR6145060	Streptomyces peucetius	1950	S	51	4	55	0.00001
SRR6145060	Sphingobium sp. CAP-1	2676077	S	121	55	176	0.00002
SRR6145060	Sagittula sp. P11	2009329	S	106	55	161	0.00002
SRR6145060	Saccharomonospora viridis	1852	S	52	3	55	0.00001
SRR6145060	Pseudomonas protegens	380021	S	52	3	55	0.00001
SRR6145060	Providencia rettgeri	587	S	25	30	55	0.00001
SRR6145060	Martelella mediterranea	293089	S	46	9	55	0.00001
SRR6145060	Halomonas sp. A3H3	1346287	S	13	55	68	0.00001
SRR6145060	Bradyrhizobium sp. ORS 3257	167468	S	55	7	62	0.00001
SRR6145060	Bradyrhizobium betae	244734	S	39	16	55	0.00001
SRR6145060	Azoarcus communis	41977	S	50	5	55	0.00001
SRR6145060	Alteromonas mediterranea	314275	S	19	36	55	0.00001
SRR6145060	Acetobacter pasteurianus	438	S	30	25	55	0.00001
SRR6145060	Xanthomonas albilineans	29447	S	53	1	54	0.00001
SRR6145060	Streptomyces sp. GF20	2692235	S	9	54	63	0.00001
SRR6145060	Bifidobacterium bifidum	1681	S	51	3	54	0.00001
SRR6145060	Actinomyces israelii	1659	S	53	1	54	0.00001
SRR6145060	Acinetobacter chinensis	2004650	S	44	10	54	0.00001
SRR6145060	Acidovorax sp. T1	1858609	S	51	54	105	0.00001
SRR6145060	Streptococcus sp. HSISS3	1316412	S	41	53	94	0.00001
SRR6145060	Rhizobium daejeonense	240521	S	50	3	53	0.00001
SRR6145060	Pseudarthrobacter sulfonivorans	121292	S	36	17	53	0.00001
SRR6145060	Lactobacillus helveticus	1587	S	33	20	53	0.00001
SRR6145060	Klebsiella sp. PO552	1972757	S	11	53	64	0.00001
SRR6145060	Kingella kingae	504	S	52	1	53	0.00001
SRR6145060	Flavobacterium nitrogenifigens	1617283	S	44	9	53	0.00001
SRR6145060	Flavobacterium haoranii	683124	S	49	4	53	0.00001
SRR6145060	Erythrobacter aureus	2182384	S	49	4	53	0.00001
SRR6145060	Cytophaga hutchinsonii	985	S	53	0	53	0.00001
SRR6145060	Bordetella petrii	94624	S	36	17	53	0.00001
SRR6145060	Bifidobacterium breve	1685	S	38	15	53	0.00001
SRR6145060	Bacteriovorax stolpii	960	S	53	0	53	0.00001
SRR6145060	Bacillus oceanisediminis	665099	S	53	0	53	0.00001
SRR6145060	Acinetobacter larvae	1789224	S	53	0	53	0.00001
SRR6145060	Acinetobacter equi	1324350	S	53	0	53	0.00001
SRR6145060	Veillonella rodentium	248315	S	51	1	52	0.00001
SRR6145060	Streptomyces tirandamycinicus	2174846	S	46	6	52	0.00001
SRR6145060	Streptomyces sp. Tu 2975	2676871	S	52	8	60	0.00001
SRR6145060	Streptomyces dengpaensis	2049881	S	48	4	52	0.00001
SRR6145060	Rhodococcus sp. AQ5-07	2054902	S	11	52	63	0.00001
SRR6145060	Rhizobium grahamii	1120045	S	50	2	52	0.00001
SRR6145060	Pseudarthrobacter equi	728066	S	45	7	52	0.00001
SRR6145060	Porphyromonas crevioricanis	393921	S	50	2	52	0.00001
SRR6145060	Polaromonas sp. JS666	296591	S	42	52	94	0.00001
SRR6145060	Mycobacterium canettii	78331	S	36	16	52	0.00001
SRR6145060	Mycobacterium basiliense	2094119	S	52	0	52	0.00001
SRR6145060	Methylobacterium sp. WL1	2603276	S	929	52	981	0.00013
SRR6145060	Mesorhizobium australicum	536018	S	40	12	52	0.00001
SRR6145060	Hymenobacter oligotrophus	2319843	S	50	2	52	0.00001
SRR6145060	Gordonia sp. YC-JH1	2059875	S	151	52	203	0.00003
SRR6145060	Curtobacterium sp. Csp2	2495430	S	320	52	372	0.00005
SRR6145060	Comamonas kerstersii	225992	S	47	5	52	0.00001
SRR6145060	Celeribacter manganoxidans	1411902	S	46	6	52	0.00001
SRR6145060	Acidiphilium multivorum	62140	S	14	38	52	0.00001
SRR6145060	Yoonia vestfoldensis	245188	S	42	9	51	0.00001
SRR6145060	Streptomyces alboniger	132473	S	43	8	51	0.00001
SRR6145060	Staphylococcus virus IPLA5	1197952	S	9	51	60	0.00001
SRR6145060	Shinella sp. HZN7	879274	S	274	51	325	0.00004
SRR6145060	Serinicoccus sp. JLT9	1758689	S	179	51	230	0.00003
SRR6145060	Rhizobium sp. CCGE531	2364271	S	2	51	53	0.00001
SRR6145060	Rhizobium favelukesii	348824	S	48	3	51	0.00001
SRR6145060	Orrella dioscoreae	1851544	S	47	4	51	0.00001
SRR6145060	Novosphingobium tardaugens	169176	S	41	10	51	0.00001
SRR6145060	Gemmata massiliana	1210884	S	40	11	51	0.00001
SRR6145060	Xanthomonas vesicatoria	56460	S	42	8	50	0.00001
SRR6145060	Thauera aromatica	59405	S	34	16	50	0.00001
SRR6145060	Streptomyces sp. 2114.2	1881022	S	5	50	55	0.00001
SRR6145060	Sinorhizobium americanum	194963	S	45	5	50	0.00001
SRR6145060	Novosphingobium sp. ABRDHK2	2571749	S	153	50	203	0.00003
SRR6145060	Murdochiella vaginalis	1852373	S	45	5	50	0.00001
SRR6145060	Mesorhizobium japonicum	2066070	S	31	19	50	0.00001
SRR6145060	Hymenobacter nivis	1850093	S	39	11	50	0.00001
SRR6145060	Glutamicibacter halophytocola	1933880	S	48	2	50	0.00001
SRR6145060	Cupriavidus sp. USMAA2-4	876364	S	7	50	57	0.00001
SRR6145060	Carnobacterium divergens	2748	S	49	1	50	0.00001
SRR6145060	Borrelia hermsii	140	S	47	3	50	0.00001
SRR6145060	Arthrobacter sp. PAMC 25486	1494608	S	50	1	51	0.00001
SRR6145060	Vibrio furnissii	29494	S	45	4	49	0.00001
SRR6145060	Variibacter gotjawalensis	1333996	S	48	1	49	0.00001
SRR6145060	Thermomonas sp. SY21	2202149	S	245	49	294	0.00004
SRR6145060	Pedobacter suwonensis	332999	S	45	4	49	0.00001
SRR6145060	Novosphingobium sp. PP1Y	702113	S	67	49	116	0.00002
SRR6145060	Microcystis aeruginosa	1126	S	15	34	49	0.00001
SRR6145060	Ketogulonicigenium vulgare	92945	S	47	2	49	0.00001
SRR6145060	Janthinobacterium svalbardensis	368607	S	27	22	49	0.00001
SRR6145060	Glutamicibacter nicotianae	37929	S	18	31	49	0.00001
SRR6145060	Flavobacterium sediminis	2201181	S	44	5	49	0.00001
SRR6145060	Flavobacterium indicum	312277	S	49	0	49	0.00001
SRR6145060	Fictibacillus phosphorivorans	1221500	S	48	1	49	0.00001
SRR6145060	Erwinia gerundensis	1619313	S	48	1	49	0.00001
SRR6145060	Enterococcus mundtii	53346	S	48	1	49	0.00001
SRR6145060	Cupriavidus pinatubonensis	248026	S	44	5	49	0.00001
SRR6145060	Citrobacter koseri	545	S	24	25	49	0.00001
SRR6145060	Caulobacter sp. FWC26	69665	S	183	49	232	0.00003
SRR6145060	Auricoccus indicus	1849491	S	48	1	49	0.00001
SRR6145060	Altererythrobacter namhicola	645517	S	47	2	49	0.00001
SRR6145060	Agrobacterium rhizogenes	359	S	44	5	49	0.00001
SRR6145060	Achromobacter pestifer	1353889	S	39	10	49	0.00001
SRR6145060	Streptococcus canis	1329	S	44	4	48	0.00001
SRR6145060	Pseudomonas furukawaii	1149133	S	45	3	48	0.00001
SRR6145060	Ochrobactrum pseudogrignonense	419475	S	31	17	48	0.00001
SRR6145060	Neoasaia chiangmaiensis	320497	S	47	1	48	0.00001
SRR6145060	Methylocystis rosea	173366	S	39	9	48	0.00001
SRR6145060	Methylobacterium sp. 17Sr1-1	2202826	S	370	48	418	0.00006
SRR6145060	Hypericibacter terrae	2602015	S	46	2	48	0.00001
SRR6145060	Frateuria aurantia	81475	S	45	3	48	0.00001
SRR6145060	Crenobacter cavernae	2290923	S	46	2	48	0.00001
SRR6145060	Clostridium pasteurianum	1501	S	48	0	48	0.00001
SRR6145060	Chryseobacterium piperi	558152	S	48	0	48	0.00001
SRR6145060	Bradyrhizobium canariense	255045	S	47	1	48	0.00001
SRR6145060	Brachybacterium sp. SGAir0954	2571029	S	597	48	645	0.00008
SRR6145060	Anoxybacillus flavithermus	33934	S	43	5	48	0.00001
SRR6145060	Anaerostipes hadrus	649756	S	43	5	48	0.00001
SRR6145060	Thermobifida fusca	2021	S	46	1	47	0.00001
SRR6145060	Streptococcus porcinus	1340	S	41	6	47	0.00001
SRR6145060	Pseudomonas sp. LTGT-11-2Z	2479393	S	3	47	50	0.00001
SRR6145060	Pseudomonas brassicacearum	930166	S	22	25	47	0.00001
SRR6145060	Planctomycetes bacterium K2D	2527962	S	3	47	50	0.00001
SRR6145060	Paraburkholderia caribensis	75105	S	42	5	47	0.00001
SRR6145060	Mesorhizobium opportunistum	593909	S	36	11	47	0.00001
SRR6145060	Flavobacterium psychrophilum	96345	S	43	4	47	0.00001
SRR6145060	Ferrovibrio terrae	2594003	S	47	0	47	0.00001
SRR6145060	Erythrobacter gangjinensis	502682	S	46	1	47	0.00001
SRR6145060	Epibacterium mobile	379347	S	37	10	47	0.00001
SRR6145060	Bosea sp. F3-2	2599640	S	237	47	284	0.00004
SRR6145060	Actinotignum schaalii	59505	S	47	0	47	0.00001
SRR6145060	Vibrio parahaemolyticus	670	S	37	9	46	0.00001
SRR6145060	Truepera radiovictrix	332249	S	46	0	46	0.00001
SRR6145060	Streptomyces sp. M56	1495638	S	14	46	60	0.00001
SRR6145060	Streptomyces fulvissimus	68202	S	36	10	46	0.00001
SRR6145060	Streptomyces cavourensis	67258	S	14	32	46	0.00001
SRR6145060	Sinorhizobium medicae	110321	S	44	2	46	0.00001
SRR6145060	Salinispora tropica	168695	S	41	5	46	0.00001
SRR6145060	Planctomycetes bacterium CA11	2527988	S	3	46	49	0.00001
SRR6145060	Phytobacter ursingii	1972431	S	32	14	46	0.00001
SRR6145060	Oryzomicrobium terrae	1735038	S	45	1	46	0.00001
SRR6145060	Neisseria chenwenguii	1853278	S	46	0	46	0.00001
SRR6145060	Meiothermus silvanus	52022	S	46	0	46	0.00001
SRR6145060	Lactococcus raffinolactis	1366	S	43	3	46	0.00001
SRR6145060	Kosakonia cowanii	208223	S	42	4	46	0.00001
SRR6145060	Hylemonella gracilis	80880	S	44	2	46	0.00001
SRR6145060	Helicobacter pylori	210	S	43	3	46	0.00001
SRR6145060	Halomonas chromatireducens	507626	S	46	0	46	0.00001
SRR6145060	Desulfovibrio vulgaris	881	S	46	0	46	0.00001
SRR6145060	Corynebacterium suranareeae	2506452	S	43	3	46	0.00001
SRR6145060	Collimonas pratensis	279113	S	39	7	46	0.00001
SRR6145060	Clostridium butyricum	1492	S	46	0	46	0.00001
SRR6145060	Citrobacter amalonaticus	35703	S	26	20	46	0.00001
SRR6145060	Celeribacter ethanolicus	1758178	S	34	12	46	0.00001
SRR6145060	Burkholderia stagnalis	1503054	S	38	8	46	0.00001
SRR6145060	Bradyrhizobium sp. 58S1	1404864	S	21	46	67	0.00001
SRR6145060	Actinopolyspora erythraea	414996	S	46	0	46	0.00001
SRR6145060	[Eubacterium] sulci	143393	S	44	1	45	0.00001
SRR6145060	Trueperella pyogenes	1661	S	42	3	45	0.00001
SRR6145060	Streptomyces sp. S501	2420135	S	7	45	52	0.00001
SRR6145060	Streptococcus phage phiARI0746	1701837	S	2	45	47	0.00001
SRR6145060	Staphylococcus chromogenes	46126	S	44	1	45	0.00001
SRR6145060	Sphingobium sp. YG1	2082188	S	202	45	247	0.00003
SRR6145060	Shewanella bicestrii	2018305	S	25	20	45	0.00001
SRR6145060	Rhizobium acidisoli	1538158	S	30	15	45	0.00001
SRR6145060	Pseudomonas pelagia	553151	S	45	0	45	0.00001
SRR6145060	Paraburkholderia hospita	169430	S	37	8	45	0.00001
SRR6145060	Moraxella bovoculi	386891	S	36	9	45	0.00001
SRR6145060	Microbacterium amylolyticum	936337	S	44	1	45	0.00001
SRR6145060	Megamonas funiformis	437897	S	44	1	45	0.00001
SRR6145060	Ketogulonicigenium robustum	92947	S	43	2	45	0.00001
SRR6145060	Flavobacterium album	2175091	S	45	0	45	0.00001
SRR6145060	Erythrobacter seohaensis	266951	S	37	8	45	0.00001
SRR6145060	Ensifer alkalisoli	1752398	S	39	6	45	0.00001
SRR6145060	Dickeya dianthicola	204039	S	7	38	45	0.00001
SRR6145060	Calothrix brevissima	938406	S	30	15	45	0.00001
SRR6145060	Burkholderia pyrrocinia	60550	S	30	15	45	0.00001
SRR6145060	Brevibacterium sp. CS2	2575923	S	701	45	746	0.00010
SRR6145060	Brevibacterium sp. 'Marine'	2725563	S	79	45	124	0.00002
SRR6145060	Bradyrhizobium sp. 1S5	1404402	S	21	45	66	0.00001
SRR6145060	Bosea sp. RAC05	1842539	S	240	45	285	0.00004
SRR6145060	Aromatoleum aromaticum	551760	S	44	1	45	0.00001
SRR6145060	Actinobacillus pleuropneumoniae	715	S	23	22	45	0.00001
SRR6145060	[Ruminococcus] gnavus	33038	S	35	9	44	0.00001
SRR6145060	Segniliparus rotundus	286802	S	44	0	44	0.00001
SRR6145060	Rickettsia bellii	33990	S	37	7	44	0.00001
SRR6145060	Rhodococcus sp. DMU1	2722825	S	10	44	54	0.00001
SRR6145060	Rhodococcus sp. BH4	1807790	S	6	44	50	0.00001
SRR6145060	Pseudorhodoplanes sinuspersici	1235591	S	43	1	44	0.00001
SRR6145060	Polynucleobacter necessarius	576610	S	42	2	44	0.00001
SRR6145060	Mannheimia haemolytica	75985	S	29	15	44	0.00001
SRR6145060	Lichenihabitans psoromatis	2528642	S	43	1	44	0.00001
SRR6145060	Lactobacillus fermentum	1613	S	41	3	44	0.00001
SRR6145060	Immundisolibacter cernigliae	1810504	S	44	0	44	0.00001
SRR6145060	Hydrogenophilus thermoluteolus	297	S	44	0	44	0.00001
SRR6145060	Gordonia sp. KTR9	337191	S	564	44	608	0.00008
SRR6145060	Flavobacterium crocinum	2183896	S	39	5	44	0.00001
SRR6145060	Flaviflexus salsibiostraticola	1282737	S	43	1	44	0.00001
SRR6145060	Clostridium saccharoperbutylacetonicum	36745	S	44	0	44	0.00001
SRR6145060	Chitinophaga pinensis	79329	S	42	2	44	0.00001
SRR6145060	Bacteroides intestinalis	329854	S	41	3	44	0.00001
SRR6145060	Bacillus circulans	1397	S	44	0	44	0.00001
SRR6145060	Acidibrevibacterium fodinaquatile	1969806	S	44	0	44	0.00001
SRR6145060	Xanthomonas cucurbitae	56453	S	40	3	43	0.00001
SRR6145060	Trichodesmium erythraeum	1206	S	41	2	43	0.00001
SRR6145060	Rhodomicrobium vannielii	1069	S	43	0	43	0.00001
SRR6145060	Rhodobacter sp. LPB0142	1850250	S	189	43	232	0.00003
SRR6145060	Pantoea rwandensis	1076550	S	41	2	43	0.00001
SRR6145060	Paludisphaera borealis	1387353	S	41	2	43	0.00001
SRR6145060	Mesorhizobium sp. M2A.F.Ca.ET.046.03.2.1	2493674	S	13	43	56	0.00001
SRR6145060	Leisingera methylohalidivorans	133924	S	40	3	43	0.00001
SRR6145060	Lacipirellula parvula	2650471	S	41	2	43	0.00001
SRR6145060	Glutamicibacter sp. ZJUTW	1155384	S	24	43	67	0.00001
SRR6145060	Deinococcus peraridilitoris	432329	S	43	0	43	0.00001
SRR6145060	Corynebacterium pseudotuberculosis	1719	S	42	1	43	0.00001
SRR6145060	Carnobacterium maltaromaticum	2751	S	41	2	43	0.00001
SRR6145060	Bifidobacterium pseudocatenulatum	28026	S	31	12	43	0.00001
SRR6145060	Azospirillum sp. TSH58	664962	S	41	43	84	0.00001
SRR6145060	Xanthomonas perforans	442694	S	7	35	42	0.00001
SRR6145060	Sulfitobacter sp. AM1-D1	1917485	S	57	42	99	0.00001
SRR6145060	Streptomyces pratensis	1169025	S	7	35	42	0.00001
SRR6145060	Streptococcus infantarius	102684	S	27	15	42	0.00001
SRR6145060	Staphylococcus carnosus	1281	S	38	4	42	0.00001
SRR6145060	Stanieria cyanosphaera	102116	S	24	18	42	0.00001
SRR6145060	Spirosoma montaniterrae	1178516	S	41	1	42	0.00001
SRR6145060	Pseudonocardia sp. HH130629-09	1641402	S	190	42	232	0.00003
SRR6145060	Pseudomonas koreensis	198620	S	37	5	42	0.00001
SRR6145060	Pandoraea pulmonicola	93221	S	39	3	42	0.00001
SRR6145060	Pandoraea pnomenusa	93220	S	36	6	42	0.00001
SRR6145060	Pandoraea apista	93218	S	34	8	42	0.00001
SRR6145060	Nocardioides sp. JS614	196162	S	365	42	407	0.00005
SRR6145060	Microbacterium sp. 1.5R	1916917	S	17	42	59	0.00001
SRR6145060	Mesorhizobium erdmanii	1777866	S	34	8	42	0.00001
SRR6145060	Legionella pneumophila	446	S	36	6	42	0.00001
SRR6145060	Lactobacillus salivarius	1624	S	41	1	42	0.00001
SRR6145060	Fibrella aestuarina	651143	S	41	1	42	0.00001
SRR6145060	Enterobacter sp. DKU_NT_01	2093698	S	2	42	44	0.00001
SRR6145060	Collimonas arenae	279058	S	38	4	42	0.00001
SRR6145060	Altererythrobacter epoxidivorans	361183	S	35	7	42	0.00001
SRR6145060	Vibrio cholerae	666	S	28	13	41	0.00001
SRR6145060	Variovorax sp. WDL1	207745	S	65	41	106	0.00001
SRR6145060	Thermus thermophilus	274	S	33	8	41	0.00001
SRR6145060	Streptomyces sp. WAC 01529	2203205	S	41	7	48	0.00001
SRR6145060	Spirosoma aerolatum	1211326	S	40	1	41	0.00001
SRR6145060	Sneathia amnii	187101	S	41	0	41	0.00001
SRR6145060	Rhodothermus marinus	29549	S	40	1	41	0.00001
SRR6145060	Pseudomonas sp. 13159349	2662034	S	13	41	54	0.00001
SRR6145060	Pseudomonas rhodesiae	76760	S	35	6	41	0.00001
SRR6145060	Pseudomonas guangdongensis	1245526	S	40	1	41	0.00001
SRR6145060	Pelagibacterium halotolerans	531813	S	40	1	41	0.00001
SRR6145060	Paraburkholderia graminis	60548	S	38	3	41	0.00001
SRR6145060	Methylocystis parvus	134	S	39	2	41	0.00001
SRR6145060	Methylibium sp. Pch-M	2082386	S	45	41	86	0.00001
SRR6145060	Mesorhizobium amorphae	71433	S	37	4	41	0.00001
SRR6145060	Lactobacillus jensenii	109790	S	40	1	41	0.00001
SRR6145060	Hyphomicrobium nitrativorans	1427356	S	41	0	41	0.00001
SRR6145060	Fusobacterium varium	856	S	40	1	41	0.00001
SRR6145060	Flavobacterium commune	1306519	S	40	1	41	0.00001
SRR6145060	Flavobacterium columnare	996	S	40	1	41	0.00001
SRR6145060	Erythrobacter atlanticus	1648404	S	30	11	41	0.00001
SRR6145060	Enterobacter chengduensis	2494701	S	34	7	41	0.00001
SRR6145060	Bradyrhizobium sp. WSM471	319017	S	16	41	57	0.00001
SRR6145060	Bifidobacterium catenulatum	1686	S	31	10	41	0.00001
SRR6145060	Streptomyces sp. DUT11	1914992	S	12	40	52	0.00001
SRR6145060	Spirosoma sp. KCTC 42546	2520506	S	40	1	41	0.00001
SRR6145060	Roseburia intestinalis	166486	S	34	6	40	0.00001
SRR6145060	Psychrobacter sp. P11G5	1699624	S	67	40	107	0.00001
SRR6145060	Paraburkholderia caledonica	134536	S	38	2	40	0.00001
SRR6145060	Myroides odoratimimus	76832	S	21	19	40	0.00001
SRR6145060	Hymenobacter jejuensis	2502781	S	38	2	40	0.00001
SRR6145060	Halomonas sp. hl-4	1761789	S	11	40	51	0.00001
SRR6145060	Halomonas aestuarii	1897729	S	40	0	40	0.00001
SRR6145060	Cronobacter malonaticus	413503	S	22	18	40	0.00001
SRR6145060	Burkholderia territorii	1503055	S	28	12	40	0.00001
SRR6145060	Acinetobacter sp. 10FS3-1	2563897	S	236	40	276	0.00004
SRR6145060	Acidihalobacter prosperus	160660	S	40	0	40	0.00001
SRR6145060	Thiomonas intermedia	926	S	30	9	39	0.00001
SRR6145060	Terriglobus roseus	392734	S	37	2	39	0.00001
SRR6145060	Streptomyces sp. SUK 48	2582831	S	39	11	50	0.00001
SRR6145060	Streptomyces sp. MOE7	1961713	S	30	39	69	0.00001
SRR6145060	Streptomyces sp. FR-008	206662	S	5	39	44	0.00001
SRR6145060	Rhodospirillum rubrum	1085	S	37	2	39	0.00001
SRR6145060	Mycobacterium sp. PYR15	2051552	S	16	39	55	0.00001
SRR6145060	Martelella endophytica	1486262	S	36	3	39	0.00001
SRR6145060	Marichromatium purpuratum	37487	S	38	1	39	0.00001
SRR6145060	Erwinia sp. QL-Z3	2547962	S	27	39	66	0.00001
SRR6145060	Chromobacterium violaceum	536	S	31	8	39	0.00001
SRR6145060	Bosea sp. AS-1	2015316	S	188	39	227	0.00003
SRR6145060	Blattabacterium sp. (Blattella germanica)	624186	S	39	0	39	0.00001
SRR6145060	Blastomonas sp. RAC04	1842535	S	47	39	86	0.00001
SRR6145060	Alienimonas californiensis	2527989	S	39	0	39	0.00001
SRR6145060	Agrobacterium vitis	373	S	39	0	39	0.00001
SRR6145060	Actinobacillus porcitonsillarum	189834	S	37	2	39	0.00001
SRR6145060	Acidiphilium cryptum	524	S	10	29	39	0.00001
SRR6145060	Streptomyces cinereoruber	67260	S	4	34	38	0.00001
SRR6145060	Staphylococcus virus IPLA7	1197953	S	7	38	45	0.00001
SRR6145060	Sphingomonas sp. LK11	1390395	S	377	38	415	0.00005
SRR6145060	Saccharibacillus brassicae	2583377	S	38	0	38	0.00001
SRR6145060	Pseudomonas sp. ATCC 13867	1294143	S	38	3	41	0.00001
SRR6145060	Pseudomonas resinovorans	53412	S	37	1	38	0.00001
SRR6145060	Pseudomonas alkylphenolica	237609	S	37	1	38	0.00001
SRR6145060	Pigmentiphaga aceris	1940612	S	38	0	38	0.00001
SRR6145060	Phycicoccus sp. HDW14	2714941	S	555	38	593	0.00008
SRR6145060	Pedobacter ginsengisoli	363852	S	36	2	38	0.00001
SRR6145060	Pantoea stewartii	66269	S	36	2	38	0.00001
SRR6145060	Nitrobacter winogradskyi	913	S	35	3	38	0.00001
SRR6145060	Nitrobacter hamburgensis	912	S	35	3	38	0.00001
SRR6145060	Mannheimia varigena	85404	S	34	4	38	0.00001
SRR6145060	Magnetospirillum magneticum	84159	S	33	5	38	0.00001
SRR6145060	Bradyrhizobium sp. S23321	335659	S	17	38	55	0.00001
SRR6145060	Bacillus velezensis	492670	S	10	28	38	0.00001
SRR6145060	Acetobacter ghanensis	431306	S	37	1	38	0.00001
SRR6145060	Shewanella sp. FDAARGOS_354	1930557	S	180	37	217	0.00003
SRR6145060	Schaalia cardiffensis	181487	S	37	0	37	0.00000
SRR6145060	Salinigranum rubrum	755307	S	37	0	37	0.00000
SRR6145060	Salinibacter ruber	146919	S	37	0	37	0.00000
SRR6145060	Pseudomonas sp. JY-Q	1338689	S	10	37	47	0.00001
SRR6145060	Paenibacillus polymyxa	1406	S	21	16	37	0.00000
SRR6145060	Lactobacillus sakei	1599	S	35	2	37	0.00000
SRR6145060	Hyphomicrobium denitrificans	53399	S	35	2	37	0.00000
SRR6145060	Geobacillus stearothermophilus	1422	S	27	10	37	0.00000
SRR6145060	Delftia sp. HK171	1920191	S	17	37	54	0.00001
SRR6145060	Delftia sp. Cs1-4	742013	S	19	37	56	0.00001
SRR6145060	Chromohalobacter salexigens	158080	S	37	0	37	0.00000
SRR6145060	Burkholderia ambifaria	152480	S	19	18	37	0.00000
SRR6145060	Azospira sp. I09	1765049	S	35	37	72	0.00001
SRR6145060	Zobellella denitrificans	347534	S	36	0	36	0.00000
SRR6145060	Xanthomonas vasicola	56459	S	31	5	36	0.00000
SRR6145060	Xanthomonas hortorum	56454	S	19	17	36	0.00000
SRR6145060	Streptomyces bacillaris	68179	S	7	29	36	0.00000
SRR6145060	Streptococcus pluranimalium	82348	S	35	1	36	0.00000
SRR6145060	Sphingopyxis sp. PAMC25046	2565556	S	127	36	163	0.00002
SRR6145060	Sphingomonas sp. KC8	1030157	S	102	36	138	0.00002
SRR6145060	Sphingobium fuliginis	336203	S	14	22	36	0.00000
SRR6145060	Rhodoferax saidenbachensis	1484693	S	34	2	36	0.00000
SRR6145060	Pseudomonas sp. J380	2605424	S	38	36	74	0.00001
SRR6145060	Pseudomonas orientalis	76758	S	32	4	36	0.00000
SRR6145060	Pseudomonas cremoricolorata	157783	S	36	0	36	0.00000
SRR6145060	Proteus vulgaris	585	S	29	7	36	0.00000
SRR6145060	Opitutus terrae	107709	S	35	1	36	0.00000
SRR6145060	Neisseria canis	493	S	34	2	36	0.00000
SRR6145060	Mycobacterium marinum	1781	S	23	13	36	0.00000
SRR6145060	Microbacterium sp. CGR1	1696072	S	14	36	50	0.00001
SRR6145060	Methylocella tundrae	227605	S	36	0	36	0.00000
SRR6145060	Mesorhizobium huakuii	28104	S	6	30	36	0.00000
SRR6145060	Leclercia sp. W17	2282309	S	20	36	56	0.00001
SRR6145060	Halorubrum lacusprofundi	2247	S	24	12	36	0.00000
SRR6145060	Halomonas beimenensis	475662	S	36	0	36	0.00000
SRR6145060	Halobellus limi	699433	S	33	3	36	0.00000
SRR6145060	Eikenella exigua	2528037	S	32	4	36	0.00000
SRR6145060	Eggerthella lenta	84112	S	32	4	36	0.00000
SRR6145060	Crinalium epipsammum	241425	S	28	8	36	0.00000
SRR6145060	Clostridium saccharobutylicum	169679	S	36	0	36	0.00000
SRR6145060	Chromobacterium rhizoryzae	1778675	S	7	29	36	0.00000
SRR6145060	Chelatococcus sp. CO-6	1702325	S	101	36	137	0.00002
SRR6145060	Capnocytophaga canimorsus	28188	S	33	3	36	0.00000
SRR6145060	Bordetella pseudohinzii	1331258	S	31	5	36	0.00000
SRR6145060	Azotobacter salinestris	69964	S	26	10	36	0.00000
SRR6145060	Afipia sp. GAS231	1882747	S	51	36	87	0.00001
SRR6145060	Variovorax sp. PMC12	2126319	S	133	35	168	0.00002
SRR6145060	Streptomyces rochei	1928	S	20	15	35	0.00000
SRR6145060	Rhodococcus sp. H-CA8f	1727214	S	6	35	41	0.00001
SRR6145060	Rathayibacter rathayi	33887	S	30	5	35	0.00000
SRR6145060	Pyruvatibacter mobilis	1712261	S	35	0	35	0.00000
SRR6145060	Pseudomonas veronii	76761	S	20	15	35	0.00000
SRR6145060	Pseudomonas simiae	321846	S	32	3	35	0.00000
SRR6145060	Pseudohalocynthiibacter aestuariivivens	1591409	S	31	4	35	0.00000
SRR6145060	Pseudoalteromonas translucida	166935	S	28	7	35	0.00000
SRR6145060	Porphyromonas cangingivalis	36874	S	34	1	35	0.00000
SRR6145060	Paraburkholderia sprentiae	948107	S	34	1	35	0.00000
SRR6145060	Paraburkholderia phymatum	148447	S	33	2	35	0.00000
SRR6145060	Pantoea eucalypti	470933	S	6	29	35	0.00000
SRR6145060	Pandoraea fibrosis	1891094	S	29	6	35	0.00000
SRR6145060	Niabella ginsenosidivorans	1176587	S	35	0	35	0.00000
SRR6145060	Myroides odoratus	256	S	35	0	35	0.00000
SRR6145060	Mycobacterium sp. YC-RL4	1682113	S	231	35	266	0.00004
SRR6145060	Moorea producens	1155739	S	34	1	35	0.00000
SRR6145060	Mixta gaviniae	665914	S	32	3	35	0.00000
SRR6145060	Massilia sp. YMA4	1593482	S	106	35	141	0.00002
SRR6145060	Lelliottia amnigena	61646	S	34	1	35	0.00000
SRR6145060	Leclercia sp. LSNIH3	1920116	S	1	35	36	0.00000
SRR6145060	Lacunisphaera limnophila	1838286	S	33	2	35	0.00000
SRR6145060	Kosakonia sacchari	1158459	S	30	5	35	0.00000
SRR6145060	Hydrogenophaga crassostreae	1763535	S	35	0	35	0.00000
SRR6145060	Haloterrigena turkmenica	62320	S	33	2	35	0.00000
SRR6145060	Halomonas titanicae	664683	S	14	21	35	0.00000
SRR6145060	Guyparkeria halophila	47960	S	34	1	35	0.00000
SRR6145060	Cupriavidus sp. USMAHM13	1389192	S	4	35	39	0.00001
SRR6145060	Corynebacterium rouxii	2719119	S	31	4	35	0.00000
SRR6145060	Cellvibrio japonicus	155077	S	34	1	35	0.00000
SRR6145060	Bradyrhizobium amphicarpaeae	1404768	S	27	8	35	0.00000
SRR6145060	Bacteroides salanitronis	376805	S	32	3	35	0.00000
SRR6145060	Arcobacter butzleri	28197	S	33	2	35	0.00000
SRR6145060	Streptococcus sp. NCTC 11567	2583584	S	34	233	267	0.00004
SRR6145060	Stenotrophomonas sp. DAIF1	2546450	S	10	34	44	0.00001
SRR6145060	Sphingosinithalassobacter sp. zrk23	2711215	S	147	34	181	0.00002
SRR6145060	Rhodococcus sp. WB9	2594007	S	28	34	62	0.00001
SRR6145060	Rhodobacteraceae bacterium 9Alg 56	2683284	S	34	0	34	0.00000
SRR6145060	Rhizobium jaguaris	1312183	S	33	1	34	0.00000
SRR6145060	Rathayibacter iranicus	59737	S	32	2	34	0.00000
SRR6145060	Pseudopedobacter saltans	151895	S	33	1	34	0.00000
SRR6145060	Pseudomonas sp. R2A2	2213057	S	55	34	89	0.00001
SRR6145060	Pandoraea thiooxydans	445709	S	34	0	34	0.00000
SRR6145060	Pandoraea norimbergensis	93219	S	32	2	34	0.00000
SRR6145060	Ornithinimicrobium sp. HY006	2508882	S	178	34	212	0.00003
SRR6145060	Neisseria brasiliensis	2666100	S	30	4	34	0.00000
SRR6145060	Methylovirgula ligni	569860	S	33	1	34	0.00000
SRR6145060	Methylocystis heyeri	391905	S	33	1	34	0.00000
SRR6145060	Methanosarcina barkeri	2208	S	34	0	34	0.00000
SRR6145060	Marinobacter salarius	1420917	S	33	1	34	0.00000
SRR6145060	Leuconostoc kimchii	136609	S	4	30	34	0.00000
SRR6145060	Klebsiella sp. LTGPAF-6F	1905288	S	1	34	35	0.00000
SRR6145060	Halorubrum trapanicum	29284	S	26	8	34	0.00000
SRR6145060	Dickeya zeae	204042	S	33	1	34	0.00000
SRR6145060	Corynebacterium crudilactis	1652495	S	31	3	34	0.00000
SRR6145060	Chromobacterium sp. ATCC 53434	2059672	S	34	5	39	0.00001
SRR6145060	Capnocytophaga haemolytica	45243	S	34	0	34	0.00000
SRR6145060	Caballeronia sp. SBC1	2705548	S	3	34	37	0.00000
SRR6145060	Streptococcus gallolyticus	315405	S	15	18	33	0.00000
SRR6145060	Staphylococcus schleiferi	1295	S	30	3	33	0.00000
SRR6145060	Sphingobium sp. MI1205	407020	S	47	33	80	0.00001
SRR6145060	Serratia plymuthica	82996	S	30	3	33	0.00000
SRR6145060	Rathayibacter sp. VKM Ac-2801	2609255	S	33	24	57	0.00001
SRR6145060	Pseudonocardia sp. HH130630-07	1690815	S	214	33	247	0.00003
SRR6145060	Pseudomonas versuta	1788301	S	32	1	33	0.00000
SRR6145060	Pseudomonas sp. 02C 26	2054914	S	33	0	33	0.00000
SRR6145060	Pseudomonas libanensis	75588	S	18	15	33	0.00000
SRR6145060	Pseudomonas graminis	158627	S	33	0	33	0.00000
SRR6145060	Nostoc carneum	374162	S	12	21	33	0.00000
SRR6145060	Nocardioides sp. dk3136	2575373	S	132	33	165	0.00002
SRR6145060	Mycobacterium paraintracellulare	1138383	S	9	24	33	0.00000
SRR6145060	Laribacter hongkongensis	168471	S	29	4	33	0.00000
SRR6145060	Hyphomonas sp. CACIAM 19H1	1873716	S	33	2	35	0.00000
SRR6145060	Halotalea alkalilenta	376489	S	33	0	33	0.00000
SRR6145060	Halomonas sp. PGE1	2730360	S	64	33	97	0.00001
SRR6145060	Halobiforma lacisalsi	229731	S	29	4	33	0.00000
SRR6145060	Glaesserella parasuis	738	S	31	2	33	0.00000
SRR6145060	Desulfovibrio desulfuricans	876	S	29	4	33	0.00000
SRR6145060	Desulfarculus baarsii	453230	S	30	3	33	0.00000
SRR6145060	Clostridium novyi	1542	S	32	1	33	0.00000
SRR6145060	Castellaniella defragrans	75697	S	30	3	33	0.00000
SRR6145060	Burkholderia insecticola	758793	S	32	1	33	0.00000
SRR6145060	Azospirillum sp. TSA2s	709810	S	49	33	82	0.00001
SRR6145060	Anaerobutyricum hallii	39488	S	29	4	33	0.00000
SRR6145060	Achromobacter sp. AONIH1	1758194	S	83	33	116	0.00002
SRR6145060	Vulgatibacter incomptus	1391653	S	32	0	32	0.00000
SRR6145060	Thiohalobacter thiocyanaticus	585455	S	31	1	32	0.00000
SRR6145060	Thauera hydrothermalis	2184083	S	8	24	32	0.00000
SRR6145060	Sphingopyxis sp. EG6	1874061	S	102	32	134	0.00002
SRR6145060	Serpentinomonas raichei	1458425	S	29	3	32	0.00000
SRR6145060	Roseivivax sp. THAF197b	2588299	S	4	32	36	0.00000
SRR6145060	Rhizobium tropici	398	S	28	4	32	0.00000
SRR6145060	Pseudomonas tolaasii	29442	S	28	4	32	0.00000
SRR6145060	Pseudomonas sp. SWI44	2083053	S	5	32	37	0.00000
SRR6145060	Pseudomonas frederiksbergensis	104087	S	28	4	32	0.00000
SRR6145060	Plantactinospora sp. BB1	2071627	S	17	32	49	0.00001
SRR6145060	Photobacterium damselae	38293	S	30	2	32	0.00000
SRR6145060	Moraxella bovis	476	S	31	1	32	0.00000
SRR6145060	Micavibrio aeruginosavorus	349221	S	32	0	32	0.00000
SRR6145060	Lactobacillus reuteri	1598	S	31	1	32	0.00000
SRR6145060	Lactobacillus johnsonii	33959	S	30	2	32	0.00000
SRR6145060	Intestinimonas butyriciproducens	1297617	S	3	29	32	0.00000
SRR6145060	Hoeflea phototrophica	244596	S	31	1	32	0.00000
SRR6145060	Halomonas subglaciescola	29571	S	32	0	32	0.00000
SRR6145060	Fusobacterium necrophorum	859	S	32	0	32	0.00000
SRR6145060	Flavobacterium sangjuense	2518177	S	32	0	32	0.00000
SRR6145060	Chitinolyticbacter meiyuanensis	682798	S	32	0	32	0.00000
SRR6145060	Caulobacter sp. Ji-3-8	2708539	S	121	32	153	0.00002
SRR6145060	Bordetella trematum	123899	S	29	3	32	0.00000
SRR6145060	Bordetella holmesii	35814	S	23	9	32	0.00000
SRR6145060	Bacillus pseudomycoides	64104	S	32	0	32	0.00000
SRR6145060	Bacillus litoralis	152268	S	32	0	32	0.00000
SRR6145060	Arcobacter lekithochrous	1904463	S	32	0	32	0.00000
SRR6145060	Aeromonas sp. ASNIH4	1636609	S	17	32	49	0.00001
SRR6145060	Thalassobius gelatinovorus	53501	S	31	0	31	0.00000
SRR6145060	Sulfuritortus calidifontis	1914471	S	26	5	31	0.00000
SRR6145060	Streptomyces sp. WAC 06738	2203210	S	31	6	37	0.00000
SRR6145060	Sphaerobacter thermophilus	2057	S	31	0	31	0.00000
SRR6145060	Salinicola tamaricis	1771309	S	31	0	31	0.00000
SRR6145060	Roseivivax sp. THAF40	2587858	S	3	31	34	0.00000
SRR6145060	Rhodobaca barguzinensis	441209	S	31	0	31	0.00000
SRR6145060	Psychromicrobium lacuslunae	1618207	S	31	0	31	0.00000
SRR6145060	Plantibacter sp. PA-3-X8	2480625	S	30	31	61	0.00001
SRR6145060	Paraburkholderia phenoliruptrix	252970	S	13	18	31	0.00000
SRR6145060	Octadecabacter antarcticus	1217908	S	30	1	31	0.00000
SRR6145060	Ochrobactrum quorumnocens	271865	S	30	1	31	0.00000
SRR6145060	Niastella koreensis	354356	S	30	1	31	0.00000
SRR6145060	Neisseria animaloris	326522	S	30	1	31	0.00000
SRR6145060	Mageeibacillus indolicus	884684	S	30	1	31	0.00000
SRR6145060	Flavisolibacter ginsenosidimutans	661481	S	31	0	31	0.00000
SRR6145060	Enterobacter cancerogenus	69218	S	30	1	31	0.00000
SRR6145060	Corynebacterium mustelae	571915	S	31	0	31	0.00000
SRR6145060	Confluentimicrobium sp. EMB200-NS6	1609966	S	63	31	94	0.00001
SRR6145060	Chitinophaga sp. 1310	2725416	S	3	31	34	0.00000
SRR6145060	Capnocytophaga stomatis	1848904	S	30	1	31	0.00000
SRR6145060	Calothrix parasitica	1973486	S	29	2	31	0.00000
SRR6145060	Azoarcus olearius	418699	S	7	24	31	0.00000
SRR6145060	Alistipes shahii	328814	S	20	11	31	0.00000
SRR6145060	Achromobacter ruhlandii	72557	S	1	30	31	0.00000
SRR6145060	Vibrio fluvialis	676	S	28	2	30	0.00000
SRR6145060	Tatumella ptyseos	82987	S	29	1	30	0.00000
SRR6145060	Tateyamaria omphalii	299262	S	30	0	30	0.00000
SRR6145060	Sulfuricaulis limicola	1620215	S	30	0	30	0.00000
SRR6145060	Staphylococcus phage StB27	1147044	S	19	30	49	0.00001
SRR6145060	Spirosoma rigui	564064	S	29	1	30	0.00000
SRR6145060	Spirosoma radiotolerans	1379870	S	28	2	30	0.00000
SRR6145060	Rhodoferax ferrireducens	192843	S	29	1	30	0.00000
SRR6145060	Rhodococcus sp. MTM3W5.2	1805827	S	308	30	338	0.00004
SRR6145060	Rhodobacter sp. CZR27	2033869	S	177	30	207	0.00003
SRR6145060	Rhizobium sp. TCK	136098	S	16	30	46	0.00001
SRR6145060	Pseudomonas moraviensis	321662	S	26	4	30	0.00000
SRR6145060	Pseudarthrobacter sp. NIBRBAC000502771	2590774	S	18	30	48	0.00001
SRR6145060	Planctomycetes bacterium Spa11	2528022	S	2	30	32	0.00000
SRR6145060	Peptoniphilus ivorii	54006	S	30	0	30	0.00000
SRR6145060	Pararhodospirillum photometricum	1084	S	30	0	30	0.00000
SRR6145060	Nostoc sphaeroides	446679	S	20	10	30	0.00000
SRR6145060	Nocardioides sp. HDW12B	2714939	S	272	30	302	0.00004
SRR6145060	Muribaculaceae bacterium DSM 108610	2652307	S	30	2	32	0.00000
SRR6145060	Methylocystis bryophila	655015	S	29	1	30	0.00000
SRR6145060	Limnochorda pilosa	1555112	S	30	0	30	0.00000
SRR6145060	Leptospira interrogans	173	S	24	6	30	0.00000
SRR6145060	Jeotgalicoccus saudimassiliensis	1461582	S	30	0	30	0.00000
SRR6145060	Herbaspirillum hiltneri	341045	S	29	1	30	0.00000
SRR6145060	Halorhodospira halophila	1053	S	30	0	30	0.00000
SRR6145060	Haloplanus rallus	1816183	S	27	3	30	0.00000
SRR6145060	Granulibacter bethesdensis	364410	S	30	0	30	0.00000
SRR6145060	Gloeocapsa sp. PCC 7428	1173026	S	30	6	36	0.00000
SRR6145060	Flavivirga eckloniae	1803846	S	30	0	30	0.00000
SRR6145060	Campylobacter geochelonis	1780362	S	30	0	30	0.00000
SRR6145060	Bradyrhizobium sp. SG09	2599805	S	3	30	33	0.00000
SRR6145060	Bifidobacterium scardovii	158787	S	30	0	30	0.00000
SRR6145060	Bacteroides cellulosilyticus	246787	S	26	4	30	0.00000
SRR6145060	Actinoalloteichus sp. GBA129-24	1612551	S	3	30	33	0.00000
SRR6145060	Weeksella virosa	1014	S	29	0	29	0.00000
SRR6145060	Treponema phagedenis	162	S	29	0	29	0.00000
SRR6145060	Thioalkalivibrio sulfidiphilus	1033854	S	26	3	29	0.00000
SRR6145060	Streptococcus marmotae	1825069	S	28	1	29	0.00000
SRR6145060	Streptobacillus moniliformis	34105	S	29	0	29	0.00000
SRR6145060	Sporosarcina ureae	1571	S	29	0	29	0.00000
SRR6145060	Singulisphaera acidiphila	466153	S	29	0	29	0.00000
SRR6145060	Rouxiella badensis	1646377	S	29	0	29	0.00000
SRR6145060	Roseovarius sp. THAF27	2587850	S	21	29	50	0.00001
SRR6145060	Rhizobium sp. Khangiran2	1435607	S	55	29	84	0.00001
SRR6145060	Raoultella planticola	575	S	24	5	29	0.00000
SRR6145060	Pseudomonas saudiphocaensis	1499686	S	29	0	29	0.00000
SRR6145060	Propionibacterium virus P104A	1982268	S	29	29	58	0.00001
SRR6145060	Polaribacter reichenbachii	996801	S	25	4	29	0.00000
SRR6145060	Phyllobacterium zundukense	1867719	S	28	1	29	0.00000
SRR6145060	Paraburkholderia terrae	311230	S	23	6	29	0.00000
SRR6145060	Paraburkholderia megapolitana	420953	S	29	0	29	0.00000
SRR6145060	Nostoc linckia	92942	S	23	6	29	0.00000
SRR6145060	Nodularia spumigena	70799	S	24	5	29	0.00000
SRR6145060	Neisseria animalis	492	S	29	0	29	0.00000
SRR6145060	Mucilaginibacter sp. PAMC 26640	1300914	S	29	1	30	0.00000
SRR6145060	Lutibacter profundi	1622118	S	29	0	29	0.00000
SRR6145060	Kluyvera intermedia	61648	S	26	3	29	0.00000
SRR6145060	Hydrogenophaga sp. PBC	795665	S	116	29	145	0.00002
SRR6145060	Halobacterium hubeiense	1407499	S	26	3	29	0.00000
SRR6145060	Geobacter sulfurreducens	35554	S	18	11	29	0.00000
SRR6145060	Dermatophilus congolensis	1863	S	29	0	29	0.00000
SRR6145060	Chromobacterium haemolyticum	394935	S	6	23	29	0.00000
SRR6145060	Carnobacterium inhibens	147709	S	26	3	29	0.00000
SRR6145060	Bacteroides xylanisolvens	371601	S	15	14	29	0.00000
SRR6145060	Anabaenopsis circularis	109266	S	20	9	29	0.00000
SRR6145060	Xanthomonas fragariae	48664	S	27	1	28	0.00000
SRR6145060	Symbiobacterium thermophilum	2734	S	28	0	28	0.00000
SRR6145060	Streptomyces sp. Tue 6075	1661694	S	28	15	43	0.00001
SRR6145060	Stenotrophomonas sp. WZN-1	2005046	S	34	28	62	0.00001
SRR6145060	Staphylococcus virus IPLAC1C	1980931	S	22	28	50	0.00001
SRR6145060	Sphingopyxis sp. 113P3	292913	S	117	28	145	0.00002
SRR6145060	Rhodococcus sp. W8901	2742603	S	223	28	251	0.00003
SRR6145060	Rhodococcus sp. SGAir0479	2567884	S	213	28	241	0.00003
SRR6145060	Rhizobium gallicum	56730	S	27	1	28	0.00000
SRR6145060	Pseudomonas trivialis	200450	S	24	4	28	0.00000
SRR6145060	Pseudomonas rhizosphaerae	216142	S	28	0	28	0.00000
SRR6145060	Pedobacter cryoconitis	188932	S	27	1	28	0.00000
SRR6145060	Pantoea alhagi	1891675	S	27	1	28	0.00000
SRR6145060	Mycoplasma salivarium	2124	S	15	13	28	0.00000
SRR6145060	Leclercia sp. J807	2681307	S	23	28	51	0.00001
SRR6145060	Labrenzia sp. THAF35	2587854	S	6	28	34	0.00000
SRR6145060	Hydrogenophaga sp. BA0156	2716225	S	110	28	138	0.00002
SRR6145060	Halorubrum ezzemoulense	337243	S	24	4	28	0.00000
SRR6145060	Fusobacterium ulcerans	861	S	27	1	28	0.00000
SRR6145060	Flavobacterium nackdongense	2547394	S	28	0	28	0.00000
SRR6145060	Exiguobacterium sp. ZWU0009	1224749	S	14	28	42	0.00001
SRR6145060	Erwinia persicina	55211	S	27	1	28	0.00000
SRR6145060	Enterococcus cecorum	44008	S	27	1	28	0.00000
SRR6145060	Enterococcus casseliflavus	37734	S	20	8	28	0.00000
SRR6145060	Enterobacter cloacae complex sp.	2027919	S	28	28	56	0.00001
SRR6145060	Edwardsiella piscicida	1263550	S	3	25	28	0.00000
SRR6145060	Cupriavidus nantongensis	1796606	S	12	16	28	0.00000
SRR6145060	Corynebacterium choanis	1862358	S	28	0	28	0.00000
SRR6145060	Clostridium kluyveri	1534	S	28	0	28	0.00000
SRR6145060	Candidatus Gracilibacteria bacterium HOT-871	1540872	S	28	0	28	0.00000
SRR6145060	Burkholderia metallica	488729	S	20	8	28	0.00000
SRR6145060	Bordetella flabilis	463014	S	28	0	28	0.00000
SRR6145060	Azoarcus sp. BH72	62928	S	8	28	36	0.00000
SRR6145060	Arthrobacter sp. Rue61a	1118963	S	8	28	36	0.00000
SRR6145060	Anabaena cylindrica	1165	S	23	5	28	0.00000
SRR6145060	Algibacter alginicilyticus	1736674	S	28	0	28	0.00000
SRR6145060	Alcanivorax xenomutans	1094342	S	24	4	28	0.00000
SRR6145060	Aerococcus christensenii	87541	S	27	1	28	0.00000
SRR6145060	Variovorax sp. PBL-H6	434009	S	44	27	71	0.00001
SRR6145060	Treponema pedis	409322	S	27	0	27	0.00000
SRR6145060	Thiobacillus denitrificans	36861	S	26	1	27	0.00000
SRR6145060	Thioalkalivibrio paradoxus	108010	S	22	5	27	0.00000
SRR6145060	Tepidiforma bonchosmolovskayae	2601677	S	27	0	27	0.00000
SRR6145060	Tenacibaculum jejuense	584609	S	27	0	27	0.00000
SRR6145060	Tardiphaga sp. vice278	2592815	S	2	27	29	0.00000
SRR6145060	Staphylococcus phage St 134	1958922	S	27	6	33	0.00000
SRR6145060	Sphingobacterium sp. 21	743722	S	7	27	34	0.00000
SRR6145060	Salinicoccus halodurans	407035	S	27	0	27	0.00000
SRR6145060	Salinibacterium sp. CGMCC 1.16371	2079791	S	27	0	27	0.00000
SRR6145060	Roseovarius sp. TM1035	391613	S	10	27	37	0.00000
SRR6145060	Roseburia hominis	301301	S	21	6	27	0.00000
SRR6145060	Plantibacter sp. M259	2583822	S	27	27	54	0.00001
SRR6145060	Parascardovia denticolens	78258	S	27	0	27	0.00000
SRR6145060	Ornithobacterium rhinotracheale	28251	S	27	0	27	0.00000
SRR6145060	Mucilaginibacter mallensis	652787	S	27	0	27	0.00000
SRR6145060	Morganella morganii	582	S	25	2	27	0.00000
SRR6145060	Mitsuaria sp. 7	1658665	S	230	27	257	0.00003
SRR6145060	Microbacterium sp. Y-01	2048898	S	204	27	231	0.00003
SRR6145060	Mesorhizobium sp. M2A.F.Ca.ET.043.05.1.1	2493671	S	36	27	63	0.00001
SRR6145060	Mesorhizobium sp. M2A.F.Ca.ET.043.02.1.1	2493670	S	9	27	36	0.00000
SRR6145060	Leclercia sp. W6	2282310	S	17	27	44	0.00001
SRR6145060	Komagataeibacter hansenii	436	S	26	1	27	0.00000
SRR6145060	Kangiella profundi	1561924	S	26	1	27	0.00000
SRR6145060	Janthinobacterium sp. SNU WT3	2590869	S	27	23	50	0.00001
SRR6145060	Gloeothece citriformis	2546356	S	24	3	27	0.00000
SRR6145060	Exiguobacterium sibiricum	332410	S	26	1	27	0.00000
SRR6145060	Enterobacter ludwigii	299767	S	13	14	27	0.00000
SRR6145060	Dialister pneumosintes	39950	S	27	0	27	0.00000
SRR6145060	Corynebacterium kutscheri	35755	S	27	0	27	0.00000
SRR6145060	Clostridium carboxidivorans	217159	S	26	1	27	0.00000
SRR6145060	Arthrobacter sp. AQ5-05	2184581	S	4	27	31	0.00000
SRR6145060	Arcobacter cryaerophilus	28198	S	25	2	27	0.00000
SRR6145060	Alistipes onderdonkii	328813	S	21	6	27	0.00000
SRR6145060	Aliivibrio fischeri	668	S	27	0	27	0.00000
SRR6145060	Vitreoscilla filiformis	63	S	25	1	26	0.00000
SRR6145060	Thioalkalivibrio nitratireducens	186931	S	21	5	26	0.00000
SRR6145060	Sulfurifustis variabilis	1675686	S	26	0	26	0.00000
SRR6145060	Streptomyces sp. 769	1262452	S	48	26	74	0.00001
SRR6145060	Streptomyces sp. 604F	1476754	S	9	26	35	0.00000
SRR6145060	Streptococcus phage K13	1448274	S	1	26	27	0.00000
SRR6145060	Sphingomonas sp. AAP5	1523415	S	376	26	402	0.00005
SRR6145060	Serratia fonticola	47917	S	23	3	26	0.00000
SRR6145060	Salmonella sp. S13	2686305	S	1	26	27	0.00000
SRR6145060	Roseovarius sp. THAF8	2587846	S	21	26	47	0.00001
SRR6145060	Rhodoferax antarcticus	81479	S	25	1	26	0.00000
SRR6145060	Pseudomonas marincola	437900	S	26	0	26	0.00000
SRR6145060	Paraflavitalea soli	2315862	S	26	0	26	0.00000
SRR6145060	Paraburkholderia dokdonella	2211211	S	25	1	26	0.00000
SRR6145060	Pantoea sp. PSNIH1	1484158	S	90	26	116	0.00002
SRR6145060	Pandoraea faecigallinarum	656179	S	23	3	26	0.00000
SRR6145060	Oceanithermus profundus	187137	S	26	0	26	0.00000
SRR6145060	Nocardioides sp. 78	2045452	S	183	26	209	0.00003
SRR6145060	Mucilaginibacter gotjawali	1550579	S	26	0	26	0.00000
SRR6145060	Microbacterium endophyticum	1526412	S	26	0	26	0.00000
SRR6145060	Methylomonas clara	417	S	20	6	26	0.00000
SRR6145060	Mesorhizobium sp. WSM1497	278153	S	6	26	32	0.00000
SRR6145060	Leuconostoc garlicum	255248	S	11	15	26	0.00000
SRR6145060	Leptolyngbya boryana	1184	S	23	3	26	0.00000
SRR6145060	Lactococcus petauri	1940789	S	23	3	26	0.00000
SRR6145060	Kosakonia radicincitans	283686	S	9	17	26	0.00000
SRR6145060	Halopiger xanaduensis	387343	S	24	2	26	0.00000
SRR6145060	Halomonas sp. HL-93	1666906	S	7	26	33	0.00000
SRR6145060	Halomonas huangheensis	1178482	S	26	0	26	0.00000
SRR6145060	Glycocaulis alkaliphilus	1434191	S	26	0	26	0.00000
SRR6145060	Euhalothece natronophila	577489	S	21	5	26	0.00000
SRR6145060	Elizabethkingia sp. 2-6	2575699	S	38	26	64	0.00001
SRR6145060	Clostridium cellulovorans	1493	S	26	0	26	0.00000
SRR6145060	Clostridium baratii	1561	S	26	0	26	0.00000
SRR6145060	Burkholderia sp. OLGA172	1804984	S	270	26	296	0.00004
SRR6145060	Burkholderia oklahomensis	342113	S	21	5	26	0.00000
SRR6145060	Bradyrhizobium sp. 6(2017)	1197460	S	253	26	279	0.00004
SRR6145060	Blautia producta	33035	S	17	9	26	0.00000
SRR6145060	Arabia massiliensis	1870985	S	26	0	26	0.00000
SRR6145060	Aquiflexum balticum	280473	S	26	0	26	0.00000
SRR6145060	Antarctobacter heliothermus	74033	S	26	0	26	0.00000
SRR6145060	Allochromatium vinosum	1049	S	26	0	26	0.00000
SRR6145060	Ahniella affigens	2021234	S	26	0	26	0.00000
SRR6145060	Aeromonas sp. 2692-1	2560029	S	8	26	34	0.00000
SRR6145060	Acidovorax sp. RAC01	1842533	S	92	26	118	0.00002
SRR6145060	[Clostridium] innocuum	1522	S	11	14	25	0.00000
SRR6145060	Treponema putidum	221027	S	21	4	25	0.00000
SRR6145060	Thiomonas arsenitoxydans	426114	S	9	16	25	0.00000
SRR6145060	Thermoanaerobacterium thermosaccharolyticum	1517	S	21	4	25	0.00000
SRR6145060	Thermaerobacter marianensis	73919	S	23	2	25	0.00000
SRR6145060	Taylorella equigenitalis	29575	S	25	0	25	0.00000
SRR6145060	Streptomyces sp. S1D4-14	2594461	S	1	25	26	0.00000
SRR6145060	Streptomyces sp. 11-1-2	1851167	S	9	25	34	0.00000
SRR6145060	Streptococcus urinalis	149016	S	23	2	25	0.00000
SRR6145060	Streptococcus uberis	1349	S	24	1	25	0.00000
SRR6145060	Streptococcus phage phiARI0462	1701826	S	1	25	26	0.00000
SRR6145060	Stenotrophomonas sp. G4	2303750	S	26	25	51	0.00001
SRR6145060	Solitalea canadensis	995	S	25	0	25	0.00000
SRR6145060	Serratia sp. JKS000199	1938820	S	3	25	28	0.00000
SRR6145060	Serratia odorifera	618	S	25	0	25	0.00000
SRR6145060	Pseudomonas viridiflava	33069	S	25	0	25	0.00000
SRR6145060	Pseudomonas sabulinigri	472181	S	25	0	25	0.00000
SRR6145060	Pseudomonas pohangensis	364197	S	25	0	25	0.00000
SRR6145060	Pseudomonas mediterranea	183795	S	22	3	25	0.00000
SRR6145060	Pseudomonas lurida	244566	S	23	2	25	0.00000
SRR6145060	Pseudoalteromonas tetraodonis	43659	S	6	19	25	0.00000
SRR6145060	Pseudoalteromonas spongiae	298657	S	25	0	25	0.00000
SRR6145060	Pseudoalteromonas luteoviolacea	43657	S	25	0	25	0.00000
SRR6145060	Pectobacterium polaris	2042057	S	18	7	25	0.00000
SRR6145060	Parabacteroides sp. CT06	2025876	S	3	25	28	0.00000
SRR6145060	Paenibacillus mucilaginosus	61624	S	25	0	25	0.00000
SRR6145060	Oscillatoria nigro-viridis	482564	S	21	4	25	0.00000
SRR6145060	Neisseria weaveri	28091	S	24	1	25	0.00000
SRR6145060	Natrinema pellirubrum	69525	S	21	4	25	0.00000
SRR6145060	Natrialbaceae archaeon XQ-INN 246	2419781	S	25	0	25	0.00000
SRR6145060	Mycoplasma mycoides	2102	S	14	11	25	0.00000
SRR6145060	Mucilaginibacter paludis	423351	S	25	0	25	0.00000
SRR6145060	Microvirgula aerodenitrificans	57480	S	24	1	25	0.00000
SRR6145060	Mesorhizobium sp. M1D.F.Ca.ET.043.01.1.1	2493669	S	42	25	67	0.00001
SRR6145060	Labrenzia sp. CP4	1674922	S	5	25	30	0.00000
SRR6145060	Kordia antarctica	1218801	S	25	0	25	0.00000
SRR6145060	Komagataeibacter saccharivorans	265959	S	24	1	25	0.00000
SRR6145060	Hymenobacter sp. APR13	1356852	S	71	25	96	0.00001
SRR6145060	Halomonas campaniensis	213554	S	16	9	25	0.00000
SRR6145060	Frankia sp. QA3	710111	S	86	25	111	0.00001
SRR6145060	Flavobacterium arcticum	1784713	S	25	0	25	0.00000
SRR6145060	Flavobacteriaceae bacterium	1871037	S	25	0	25	0.00000
SRR6145060	Enterocloster bolteae	208479	S	23	2	25	0.00000
SRR6145060	Chlamydia psittaci	83554	S	10	15	25	0.00000
SRR6145060	Cellulophaga lytica	979	S	25	0	25	0.00000
SRR6145060	Cedecea neteri	158822	S	24	1	25	0.00000
SRR6145060	Burkholderia seminalis	488731	S	18	7	25	0.00000
SRR6145060	Brachyspira pilosicoli	52584	S	25	0	25	0.00000
SRR6145060	Bacillus pumilus	1408	S	23	2	25	0.00000
SRR6145060	Bacillus licheniformis	1402	S	10	15	25	0.00000
SRR6145060	Azospirillum sp. M2T2B2	682998	S	64	25	89	0.00001
SRR6145060	Alcanivorax dieselolei	285091	S	22	3	25	0.00000
SRR6145060	[Pseudomonas] mesoacidophila	265293	S	18	6	24	0.00000
SRR6145060	Zunongwangia profunda	398743	S	23	1	24	0.00000
SRR6145060	Vibrio rumoiensis	76258	S	23	1	24	0.00000
SRR6145060	Sulfuritalea hydrogenivorans	748811	S	24	0	24	0.00000
SRR6145060	Streptomyces sp. RPA4-5	2721245	S	47	24	71	0.00001
SRR6145060	Streptomyces sp. CFMR 7	1649184	S	24	51	75	0.00001
SRR6145060	Streptococcus respiraculi	2021971	S	24	0	24	0.00000
SRR6145060	Streptococcus parauberis	1348	S	22	2	24	0.00000
SRR6145060	Streptococcus lutetiensis	150055	S	4	20	24	0.00000
SRR6145060	Staphylococcus felis	46127	S	24	0	24	0.00000
SRR6145060	Sphingopyxis sp. FD7	1914525	S	104	24	128	0.00002
SRR6145060	Ruminococcus bicirculans	1160721	S	23	1	24	0.00000
SRR6145060	Roseimaritima ulvae	980254	S	24	0	24	0.00000
SRR6145060	Rhodothermaceae bacterium	2026787	S	12	12	24	0.00000
SRR6145060	Rhizobium sp. JKLM13E	2582918	S	12	24	36	0.00000
SRR6145060	Pseudomonas litoralis	797277	S	24	0	24	0.00000
SRR6145060	Pseudomonas lactis	1615674	S	17	7	24	0.00000
SRR6145060	Providencia stuartii	588	S	20	4	24	0.00000
SRR6145060	Pandoraea vervacti	656178	S	21	3	24	0.00000
SRR6145060	Oblitimonas alkaliphila	1697053	S	24	0	24	0.00000
SRR6145060	Ndongobacter massiliensis	1871025	S	22	2	24	0.00000
SRR6145060	Natrinema versiforme	88724	S	22	2	24	0.00000
SRR6145060	Microchaete diplosiphon	1197	S	10	14	24	0.00000
SRR6145060	Methyloceanibacter caenitepidi	1384459	S	24	0	24	0.00000
SRR6145060	Methanococcus maripaludis	39152	S	23	1	24	0.00000
SRR6145060	Labilibaculum antarcticum	1717717	S	24	0	24	0.00000
SRR6145060	Jeotgalibacillus malaysiensis	1508404	S	24	0	24	0.00000
SRR6145060	Halomonas elongata	2746	S	24	0	24	0.00000
SRR6145060	Gordonia sp. 1D	1737359	S	211	24	235	0.00003
SRR6145060	Formosa sediminum	2594004	S	24	0	24	0.00000
SRR6145060	Fimbriimonas ginsengisoli	1005039	S	24	0	24	0.00000
SRR6145060	Dolichospermum compactum	136073	S	11	13	24	0.00000
SRR6145060	Desulfosarcina ovata	83564	S	24	0	24	0.00000
SRR6145060	Celeribacter baekdonensis	875171	S	19	5	24	0.00000
SRR6145060	Calothrix parietina	32054	S	22	2	24	0.00000
SRR6145060	Burkholderia sp. RPE67	758796	S	12	24	36	0.00000
SRR6145060	Brevibacterium sp. o2	2697565	S	91	24	115	0.00002
SRR6145060	Brenneria rubrifaciens	55213	S	10	14	24	0.00000
SRR6145060	Bifidobacterium pseudolongum	1694	S	24	0	24	0.00000
SRR6145060	Bernardetia litoralis	999	S	24	0	24	0.00000
SRR6145060	Bacteroides caccae	47678	S	23	1	24	0.00000
SRR6145060	Anaeromyxobacter sp. K	447217	S	28	24	52	0.00001
SRR6145060	Alkalitalea saponilacus	889453	S	24	0	24	0.00000
SRR6145060	Acinetobacter sp. ACNIH2	1758189	S	215	24	239	0.00003
SRR6145060	Acetobacter aceti	435	S	24	0	24	0.00000
SRR6145060	Zymomonas mobilis	542	S	18	5	23	0.00000
SRR6145060	Weissella jogaejeotgali	1631871	S	22	1	23	0.00000
SRR6145060	Vibrio vulnificus	672	S	22	1	23	0.00000
SRR6145060	Variovorax sp. RA8	662548	S	71	23	94	0.00001
SRR6145060	Urechidicola croceus	1850246	S	23	0	23	0.00000
SRR6145060	Streptomyces sp. ICC4	2099584	S	1	23	24	0.00000
SRR6145060	Streptococcus pasteurianus	197614	S	4	19	23	0.00000
SRR6145060	Stenotrophomonas sp. ZAC14D2_NAIMI4_6	2072406	S	18	23	41	0.00001
SRR6145060	Shewanella oneidensis	70863	S	22	1	23	0.00000
SRR6145060	Rufibacter tibetensis	512763	S	20	3	23	0.00000
SRR6145060	Rubrobacter radiotolerans	42256	S	22	1	23	0.00000
SRR6145060	Pseudomonas taetrolens	47884	S	23	0	23	0.00000
SRR6145060	Pseudomonas sp. SNU WT1	2518644	S	23	1	24	0.00000
SRR6145060	Pseudomonas sp. PONIH3	1636610	S	12	23	35	0.00000
SRR6145060	Pectobacterium versatile	2488639	S	12	11	23	0.00000
SRR6145060	Paracoccus sp. SC2-6	2259340	S	271	23	294	0.00004
SRR6145060	Mucilaginibacter ginsenosidivorans	398053	S	23	0	23	0.00000
SRR6145060	Mixta theicola	1458355	S	21	2	23	0.00000
SRR6145060	Methylovulum psychrotolerans	1704499	S	23	0	23	0.00000
SRR6145060	Methylococcus capsulatus	414	S	22	1	23	0.00000
SRR6145060	Marinobacter sp. CP1	1671721	S	22	23	45	0.00001
SRR6145060	Legionella sainthelensi	28087	S	21	2	23	0.00000
SRR6145060	Leadbetterella byssophila	316068	S	22	1	23	0.00000
SRR6145060	Lachnospira eligens	39485	S	23	0	23	0.00000
SRR6145060	Kerstersia gyiorum	206506	S	22	1	23	0.00000
SRR6145060	Helicobacter cholecystus	45498	S	23	0	23	0.00000
SRR6145060	Haloferax gibbonsii	35746	S	20	3	23	0.00000
SRR6145060	Gordonibacter pamelaeae	471189	S	15	8	23	0.00000
SRR6145060	Elizabethkingia ursingii	1756150	S	20	3	23	0.00000
SRR6145060	Crocosphaera subtropica	2546360	S	20	3	23	0.00000
SRR6145060	Clostridium scatologenes	1548	S	18	5	23	0.00000
SRR6145060	Campylobacter corcagiensis	1448857	S	23	0	23	0.00000
SRR6145060	Aquitalea denitrificans	519081	S	18	5	23	0.00000
SRR6145060	Anabaena sp. WA102	1647413	S	15	23	38	0.00001
SRR6145060	Altererythrobacter sp. NS1	2338327	S	154	23	177	0.00002
SRR6145060	Altererythrobacter sp. B11	2060312	S	94	23	117	0.00002
SRR6145060	Altererythrobacter ishigakiensis	476157	S	23	0	23	0.00000
SRR6145060	Acidothermus cellulolyticus	28049	S	23	0	23	0.00000
SRR6145060	Xanthomonas axonopodis	53413	S	15	7	22	0.00000
SRR6145060	Thermochromatium tepidum	1050	S	22	0	22	0.00000
SRR6145060	Streptococcus ferus	1345	S	22	0	22	0.00000
SRR6145060	Steroidobacter denitrificans	465721	S	21	1	22	0.00000
SRR6145060	Staphylococcus agnetis	985762	S	21	1	22	0.00000
SRR6145060	Serratia rubidaea	61652	S	16	6	22	0.00000
SRR6145060	Pseudonocardia sp. Gen01	2736640	S	427	22	449	0.00006
SRR6145060	Pseudomonas sp. SWI6	2083051	S	2	22	24	0.00000
SRR6145060	Pseudomonas sp. R2-60-08W	1173280	S	4	22	26	0.00000
SRR6145060	Pseudomonas sp. CFSAN084952	2664899	S	10	22	32	0.00000
SRR6145060	Pseudomonas sp. CCOS 191	1649877	S	22	5	27	0.00000
SRR6145060	Pseudomonas cedrina	651740	S	19	3	22	0.00000
SRR6145060	Pseudomonas antarctica	219572	S	20	2	22	0.00000
SRR6145060	Pedobacter steynii	430522	S	21	1	22	0.00000
SRR6145060	Pediococcus pentosaceus	1255	S	21	1	22	0.00000
SRR6145060	Pasteurella dagmatis	754	S	22	0	22	0.00000
SRR6145060	Pandoraea oxalativorans	573737	S	17	5	22	0.00000
SRR6145060	Olivibacter sp. LS-1	2592345	S	6	22	28	0.00000
SRR6145060	Neisseria zoodegmatis	326523	S	21	1	22	0.00000
SRR6145060	Neisseria zalophi	640030	S	22	0	22	0.00000
SRR6145060	Microcoleus sp. PCC 7113	1173027	S	22	6	28	0.00000
SRR6145060	Marivirga tractuosa	1006	S	20	2	22	0.00000
SRR6145060	Hymenobacter sp. DG01	2584940	S	97	22	119	0.00002
SRR6145060	Hymenobacter sp. BRD72	2615203	S	55	22	77	0.00001
SRR6145060	Haloterrigena daqingensis	588898	S	21	1	22	0.00000
SRR6145060	Halalkalicoccus jeotgali	413810	S	22	0	22	0.00000
SRR6145060	Geosporobacter ferrireducens	1424294	S	22	0	22	0.00000
SRR6145060	Flavobacterium kingsejongi	1678728	S	22	0	22	0.00000
SRR6145060	Flavobacterium branchiophilum	55197	S	22	0	22	0.00000
SRR6145060	Fermentimonas caenicola	1562970	S	20	2	22	0.00000
SRR6145060	Dickeya dadantii	204038	S	21	1	22	0.00000
SRR6145060	Devriesea agamarum	472569	S	22	0	22	0.00000
SRR6145060	Dechloromonas aromatica	259537	S	22	0	22	0.00000
SRR6145060	Cyanobium gracile	59930	S	20	2	22	0.00000
SRR6145060	Cohnella candidum	2674991	S	22	0	22	0.00000
SRR6145060	Clostridium isatidis	182773	S	22	0	22	0.00000
SRR6145060	Clostridium bornimense	1216932	S	22	0	22	0.00000
SRR6145060	Clostridium argentinense	29341	S	22	0	22	0.00000
SRR6145060	Chryseolinea soli	2321403	S	22	0	22	0.00000
SRR6145060	Burkholderia anthina	179879	S	15	7	22	0.00000
SRR6145060	Brucella pinnipedialis	120576	S	1	21	22	0.00000
SRR6145060	Brevibacillus laterosporus	1465	S	14	8	22	0.00000
SRR6145060	Brachyspira hyodysenteriae	159	S	18	4	22	0.00000
SRR6145060	Belliella baltica	232259	S	22	0	22	0.00000
SRR6145060	Bacillus clausii	79880	S	22	0	22	0.00000
SRR6145060	Aquitalea magnusonii	332411	S	17	5	22	0.00000
SRR6145060	Aminobacter sp. MSH1	374606	S	78	22	100	0.00001
SRR6145060	Alkalilimnicola ehrlichii	351052	S	22	0	22	0.00000
SRR6145060	Alicyclobacillus acidocaldarius	405212	S	22	0	22	0.00000
SRR6145060	Agrococcus sp. SGAir0287	2070347	S	143	22	165	0.00002
SRR6145060	Actinomyces sp. Z16	2079536	S	89	22	111	0.00001
SRR6145060	Acidimicrobium ferrooxidans	53635	S	22	0	22	0.00000
SRR6145060	Xanthomonas cassavae	56450	S	19	2	21	0.00000
SRR6145060	Vibrio metoecus	1481663	S	16	5	21	0.00000
SRR6145060	Verrucomicrobium spinosum	2736	S	20	1	21	0.00000
SRR6145060	Vagococcus teuberi	519472	S	20	1	21	0.00000
SRR6145060	Thiocystis violascens	73141	S	21	0	21	0.00000
SRR6145060	Thalassospira xiamenensis	220697	S	20	1	21	0.00000
SRR6145060	Tenacibaculum mesophilum	104268	S	16	5	21	0.00000
SRR6145060	Tenacibaculum maritimum	107401	S	21	0	21	0.00000
SRR6145060	Sutterella megalosphaeroides	2494234	S	19	2	21	0.00000
SRR6145060	Sulfitobacter sp. THAF37	2587855	S	45	21	66	0.00001
SRR6145060	Streptomyces sp. S1D4-20	2594462	S	2	21	23	0.00000
SRR6145060	Streptococcus himalayensis	1888195	S	21	0	21	0.00000
SRR6145060	Staphylococcus sp. SDB 2975	2044912	S	21	2	23	0.00000
SRR6145060	Staphylococcus phage StB20	1147043	S	10	21	31	0.00000
SRR6145060	Sphingobacterium sp. CZ-2	2557994	S	204	21	225	0.00003
SRR6145060	Snodgrassella alvi	1196083	S	21	0	21	0.00000
SRR6145060	Serratia symbiotica	138074	S	21	0	21	0.00000
SRR6145060	Scytonema sp. NIES-4073	2005464	S	38	21	59	0.00001
SRR6145060	Romboutsia hominis	1507512	S	21	0	21	0.00000
SRR6145060	Raphidiopsis curvata	312883	S	18	3	21	0.00000
SRR6145060	Psychrobacter urativorans	45610	S	21	0	21	0.00000
SRR6145060	Pseudomonas yamanorum	515393	S	19	2	21	0.00000
SRR6145060	Pseudomonas sp. LTJR-52	2479392	S	102	21	123	0.00002
SRR6145060	Pseudomonas cichorii	36746	S	21	0	21	0.00000
SRR6145060	Pseudodesulfovibrio aespoeensis	182210	S	19	2	21	0.00000
SRR6145060	Propionibacterium virus SKKY	1982305	S	19	21	40	0.00001
SRR6145060	Propionibacterium virus PHL116M00	1982288	S	56	21	77	0.00001
SRR6145060	Propionibacterium virus P1001	1982263	S	14	21	35	0.00000
SRR6145060	Pontibacter akesuensis	388950	S	20	1	21	0.00000
SRR6145060	Plesiomonas shigelloides	703	S	21	0	21	0.00000
SRR6145060	Pedobacter heparinus	984	S	20	1	21	0.00000
SRR6145060	Pediococcus acidilactici	1254	S	21	0	21	0.00000
SRR6145060	Owenweeksia hongkongensis	253245	S	21	0	21	0.00000
SRR6145060	Ochrobactrum pituitosum	571256	S	14	7	21	0.00000
SRR6145060	Nonlabens spongiae	331648	S	21	0	21	0.00000
SRR6145060	Nitrospira moscoviensis	42253	S	21	0	21	0.00000
SRR6145060	Micromonospora sp. WMMA2032	2039870	S	75	21	96	0.00001
SRR6145060	Micromonospora sp. B006	2201999	S	48	21	69	0.00001
SRR6145060	Methylocaldum marinum	1432792	S	21	0	21	0.00000
SRR6145060	Lactobacillus hordei	468911	S	20	1	21	0.00000
SRR6145060	Histophilus somni	731	S	20	1	21	0.00000
SRR6145060	Haloferax alexandrinus	114529	S	7	14	21	0.00000
SRR6145060	Fluviibacterium aquatile	2552766	S	19	2	21	0.00000
SRR6145060	Flavobacterium pallidum	2172098	S	21	0	21	0.00000
SRR6145060	Filimonas lacunae	477680	S	21	0	21	0.00000
SRR6145060	Ferrimonas balearica	44012	S	21	0	21	0.00000
SRR6145060	Exiguobacterium sp. U13-1	1849031	S	10	21	31	0.00000
SRR6145060	Dolichospermum flos-aquae	1166	S	2	19	21	0.00000
SRR6145060	Desulfovibrio carbinoliphilus	345370	S	21	0	21	0.00000
SRR6145060	Cronobacter dublinensis	413497	S	19	2	21	0.00000
SRR6145060	Cobetia marina	28258	S	4	17	21	0.00000
SRR6145060	Clostridium sp. MF28	1702238	S	5	21	26	0.00000
SRR6145060	Cellulomonas sp. PSBB021	2003551	S	126	21	147	0.00002
SRR6145060	Caulobacter sp. K31	366602	S	122	21	143	0.00002
SRR6145060	Casimicrobium huifangae	2591109	S	19	2	21	0.00000
SRR6145060	Brevundimonas sp. MF30-B	2561924	S	539	21	560	0.00007
SRR6145060	Brevibacillus brevis	1393	S	20	1	21	0.00000
SRR6145060	Brachyspira murdochii	84378	S	19	2	21	0.00000
SRR6145060	Bordetella parapertussis	519	S	3	18	21	0.00000
SRR6145060	Bartonella apis	1686310	S	21	0	21	0.00000
SRR6145060	Bacillus thermoamylovorans	35841	S	21	0	21	0.00000
SRR6145060	Bacillus safensis	561879	S	20	1	21	0.00000
SRR6145060	Bacillus coagulans	1398	S	21	0	21	0.00000
SRR6145060	Arthrobacter sp. UKPF54-2	2600159	S	63	21	84	0.00001
SRR6145060	Arenibacter algicola	616991	S	21	0	21	0.00000
SRR6145060	Arcobacter mytili	603050	S	21	0	21	0.00000
SRR6145060	Aliiarcobacter faecis	1564138	S	21	0	21	0.00000
SRR6145060	Agrobacterium sp. H13-3	861208	S	8	21	29	0.00000
SRR6145060	Wenzhouxiangella marina	1579979	S	20	0	20	0.00000
SRR6145060	Vibrio harveyi	669	S	15	5	20	0.00000
SRR6145060	Thioflavicoccus mobilis	80679	S	20	0	20	0.00000
SRR6145060	Thioalkalivibrio versutus	106634	S	19	1	20	0.00000
SRR6145060	Sulfurivermis fontis	1972068	S	18	2	20	0.00000
SRR6145060	Streptomyces sp. RLB3-17	2594455	S	4	20	24	0.00000
SRR6145060	Streptomyces sp. ICC1	2099583	S	1	20	21	0.00000
SRR6145060	Stenotrophomonas sp. SAU14A_NAIMI4_5	2072413	S	58	20	78	0.00001
SRR6145060	Solibacillus silvestris	76853	S	20	0	20	0.00000
SRR6145060	Shigella flexneri	623	S	2	18	20	0.00000
SRR6145060	Scandinavium goeteborgense	1851514	S	20	0	20	0.00000
SRR6145060	Salmonella sp. SSDFZ54	2500542	S	1	20	21	0.00000
SRR6145060	Roseobacter litoralis	42443	S	17	3	20	0.00000
SRR6145060	Raoultella electrica	1259973	S	17	3	20	0.00000
SRR6145060	Psychroflexus torquis	57029	S	20	0	20	0.00000
SRR6145060	Psychrobacter sp. YP14	2203895	S	31	20	51	0.00001
SRR6145060	Pseudomonas vancouverensis	95300	S	20	0	20	0.00000
SRR6145060	Pseudomonas sp. Os17	1500686	S	10	20	30	0.00000
SRR6145060	Pseudomonas sp. FGI182	1259844	S	32	20	52	0.00001
SRR6145060	Pseudomonas extremaustralis	359110	S	19	1	20	0.00000
SRR6145060	Pepper chlorotic spot virus	1414655	S	20	0	20	0.00000
SRR6145060	Pedobacter sp. PACM 27299	1727164	S	20	2	22	0.00000
SRR6145060	Parolsenella catena	2003188	S	10	10	20	0.00000
SRR6145060	Pandoraea sputorum	93222	S	16	4	20	0.00000
SRR6145060	Oceanobacillus iheyensis	182710	S	20	0	20	0.00000
SRR6145060	Nostoc punctiforme	272131	S	12	8	20	0.00000
SRR6145060	Nibricoccus aquaticus	2576891	S	20	0	20	0.00000
SRR6145060	Niabella soli	446683	S	20	0	20	0.00000
SRR6145060	Mycobacterium lepraemurium	64667	S	18	2	20	0.00000
SRR6145060	Moraxella cuniculi	34061	S	20	0	20	0.00000
SRR6145060	Mariprofundus aestuarium	1921086	S	20	0	20	0.00000
SRR6145060	Komagataeibacter rhaeticus	215221	S	2	18	20	0.00000
SRR6145060	Hymenobacter sp. 17J36-26	2496028	S	12	20	32	0.00000
SRR6145060	Hydrogenophaga sp. PBL-H3	434010	S	62	20	82	0.00001
SRR6145060	Halostella pelagica	2583824	S	17	3	20	0.00000
SRR6145060	Halomonas venusta	44935	S	18	2	20	0.00000
SRR6145060	Gottschalkia acidurici	1556	S	20	0	20	0.00000
SRR6145060	Geminocystis herdmanii	669359	S	19	1	20	0.00000
SRR6145060	Geitlerinema sp. PCC 7407	1173025	S	20	5	25	0.00000
SRR6145060	Flavonifractor plautii	292800	S	19	1	20	0.00000
SRR6145060	Flammeovirga pectinis	2494373	S	20	0	20	0.00000
SRR6145060	Draconibacterium orientale	1168034	S	19	1	20	0.00000
SRR6145060	Dickeya chrysanthemi	556	S	20	0	20	0.00000
SRR6145060	Desulfovibrio marinus	370038	S	20	0	20	0.00000
SRR6145060	Desulfovibrio carbinolicus	296842	S	19	1	20	0.00000
SRR6145060	Cylindrospermum stagnale	142864	S	18	2	20	0.00000
SRR6145060	Cryobacterium sp. GCJ02	2220095	S	51	20	71	0.00001
SRR6145060	Clostridium septicum	1504	S	20	0	20	0.00000
SRR6145060	Citrobacter braakii	57706	S	7	13	20	0.00000
SRR6145060	Calothrix sp. PCC 7507	99598	S	20	15	35	0.00000
SRR6145060	Burkholderia diffusa	488732	S	14	6	20	0.00000
SRR6145060	Brachyspira hampsonii	1287055	S	18	2	20	0.00000
SRR6145060	Bifidobacterium gallinarum	78344	S	19	1	20	0.00000
SRR6145060	Bacillus mycoides	1405	S	18	2	20	0.00000
SRR6145060	Bacillus anthracis	1392	S	10	10	20	0.00000
SRR6145060	Alcanivorax borkumensis	59754	S	2	18	20	0.00000
SRR6145060	Agarilytica rhodophyticola	1737490	S	20	0	20	0.00000
SRR6145060	Aeromicrobium sp. 592	2079793	S	106	20	126	0.00002
SRR6145060	Acidihalobacter ferrooxidans	1765967	S	20	0	20	0.00000
SRR6145060	Acetobacter sp. KACC 21233	2592655	S	20	0	20	0.00000
SRR6145060	Yersinia kristensenii	28152	S	6	13	19	0.00000
SRR6145060	Vagococcus penaei	633807	S	18	1	19	0.00000
SRR6145060	Synechococcus sp. PCC 7336	195250	S	19	0	19	0.00000
SRR6145060	Streptomyces sp. endophyte_N2	2153485	S	27	19	46	0.00001
SRR6145060	Streptomyces sp. CB09001	2083284	S	45	19	64	0.00001
SRR6145060	Streptococcus merionis	400065	S	19	0	19	0.00000
SRR6145060	Sphingobium sp. SYK-6	627192	S	120	19	139	0.00002
SRR6145060	Robiginitalea biformata	252307	S	19	0	19	0.00000
SRR6145060	Rippkaea orientalis	2546366	S	18	1	19	0.00000
SRR6145060	Pseudomonas umsongensis	198618	S	19	0	19	0.00000
SRR6145060	Pseudomonas sp. XWY-1	2069256	S	12	19	31	0.00000
SRR6145060	Pseudomonas sp. 14181154	2662033	S	42	19	61	0.00001
SRR6145060	Pseudomonas mucidolens	46679	S	18	1	19	0.00000
SRR6145060	Pseudolysobacter antarcticus	2511995	S	19	0	19	0.00000
SRR6145060	Pseudodesulfovibrio indicus	1716143	S	18	1	19	0.00000
SRR6145060	Propionibacterium virus ATCC29399BT	1982253	S	10	19	29	0.00000
SRR6145060	Pistricoccus aurantiacus	1883414	S	19	0	19	0.00000
SRR6145060	Peptacetobacter hiranonis	89152	S	19	0	19	0.00000
SRR6145060	Pectobacterium odoriferum	78398	S	12	7	19	0.00000
SRR6145060	Nostoc flagelliforme	1306274	S	14	5	19	0.00000
SRR6145060	Neisseriaceae bacterium DSM 100970	2052837	S	19	0	19	0.00000
SRR6145060	Natronolimnobius aegyptiacus	745377	S	19	0	19	0.00000
SRR6145060	Microbacterium sp. 10M-3C3	2483401	S	172	19	191	0.00003
SRR6145060	Methylobacterium sp. 4-46	426117	S	461	19	480	0.00006
SRR6145060	Melaminivora sp. SC2-9	2109913	S	75	19	94	0.00001
SRR6145060	Megasphaera elsdenii	907	S	18	1	19	0.00000
SRR6145060	Mahella australiensis	252966	S	19	0	19	0.00000
SRR6145060	Lactobacillus amylovorus	1604	S	18	1	19	0.00000
SRR6145060	Kosakonia oryzae	497725	S	12	7	19	0.00000
SRR6145060	Jonquetella anthropi	428712	S	19	0	19	0.00000
SRR6145060	Janthinobacterium sp. 1_2014MBL_MicDiv	1644131	S	63	19	82	0.00001
SRR6145060	Halomicrobium mukohataei	57705	S	16	3	19	0.00000
SRR6145060	Halobacterium salinarum	2242	S	18	1	19	0.00000
SRR6145060	Geobacter bemidjiensis	225194	S	17	2	19	0.00000
SRR6145060	Fluviicola taffensis	191579	S	19	0	19	0.00000
SRR6145060	Desulfovibrio magneticus	184917	S	19	0	19	0.00000
SRR6145060	Cyclobacterium marinum	104	S	18	1	19	0.00000
SRR6145060	Cronobacter turicensis	413502	S	16	3	19	0.00000
SRR6145060	Clostridium acetobutylicum	1488	S	19	0	19	0.00000
SRR6145060	Citrobacter werkmanii	67827	S	12	7	19	0.00000
SRR6145060	Citrobacter portucalensis	1639133	S	10	9	19	0.00000
SRR6145060	Chryseobacterium sp. G0162	2487063	S	56	19	75	0.00001
SRR6145060	Changchengzhania lutea	2049305	S	19	0	19	0.00000
SRR6145060	Cellulophaga baltica	76594	S	19	0	19	0.00000
SRR6145060	Capnocytophaga cynodegmi	28189	S	17	2	19	0.00000
SRR6145060	Brachyspira intermedia	84377	S	17	2	19	0.00000
SRR6145060	Bordetella genomosp. 6	463024	S	14	19	33	0.00000
SRR6145060	Bifidobacterium choerinum	35760	S	19	0	19	0.00000
SRR6145060	Beijerinckia indica	533	S	19	0	19	0.00000
SRR6145060	Bacteroides helcogenes	290053	S	19	0	19	0.00000
SRR6145060	Bacteroides caecimuris	1796613	S	12	7	19	0.00000
SRR6145060	Bacillus filamentosus	1402861	S	19	0	19	0.00000
SRR6145060	Arcobacter nitrofigilis	28199	S	19	0	19	0.00000
SRR6145060	Antarcticibacterium sp. PAMC 28998	2585771	S	19	0	19	0.00000
SRR6145060	Alistipes megaguti	2364787	S	15	4	19	0.00000
SRR6145060	Aeromonas schubertii	652	S	19	0	19	0.00000
SRR6145060	Aeromonas encheleia	73010	S	18	1	19	0.00000
SRR6145060	Aeromicrobium sp. MF47	2662028	S	104	19	123	0.00002
SRR6145060	Aeribacillus pallidus	33936	S	19	0	19	0.00000
SRR6145060	Actinomyces sp. dk561	2560010	S	73	19	92	0.00001
SRR6145060	haloarchaeon 3A1-DGR	1071085	S	17	1	18	0.00000
SRR6145060	[Enterobacter] lignolyticus	1334193	S	18	0	18	0.00000
SRR6145060	Zobellia galactanivorans	63186	S	18	0	18	0.00000
SRR6145060	Vibrio scophthalmi	45658	S	17	1	18	0.00000
SRR6145060	Vibrio owensii	696485	S	12	6	18	0.00000
SRR6145060	Vibrio metschnikovii	28172	S	18	0	18	0.00000
SRR6145060	Thalassospira indica	1891279	S	17	1	18	0.00000
SRR6145060	Tenacibaculum todarodis	1850252	S	18	0	18	0.00000
SRR6145060	Sulfuricella denitrificans	649841	S	18	0	18	0.00000
SRR6145060	Streptomyces sp. SGAir0924	2109593	S	13	18	31	0.00000
SRR6145060	Streptomyces sp. S1D4-23	2594463	S	1	18	19	0.00000
SRR6145060	Streptomyces sp. NEAU-S7GS2	2202000	S	30	18	48	0.00001
SRR6145060	Streptococcus phage phiARI0131-2	1701814	S	1	18	19	0.00000
SRR6145060	Sphaerospermopsis kisseleviana	289435	S	15	3	18	0.00000
SRR6145060	Shimwellia blattae	563	S	18	0	18	0.00000
SRR6145060	Scytonema sp. HK-05	1137095	S	37	18	55	0.00001
SRR6145060	Rivularia sp. PCC 7116	373994	S	18	1	19	0.00000
SRR6145060	Rhizobium sp. JKLM12A2	2583231	S	9	18	27	0.00000
SRR6145060	Pseudomonas xanthomarina	271420	S	18	0	18	0.00000
SRR6145060	Pseudomonas sp. TKP	1415630	S	11	18	29	0.00000
SRR6145060	Pseudomonas sp. SWI36	2083052	S	10	18	28	0.00000
SRR6145060	Pseudomonas soli	1306993	S	7	11	18	0.00000
SRR6145060	Pseudomonas poae	200451	S	15	3	18	0.00000
SRR6145060	Pseudomonas amygdali	47877	S	8	10	18	0.00000
SRR6145060	Pseudarthrobacter sp. NIBRBAC000502770	2590785	S	11	18	29	0.00000
SRR6145060	Propionibacterium virus PHL179M00	1982298	S	19	18	37	0.00000
SRR6145060	Propionibacterium virus PHL132N00	1982291	S	16	18	34	0.00000
SRR6145060	Propionibacterium phage PAC1	1690805	S	16	18	34	0.00000
SRR6145060	Pontibacter actiniarum	323450	S	16	2	18	0.00000
SRR6145060	Permianibacter aggregans	1510150	S	18	0	18	0.00000
SRR6145060	Paracoccus sp. 2251	2560053	S	337	18	355	0.00005
SRR6145060	Paraclostridium bifermentans	1490	S	18	0	18	0.00000
SRR6145060	Paeniclostridium sordellii	1505	S	18	0	18	0.00000
SRR6145060	Paenibacillus stellifer	169760	S	18	0	18	0.00000
SRR6145060	Ornithinimicrobium sp. AMA3305	2283195	S	226	18	244	0.00003
SRR6145060	Nitrosomonas communis	44574	S	18	0	18	0.00000
SRR6145060	Mycoplasma capricolum	2095	S	9	9	18	0.00000
SRR6145060	Mucinivorans hirudinis	1433126	S	18	0	18	0.00000
SRR6145060	Mucilaginibacter xinganensis	1234841	S	18	0	18	0.00000
SRR6145060	Microvirga sp. HR1	2651334	S	112	18	130	0.00002
SRR6145060	Micromonospora sp. L5	648999	S	2	18	20	0.00000
SRR6145060	Methylomicrobium album	39775	S	18	0	18	0.00000
SRR6145060	Meiothermus ruber	277	S	18	0	18	0.00000
SRR6145060	Klebsiella sp. MPUS7	2697371	S	2	18	20	0.00000
SRR6145060	Klebsiella quasivariicola	2026240	S	3	15	18	0.00000
SRR6145060	Jeotgalibaca ciconiae	2496265	S	17	1	18	0.00000
SRR6145060	Halomonas sp. PA16-9	2576841	S	29	18	47	0.00001
SRR6145060	Francisella tularensis	263	S	16	2	18	0.00000
SRR6145060	Fibrobacter succinogenes	833	S	18	0	18	0.00000
SRR6145060	Duncaniella dubosii	2518971	S	16	2	18	0.00000
SRR6145060	Desulfovibrio alaskensis	58180	S	14	4	18	0.00000
SRR6145060	Desulfomicrobium orale	132132	S	18	0	18	0.00000
SRR6145060	Clostridium aceticum	84022	S	18	0	18	0.00000
SRR6145060	Citromicrobium sp. JL477	1634516	S	79	18	97	0.00001
SRR6145060	Citrobacter farmeri	67824	S	14	4	18	0.00000
SRR6145060	Cellulophaga algicola	59600	S	18	0	18	0.00000
SRR6145060	Catenovulum sediminis	1740262	S	18	0	18	0.00000
SRR6145060	Brevundimonas sp. M20	2591463	S	476	18	494	0.00007
SRR6145060	Bifidobacterium dentium	1689	S	18	0	18	0.00000
SRR6145060	Bifidobacterium animalis	28025	S	18	0	18	0.00000
SRR6145060	Bacteroides coprosuis	151276	S	18	0	18	0.00000
SRR6145060	Arcobacter lanthieri	1355374	S	18	0	18	0.00000
SRR6145060	Arcobacter aquimarinus	1315211	S	16	2	18	0.00000
SRR6145060	Arachidicoccus ginsenosidivorans	496057	S	18	0	18	0.00000
SRR6145060	Ancylobacter sp. TS-1	1850374	S	79	18	97	0.00001
SRR6145060	Alistipes communis	2585118	S	15	3	18	0.00000
SRR6145060	Agromyces sp. LHK192	2498704	S	125	18	143	0.00002
SRR6145060	[Haemophilus] ducreyi	730	S	17	0	17	0.00000
SRR6145060	[Clostridium] scindens	29347	S	16	1	17	0.00000
SRR6145060	Yersinia frederiksenii	29484	S	12	5	17	0.00000
SRR6145060	Xanthomonas gardneri	90270	S	4	13	17	0.00000
SRR6145060	Woeseia oceani	1548547	S	17	0	17	0.00000
SRR6145060	Tolypothrix sp. PCC 7910	2099387	S	17	14	31	0.00000
SRR6145060	Tardiphaga sp. vice352	2592816	S	1	17	18	0.00000
SRR6145060	Streptomyces sp. S8	1837283	S	25	17	42	0.00001
SRR6145060	Streptococcus acidominimus	1326	S	16	1	17	0.00000
SRR6145060	Sterolibacterium denitrificans	157592	S	17	0	17	0.00000
SRR6145060	Stenotrophomonas sp. YAU14A_MKIMI4_1	2072408	S	4	17	21	0.00000
SRR6145060	Stenotrophomonas sp. SAU14A_NAIMI4_8	2072409	S	4	17	21	0.00000
SRR6145060	Stenotrophomonas sp. LM091	1904944	S	84	17	101	0.00001
SRR6145060	Staphylococcus muscae	1294	S	17	0	17	0.00000
SRR6145060	Salinibaculum litoreum	1710541	S	14	3	17	0.00000
SRR6145060	Ruthenibacterium lactatiformans	1550024	S	16	1	17	0.00000
SRR6145060	Roseobacter ponti	1891787	S	17	0	17	0.00000
SRR6145060	Roseiflexus castenholzii	120962	S	16	1	17	0.00000
SRR6145060	Rhodobiaceae bacterium	2026785	S	17	0	17	0.00000
SRR6145060	Pseudobacter ginsenosidimutans	661488	S	17	0	17	0.00000
SRR6145060	Pseudoarcobacter acticola	1849015	S	17	0	17	0.00000
SRR6145060	Planctomycetes bacterium	2026780	S	17	0	17	0.00000
SRR6145060	Pectobacterium parmentieri	1905730	S	13	4	17	0.00000
SRR6145060	Orientia tsutsugamushi	784	S	17	0	17	0.00000
SRR6145060	Nocardioides sp. SB3-45	2558918	S	222	17	239	0.00003
SRR6145060	Nocardioides sp. HY056	2500546	S	118	17	135	0.00002
SRR6145060	Mucilaginibacter ginsenosidivorax	862126	S	17	0	17	0.00000
SRR6145060	Mesorhizobium sp. M1E.F.Ca.ET.045.02.1.1	2493672	S	38	17	55	0.00001
SRR6145060	Lelliottia nimipressuralis	69220	S	14	3	17	0.00000
SRR6145060	Lactobacillus curieae	1138822	S	17	0	17	0.00000
SRR6145060	Lactobacillus brevis	1580	S	16	1	17	0.00000
SRR6145060	Komagataeibacter medellinensis	1177712	S	15	2	17	0.00000
SRR6145060	Ignavibacterium album	591197	S	17	0	17	0.00000
SRR6145060	Hyphomonas neptunium	81032	S	16	1	17	0.00000
SRR6145060	Halothece sp. PCC 7418	65093	S	17	12	29	0.00000
SRR6145060	Gloeothece verrucosa	2546359	S	16	1	17	0.00000
SRR6145060	Gloeobacter kilaueensis	1416614	S	17	0	17	0.00000
SRR6145060	Enterococcus avium	33945	S	16	1	17	0.00000
SRR6145060	Enterobacteriaceae bacterium A-F18	2045202	S	6	17	23	0.00000
SRR6145060	Enterobacter sichuanensis	2071710	S	12	5	17	0.00000
SRR6145060	Cyclobacterium amurskyense	320787	S	16	1	17	0.00000
SRR6145060	Clostridium estertheticum	238834	S	17	0	17	0.00000
SRR6145060	Brevibacillus agri	51101	S	17	0	17	0.00000
SRR6145060	Brachybacterium sp. P6-10-X1	1903186	S	256	17	273	0.00004
SRR6145060	Bdellovibrio exovorus	453816	S	17	0	17	0.00000
SRR6145060	Bacillus lentus	1467	S	17	0	17	0.00000
SRR6145060	Asaia bogorensis	91915	S	17	0	17	0.00000
SRR6145060	Arthrobacter citreus	1670	S	17	0	17	0.00000
SRR6145060	Arcobacter venerupis	1054033	S	17	0	17	0.00000
SRR6145060	Arcobacter ellisii	913109	S	16	1	17	0.00000
SRR6145060	Anseongella ginsenosidimutans	496056	S	17	0	17	0.00000
SRR6145060	Amycolatopsis sp. BJA-103	1911175	S	77	17	94	0.00001
SRR6145060	Acetobacter senegalensis	446692	S	13	4	17	0.00000
SRR6145060	Yersinia pestis	632	S	2	14	16	0.00000
SRR6145060	Xylanimicrobium sp. FW10M-9	2509457	S	88	16	104	0.00001
SRR6145060	Xenorhabdus bovienii	40576	S	15	1	16	0.00000
SRR6145060	Vibrio navarrensis	29495	S	13	3	16	0.00000
SRR6145060	Vibrio mimicus	674	S	14	2	16	0.00000
SRR6145060	Tumebacillus algifaecis	1214604	S	16	0	16	0.00000
SRR6145060	Trichormus azollae	1164	S	14	2	16	0.00000
SRR6145060	Thermomonas sp. HDW16	2714945	S	145	16	161	0.00002
SRR6145060	Synechococcus sp. PCC 7502	1173263	S	16	0	16	0.00000
SRR6145060	Sulfuriferula plumbiphila	171865	S	16	0	16	0.00000
SRR6145060	Streptomyces sp. SYP-A7193	2662065	S	54	16	70	0.00001
SRR6145060	Streptomyces sp. Go-475	2072505	S	69	16	85	0.00001
SRR6145060	Streptococcus iniae	1346	S	16	0	16	0.00000
SRR6145060	Staphylococcus virus SEP1	1980930	S	15	16	31	0.00000
SRR6145060	Staphylococcus stepanovicii	643214	S	16	0	16	0.00000
SRR6145060	Staphylococcus piscifermentans	70258	S	15	1	16	0.00000
SRR6145060	Staphylococcus phage StB20-like	1732064	S	1	16	17	0.00000
SRR6145060	Shewanella japonica	93973	S	16	0	16	0.00000
SRR6145060	Serinicoccus sp. W204	2593973	S	123	16	139	0.00002
SRR6145060	Salinivirga cyanobacteriivorans	1307839	S	16	0	16	0.00000
SRR6145060	Roseobacter denitrificans	2434	S	14	2	16	0.00000
SRR6145060	Rhizobium sp. NIBRBAC000502774	2590777	S	11	16	27	0.00000
SRR6145060	Rathayibacter sp. VKM Ac-2805	2609258	S	16	41	57	0.00001
SRR6145060	Psychrobacter arcticus	334543	S	16	0	16	0.00000
SRR6145060	Pseudomonas sp. S09G 359	2054919	S	16	1	17	0.00000
SRR6145060	Pseudoalteromonas piscicida	43662	S	15	1	16	0.00000
SRR6145060	Propionibacterium virus Wizzo	1982308	S	21	16	37	0.00000
SRR6145060	Propionibacterium virus PHL060L00	1982277	S	14	16	30	0.00000
SRR6145060	Propionibacterium phage PA1-14	1747271	S	21	16	37	0.00000
SRR6145060	Paraburkholderia sp. Msb3	2604047	S	71	16	87	0.00001
SRR6145060	Paludibacter propionicigenes	185300	S	16	0	16	0.00000
SRR6145060	Paenibacillus xylanilyticus	248903	S	16	0	16	0.00000
SRR6145060	Paenibacillus glucanolyticus	59843	S	8	8	16	0.00000
SRR6145060	Olsenella umbonata	604330	S	15	1	16	0.00000
SRR6145060	Olsenella uli	133926	S	16	0	16	0.00000
SRR6145060	Nostoc sp. PCC 7524	28072	S	16	3	19	0.00000
SRR6145060	Nitrosomonas europaea	915	S	16	0	16	0.00000
SRR6145060	Mycoplasma hominis	2098	S	16	0	16	0.00000
SRR6145060	Mycobacterium sp. ELW1	1547487	S	92	16	108	0.00001
SRR6145060	Mesorhizobium sp. M9A.F.Ca.ET.002.03.1.2	2493668	S	35	16	51	0.00001
SRR6145060	Marinobacter sp. LQ44	1749259	S	26	16	42	0.00001
SRR6145060	Marinithermus hydrothermalis	186192	S	16	0	16	0.00000
SRR6145060	Maricaulis maris	74318	S	16	0	16	0.00000
SRR6145060	Labrenzia alexandrii	388408	S	15	1	16	0.00000
SRR6145060	Kushneria konosiri	698828	S	14	2	16	0.00000
SRR6145060	Janthinobacterium sp. LM6	1938606	S	31	16	47	0.00001
SRR6145060	Isosphaera pallida	128	S	16	0	16	0.00000
SRR6145060	Hymenobacter sp. BRD67	2675877	S	43	16	59	0.00001
SRR6145060	Herbinix luporum	1679721	S	15	1	16	0.00000
SRR6145060	Hathewaya histolytica	1498	S	16	0	16	0.00000
SRR6145060	Halostagnicola larsenii	353800	S	16	0	16	0.00000
SRR6145060	Haloplanus aerogenes	660522	S	15	1	16	0.00000
SRR6145060	Haloferax volcanii	2246	S	6	10	16	0.00000
SRR6145060	Hafnia alvei	569	S	10	6	16	0.00000
SRR6145060	Grimontia hollisae	673	S	16	0	16	0.00000
SRR6145060	Gemmatimonas aurantiaca	173480	S	16	0	16	0.00000
SRR6145060	Fusobacterium mortiferum	850	S	16	0	16	0.00000
SRR6145060	Formosa agariphila	320324	S	16	0	16	0.00000
SRR6145060	Flavobacterium gilvum	1492737	S	16	0	16	0.00000
SRR6145060	Flavobacterium crassostreae	1763534	S	16	0	16	0.00000
SRR6145060	Exiguobacterium sp. MH3	1399115	S	41	16	57	0.00001
SRR6145060	Escherichia albertii	208962	S	14	2	16	0.00000
SRR6145060	Edwardsiella tarda	636	S	9	7	16	0.00000
SRR6145060	Desulfosarcina alkanivorans	571177	S	15	1	16	0.00000
SRR6145060	Desulfocurvibacter africanus	873	S	16	0	16	0.00000
SRR6145060	Desulfobulbus oralis	1986146	S	16	0	16	0.00000
SRR6145060	Desulfobacter hydrogenophilus	2291	S	16	0	16	0.00000
SRR6145060	Deferribacter desulfuricans	197162	S	16	0	16	0.00000
SRR6145060	Clostridium cochlearium	1494	S	16	0	16	0.00000
SRR6145060	Cellulomonas sp. Y8	2591145	S	162	16	178	0.00002
SRR6145060	Cellulomonas sp. JZ18	2654191	S	144	16	160	0.00002
SRR6145060	Caldithrix abyssi	187145	S	16	0	16	0.00000
SRR6145060	Burkholderia sp. CCGE1001	640510	S	11	16	27	0.00000
SRR6145060	Brevundimonas sp. LM2	1938605	S	440	16	456	0.00006
SRR6145060	Brenneria goodwinii	1109412	S	11	5	16	0.00000
SRR6145060	Barnesiella viscericola	397865	S	13	3	16	0.00000
SRR6145060	Bacillus freudenreichii	1783501	S	16	0	16	0.00000
SRR6145060	Bacillus ciccensis	1670641	S	16	0	16	0.00000
SRR6145060	Bacillus amyloliquefaciens	1390	S	9	7	16	0.00000
SRR6145060	Arsenophonus nasoniae	638	S	16	0	16	0.00000
SRR6145060	Arcobacter skirrowii	28200	S	14	2	16	0.00000
SRR6145060	Alistipes dispar	2585119	S	12	4	16	0.00000
SRR6145060	Aeromonas dhakensis	196024	S	9	7	16	0.00000
SRR6145060	Actinobacillus suis	716	S	14	2	16	0.00000
SRR6145060	Acidisarcina polymorpha	2211140	S	16	0	16	0.00000
SRR6145060	Acetobacter oryzifermentans	1633874	S	3	13	16	0.00000
SRR6145060	Zoogloeaceae bacteirum Par-f-2	2080469	S	5	15	20	0.00000
SRR6145060	Weissella hellenica	46256	S	14	1	15	0.00000
SRR6145060	Victivallales bacterium CCUG 44730	2094242	S	15	0	15	0.00000
SRR6145060	Vibrio casei	673372	S	14	1	15	0.00000
SRR6145060	Vibrio azureus	512649	S	15	0	15	0.00000
SRR6145060	Thermobacillus composti	377615	S	15	0	15	0.00000
SRR6145060	Tenacibaculum sp. DSM 106434	2358479	S	15	4	19	0.00000
SRR6145060	Staphylococcus lutrae	155085	S	15	0	15	0.00000
SRR6145060	Spiroplasma taiwanense	2145	S	15	0	15	0.00000
SRR6145060	Shewanella sediminis	271097	S	15	0	15	0.00000
SRR6145060	Rodentibacter pneumotropicus	758	S	15	0	15	0.00000
SRR6145060	Rhodocyclaceae bacterium	1898103	S	4	11	15	0.00000
SRR6145060	Pseudomonas kribbensis	1628086	S	14	1	15	0.00000
SRR6145060	Pseudomonas asturiensis	1190415	S	15	0	15	0.00000
SRR6145060	Pseudoalteromonas phenolica	161398	S	15	0	15	0.00000
SRR6145060	Pseudoalteromonas agarivorans	176102	S	7	8	15	0.00000
SRR6145060	Proteiniphilum saccharofermentans	1642647	S	14	1	15	0.00000
SRR6145060	Propionibacterium virus Solid	1982306	S	20	15	35	0.00000
SRR6145060	Propionibacterium virus PHL152M00	1982295	S	53	15	68	0.00001
SRR6145060	Propionibacterium virus P1.1	1982264	S	14	15	29	0.00000
SRR6145060	Planctomycetes bacterium Mal35	2527993	S	2	15	17	0.00000
SRR6145060	Petrimonas mucosa	1642646	S	13	2	15	0.00000
SRR6145060	Paenibacillus sp. FSL R7-0331	1536773	S	15	1	16	0.00000
SRR6145060	Olleya aquimaris	639310	S	15	0	15	0.00000
SRR6145060	Nostoc piscinale	224012	S	13	2	15	0.00000
SRR6145060	Natrialba magadii	13769	S	14	1	15	0.00000
SRR6145060	Mycobacterium leprae	1769	S	15	0	15	0.00000
SRR6145060	Muricauda ruestringensis	111501	S	15	0	15	0.00000
SRR6145060	Micromonospora sp. HM134	2583243	S	75	15	90	0.00001
SRR6145060	Methanosarcina mazei	2209	S	15	0	15	0.00000
SRR6145060	Melissococcus plutonius	33970	S	15	0	15	0.00000
SRR6145060	Lysinibacillus timonensis	2086577	S	15	0	15	0.00000
SRR6145060	Luteimonas sp. Gr-4	1176533	S	216	15	231	0.00003
SRR6145060	Lonsdalea britannica	1082704	S	15	0	15	0.00000
SRR6145060	Leptolyngbya sp. PCC 7376	111781	S	15	1	16	0.00000
SRR6145060	Leisingera sp. NJS204	2508307	S	14	15	29	0.00000
SRR6145060	Labrenzia aggregata	187304	S	4	11	15	0.00000
SRR6145060	Kurthia zopfii	1650	S	15	0	15	0.00000
SRR6145060	Ilyobacter polytropus	167642	S	15	0	15	0.00000
SRR6145060	Hydrocarboniclastica marina	2259620	S	15	0	15	0.00000
SRR6145060	Hungatella hathewayi	154046	S	15	0	15	0.00000
SRR6145060	Hungateiclostridium saccincola	1677857	S	15	0	15	0.00000
SRR6145060	Herminiimonas arsenitoxidans	1809410	S	13	2	15	0.00000
SRR6145060	Halorhabdus tiamatea	430914	S	13	2	15	0.00000
SRR6145060	Haloplanus sp. CBA1113	1547899	S	3	15	18	0.00000
SRR6145060	Granulicella mallensis	940614	S	15	0	15	0.00000
SRR6145060	Gramella flava	1486245	S	15	0	15	0.00000
SRR6145060	Gilliamella apicola	1196095	S	14	1	15	0.00000
SRR6145060	Geoalkalibacter subterraneus	483547	S	13	2	15	0.00000
SRR6145060	Francisella philomiragia	28110	S	11	4	15	0.00000
SRR6145060	Euzebyella marina	1761453	S	15	0	15	0.00000
SRR6145060	Erysipelothrix rhusiopathiae	1648	S	13	2	15	0.00000
SRR6145060	Enterococcus saigonensis	1805431	S	14	1	15	0.00000
SRR6145060	Enterococcus hirae	1354	S	14	1	15	0.00000
SRR6145060	Enterococcus gilvus	160453	S	15	0	15	0.00000
SRR6145060	Enterobacter sp. Crenshaw	1977566	S	1	15	16	0.00000
SRR6145060	Desulfovibrio gigas	879	S	15	0	15	0.00000
SRR6145060	Desulfococcus oleovorans	181663	S	15	0	15	0.00000
SRR6145060	Chitinophaga caeni	2029983	S	15	0	15	0.00000
SRR6145060	Cellulosilyticum lentocellum	29360	S	8	7	15	0.00000
SRR6145060	Candidatus Liberibacter asiaticus	34021	S	3	15	18	0.00000
SRR6145060	Candidatus Izimaplasma sp. HR1	1541959	S	15	0	15	0.00000
SRR6145060	Candidatus Atelocyanobacterium thalassa	713887	S	40	15	55	0.00001
SRR6145060	Campylobacter sputorum	206	S	15	0	15	0.00000
SRR6145060	Campylobacter pinnipediorum	1965231	S	15	0	15	0.00000
SRR6145060	Campylobacter hyointestinalis	198	S	15	0	15	0.00000
SRR6145060	Bordetella pertussis	520	S	3	12	15	0.00000
SRR6145060	Bordetella genomosp. 13	463040	S	70	15	85	0.00001
SRR6145060	Bifidobacterium thermophilum	33905	S	15	0	15	0.00000
SRR6145060	Beggiatoa leptomitoformis	288004	S	15	0	15	0.00000
SRR6145060	Bacillus atrophaeus	1452	S	15	0	15	0.00000
SRR6145060	Azospirillum sp. TSH100	652764	S	52	15	67	0.00001
SRR6145060	Arthrobacter sp. KBS0702	2578107	S	48	15	63	0.00001
SRR6145060	Arcanobacterium haemolyticum	28264	S	14	1	15	0.00000
SRR6145060	Anabaena sp. 90	46234	S	2	15	17	0.00000
SRR6145060	Alistipes finegoldii	214856	S	11	4	15	0.00000
SRR6145060	Algoriphagus sanaruensis	1727163	S	15	0	15	0.00000
SRR6145060	Advenella mimigardefordensis	302406	S	14	1	15	0.00000
SRR6145060	Actinomadura sp. WMMB499	2650775	S	186	15	201	0.00003
SRR6145060	Acidovorax sp. 1608163	2478662	S	160	15	175	0.00002
SRR6145060	Acidobacterium capsulatum	33075	S	15	0	15	0.00000
SRR6145060	bacterium 2013Arg42i	1561003	S	14	0	14	0.00000
SRR6145060	[Eubacterium] minutum	76124	S	14	0	14	0.00000
SRR6145060	[Brevibacterium] frigoritolerans	450367	S	14	0	14	0.00000
SRR6145060	Yersinia ruckeri	29486	S	14	0	14	0.00000
SRR6145060	Yersinia enterocolitica	630	S	13	1	14	0.00000
SRR6145060	Wenyingzhuangia fucanilytica	1790137	S	14	0	14	0.00000
SRR6145060	Weissella soli	155866	S	14	0	14	0.00000
SRR6145060	Variovorax sp. PBS-H4	434008	S	81	14	95	0.00001
SRR6145060	Trueperella bialowiezensis	312285	S	14	0	14	0.00000
SRR6145060	Thiomonas sp. X19	1050370	S	45	14	59	0.00001
SRR6145060	Synechococcus sp. WH 8020	32052	S	14	1	15	0.00000
SRR6145060	Streptomyces sp. jing01	2726118	S	43	14	57	0.00001
SRR6145060	Streptomyces sp. S1A1-7	2594459	S	5	14	19	0.00000
SRR6145060	Streptomyces sp. KPB2	2305221	S	39	14	53	0.00001
SRR6145060	Streptococcus troglodytae	1111760	S	13	1	14	0.00000
SRR6145060	Streptococcus macedonicus	59310	S	3	11	14	0.00000
SRR6145060	Streptococcus halotolerans	1814128	S	14	0	14	0.00000
SRR6145060	Staphylococcus sp. MI 10-1553	1912064	S	14	0	14	0.00000
SRR6145060	Staphylococcus hyicus	1284	S	14	0	14	0.00000
SRR6145060	Staphylococcus fleurettii	150056	S	13	1	14	0.00000
SRR6145060	Shewanella khirikhana	1965282	S	14	0	14	0.00000
SRR6145060	Salegentibacter salegens	143223	S	12	2	14	0.00000
SRR6145060	Salaquimonas pukyongi	2712698	S	14	0	14	0.00000
SRR6145060	Ruminiclostridium cellulolyticum	1521	S	14	0	14	0.00000
SRR6145060	Rhodothermaceae bacterium RA	1779382	S	15	14	29	0.00000
SRR6145060	Rhizobium sp. N324	1703969	S	1	14	15	0.00000
SRR6145060	Rathayibacter sp. VKM Ac-2762	2609254	S	14	34	48	0.00001
SRR6145060	Pseudomonas sp. WCS374	1495331	S	1	14	15	0.00000
SRR6145060	Pseudomonas sp. R11-23-07	658632	S	2	14	16	0.00000
SRR6145060	Pseudomonas sp. MRSN12121	1611770	S	18	14	32	0.00000
SRR6145060	Pseudomonas sp. BIOMIG1BAC	1758730	S	6	14	20	0.00000
SRR6145060	Pseudomonas reinekei	395598	S	14	0	14	0.00000
SRR6145060	Pseudomonas palleroniana	191390	S	14	0	14	0.00000
SRR6145060	Pseudomonas extremorientalis	169669	S	11	3	14	0.00000
SRR6145060	Pseudomonas corrugata	47879	S	13	1	14	0.00000
SRR6145060	Propionibacterium virus Stormborn	1982307	S	18	14	32	0.00000
SRR6145060	Propionibacterium virus PHL113M01	1982286	S	12	14	26	0.00000
SRR6145060	Propionibacterium virus P105	1982261	S	13	14	27	0.00000
SRR6145060	Propionibacterium virus Ouroboros	1982259	S	46	14	60	0.00001
SRR6145060	Planococcus rifietoensis	200991	S	10	4	14	0.00000
SRR6145060	Phoenicibacter congonensis	1944646	S	14	0	14	0.00000
SRR6145060	Pelosinus fermentans	365349	S	14	0	14	0.00000
SRR6145060	Pelobacter carbinolicus	19	S	14	0	14	0.00000
SRR6145060	Pectobacterium atrosepticum	29471	S	12	2	14	0.00000
SRR6145060	Parashewanella tropica	2547970	S	14	0	14	0.00000
SRR6145060	Oscillatoria acuminata	118323	S	9	5	14	0.00000
SRR6145060	Nocardioides sp. JQ2195	2592334	S	179	14	193	0.00003
SRR6145060	Muricauda lutaonensis	516051	S	14	0	14	0.00000
SRR6145060	Methanococcus aeolicus	42879	S	14	0	14	0.00000
SRR6145060	Mesorhizobium sp. M1B.F.Ca.ET.045.04.1.1	2493673	S	52	14	66	0.00001
SRR6145060	Mesoplasma florum	2151	S	13	1	14	0.00000
SRR6145060	Marinobacterium aestuarii	1821621	S	14	0	14	0.00000
SRR6145060	Luteimonas sp. 100111	2006110	S	291	14	305	0.00004
SRR6145060	Lactobacillus mucosae	97478	S	14	0	14	0.00000
SRR6145060	Lactobacillus curvatus	28038	S	13	1	14	0.00000
SRR6145060	Lacinutrix venerupis	1486034	S	13	1	14	0.00000
SRR6145060	Kosakonia sp. CCTCC M2018092	2492396	S	14	2	16	0.00000
SRR6145060	Komagataeibacter nataicola	265960	S	13	1	14	0.00000
SRR6145060	Jeotgalibaca porci	1868793	S	13	1	14	0.00000
SRR6145060	Herminiimonas arsenicoxydans	204773	S	11	3	14	0.00000
SRR6145060	Halovivax ruber	387341	S	14	0	14	0.00000
SRR6145060	Halomonas sp. NBT06E8	2609667	S	271	14	285	0.00004
SRR6145060	Hafnia paralvei	546367	S	14	0	14	0.00000
SRR6145060	Desulfobulbus propionicus	894	S	14	0	14	0.00000
SRR6145060	Clostridium taeniosporum	394958	S	14	0	14	0.00000
SRR6145060	Clostridium sporogenes	1509	S	2	12	14	0.00000
SRR6145060	Clostridium chauvoei	46867	S	14	0	14	0.00000
SRR6145060	Citrobacter sp. CF971	2566012	S	2	14	16	0.00000
SRR6145060	Cellulomonas sp. H30R-01	2704467	S	127	14	141	0.00002
SRR6145060	Candidatus Pelagibacter sp. RS40	1977865	S	14	0	14	0.00000
SRR6145060	Caldicellulosiruptor changbaiensis	1222016	S	6	8	14	0.00000
SRR6145060	Burkholderia sp. YI23	1097668	S	7	14	21	0.00000
SRR6145060	Borrelia crocidurae	29520	S	3	11	14	0.00000
SRR6145060	Bacillus simplex	1478	S	14	0	14	0.00000
SRR6145060	Bacillus pseudofirmus	79885	S	14	0	14	0.00000
SRR6145060	Bacillus infantis	324767	S	14	0	14	0.00000
SRR6145060	Bacillus cohnii	33932	S	14	0	14	0.00000
SRR6145060	Arcobacter pacificus	1080223	S	14	0	14	0.00000
SRR6145060	Arcobacter canalis	1912871	S	10	4	14	0.00000
SRR6145060	Alcaligenes aquatilis	323284	S	9	5	14	0.00000
SRR6145060	Agromyces sp. MF30-A	2080742	S	71	14	85	0.00001
SRR6145060	Aequorivita sublithincola	101385	S	14	0	14	0.00000
SRR6145060	Actinomyces tangfeifanii	1912795	S	14	0	14	0.00000
SRR6145060	Actinomadura sp. WMMA1423	2591108	S	152	14	166	0.00002
SRR6145060	Acetobacter tropicalis	104102	S	10	4	14	0.00000
SRR6145060	Absiella sp. 9CBEGH2	2583452	S	3	14	17	0.00000
SRR6145060	[Pasteurella] aerogenes	749	S	13	0	13	0.00000
SRR6145060	Yokenella regensburgei	158877	S	13	0	13	0.00000
SRR6145060	Vibrio campbellii	680	S	10	3	13	0.00000
SRR6145060	Thermoanaerobacter ethanolicus	1757	S	2	11	13	0.00000
SRR6145060	Sulfuriflexus mobilis	1811807	S	13	0	13	0.00000
SRR6145060	Suicoccus acidiformans	2036206	S	13	0	13	0.00000
SRR6145060	Streptomyces sp. SS52	2563602	S	9	13	22	0.00000
SRR6145060	Streptomyces sp. S063	2005885	S	34	13	47	0.00001
SRR6145060	Streptococcus ratti	1341	S	13	0	13	0.00000
SRR6145060	Streptococcus phage SpSL1	1566990	S	16	13	29	0.00000
SRR6145060	Stenotrophomonas sp. YAU14D1_LEIMI4_1	2072407	S	12	13	25	0.00000
SRR6145060	Sporosarcina pasteurii	1474	S	13	0	13	0.00000
SRR6145060	Spiroplasma tabanidicola	324079	S	13	0	13	0.00000
SRR6145060	Sphingomonas sp. LM7	1938607	S	213	13	226	0.00003
SRR6145060	Siansivirga zeaxanthinifaciens	762954	S	13	0	13	0.00000
SRR6145060	Shigella dysenteriae	622	S	3	10	13	0.00000
SRR6145060	Shewanella decolorationis	256839	S	12	1	13	0.00000
SRR6145060	Serratia sp. SCBI	488142	S	4	13	17	0.00000
SRR6145060	Saccharospirillum mangrovi	2161747	S	13	0	13	0.00000
SRR6145060	Rubrobacter indicoceani	2051957	S	13	0	13	0.00000
SRR6145060	Rhodovulum sp. MB263	308754	S	70	13	83	0.00001
SRR6145060	Rhodococcus sp. ABRD24	2507582	S	169	13	182	0.00002
SRR6145060	Rhizobium sp. Kim5	2020311	S	12	13	25	0.00000
SRR6145060	Psychrobacter cryohalolentis	330922	S	13	0	13	0.00000
SRR6145060	Pseudomonas thivervalensis	86265	S	12	1	13	0.00000
SRR6145060	Pseudomonas sp. S49	1573720	S	7	13	20	0.00000
SRR6145060	Pseudomonas sp. CMR12a	658629	S	5	13	18	0.00000
SRR6145060	Pseudomonas arsenicoxydans	702115	S	13	0	13	0.00000
SRR6145060	Pseudomonas agarici	46677	S	13	0	13	0.00000
SRR6145060	Propionibacterium virus Attacne	1982254	S	23	13	36	0.00000
SRR6145060	Propionibacterium phage QueenBey	1654782	S	39	13	52	0.00001
SRR6145060	Polaribacter vadi	1774273	S	12	1	13	0.00000
SRR6145060	Phytobacter diazotrophicus	395631	S	3	10	13	0.00000
SRR6145060	Phaeobacter porticola	1844006	S	10	3	13	0.00000
SRR6145060	Paraburkholderia rhizoxinica	412963	S	13	0	13	0.00000
SRR6145060	Paenibacillus odorifer	189426	S	13	0	13	0.00000
SRR6145060	Paenibacillus beijingensis	1126833	S	13	0	13	0.00000
SRR6145060	Oceanicoccus sagamiensis	716816	S	13	0	13	0.00000
SRR6145060	Nostoc sp. PCC 7107	317936	S	13	4	17	0.00000
SRR6145060	Nonomuraea sp. WYY166	2656914	S	164	13	177	0.00002
SRR6145060	Muribaculum intestinale	1796646	S	11	2	13	0.00000
SRR6145060	Miniimonas sp. S16	2171623	S	201	13	214	0.00003
SRR6145060	Microbacteriaceae bacterium WY83	1804990	S	104	13	117	0.00002
SRR6145060	Methylocystis sp. SC2	187303	S	29	13	42	0.00001
SRR6145060	Megasphaera stantonii	2144175	S	12	1	13	0.00000
SRR6145060	Mannheimia granulomatis	85402	S	13	0	13	0.00000
SRR6145060	Listeria ivanovii	1638	S	13	0	13	0.00000
SRR6145060	Legionella longbeachae	450	S	12	1	13	0.00000
SRR6145060	Lactobacillus paragasseri	2107999	S	7	6	13	0.00000
SRR6145060	Lactobacillus nagelii	82688	S	13	0	13	0.00000
SRR6145060	Lachnoclostridium phytofermentans	66219	S	13	0	13	0.00000
SRR6145060	Kushneria marisflavi	157779	S	12	1	13	0.00000
SRR6145060	Hippea maritima	84405	S	13	0	13	0.00000
SRR6145060	Halopenitus persicus	1048396	S	12	1	13	0.00000
SRR6145060	Haloarcula taiwanensis	1932004	S	12	1	13	0.00000
SRR6145060	Gordonibacter urolithinfaciens	1335613	S	9	4	13	0.00000
SRR6145060	Gordonia sp. X0973	2742602	S	133	13	146	0.00002
SRR6145060	Geobacillus thermoleovorans	33941	S	4	9	13	0.00000
SRR6145060	Gemmatimonas phototrophica	1379270	S	13	0	13	0.00000
SRR6145060	Gallibacterium anatis	750	S	13	0	13	0.00000
SRR6145060	Frischella perrara	1267021	S	12	1	13	0.00000
SRR6145060	Francisella adeliensis	2007306	S	13	0	13	0.00000
SRR6145060	Flavobacterium faecale	1355330	S	13	0	13	0.00000
SRR6145060	Fictibacillus arsenicus	255247	S	13	0	13	0.00000
SRR6145060	Ferriphaselus amnicola	1188319	S	13	0	13	0.00000
SRR6145060	Fabibacter pacificus	1267423	S	13	0	13	0.00000
SRR6145060	Erythrobacter sp. EB310	2739433	S	54	13	67	0.00001
SRR6145060	Enterococcus wangshanyuanii	2005703	S	13	0	13	0.00000
SRR6145060	Enterobacteriaceae bacterium ENNIH1	2066051	S	31	13	44	0.00001
SRR6145060	Echinicola vietnamensis	390884	S	12	1	13	0.00000
SRR6145060	Dialister hominis	2582419	S	2	11	13	0.00000
SRR6145060	Desulfuromonas soudanensis	1603606	S	13	0	13	0.00000
SRR6145060	Desulfurella acetivorans	33002	S	13	0	13	0.00000
SRR6145060	Desulfosarcina widdelii	947919	S	13	0	13	0.00000
SRR6145060	Desulfomicrobium baculatum	899	S	13	0	13	0.00000
SRR6145060	Cytophagales bacterium TFI 002	1945892	S	13	0	13	0.00000
SRR6145060	Cyanobacterium aponinum	379064	S	11	2	13	0.00000
SRR6145060	Clostridium drakei	332101	S	10	3	13	0.00000
SRR6145060	Chamaesiphon minutus	1173032	S	12	1	13	0.00000
SRR6145060	Candidatus Pelagibacter sp. FZCC0015	2268451	S	13	0	13	0.00000
SRR6145060	Burkholderia sp. MSMB1588	1636423	S	4	13	17	0.00000
SRR6145060	Bibersteinia trehalosi	47735	S	13	0	13	0.00000
SRR6145060	Beijerinckiaceae bacterium	1978229	S	13	0	13	0.00000
SRR6145060	Bacillus luti	2026191	S	13	0	13	0.00000
SRR6145060	Bacillus altitudinis	293387	S	9	4	13	0.00000
SRR6145060	Arcobacter defluvii	873191	S	6	7	13	0.00000
SRR6145060	Arcobacter anaerophilus	877500	S	13	0	13	0.00000
SRR6145060	Antarcticibacterium flavum	2058175	S	13	0	13	0.00000
SRR6145060	Acidithiobacillus caldus	33059	S	13	0	13	0.00000
SRR6145060	uncultured crAssphage	1211417	S	12	0	12	0.00000
SRR6145060	Xenorhabdus hominickii	351679	S	12	0	12	0.00000
SRR6145060	Virgibacillus necropolis	163877	S	12	0	12	0.00000
SRR6145060	Vibrio ponticus	265668	S	12	0	12	0.00000
SRR6145060	Tumebacillus avium	1903704	S	12	0	12	0.00000
SRR6145060	Tolumonas auensis	43948	S	12	0	12	0.00000
SRR6145060	Terriglobus saanensis	870903	S	12	0	12	0.00000
SRR6145060	Streptomyces sp. JB150	2714844	S	69	12	81	0.00001
SRR6145060	Streptococcus sp. NCTC 10228	2583585	S	12	6	18	0.00000
SRR6145060	Stenotrophomonas sp. ZAC14A_NAIMI4_1	2072412	S	10	12	22	0.00000
SRR6145060	Stenotrophomonas sp. ESTM1D_MKCIP4_1	2072414	S	59	12	71	0.00001
SRR6145060	Spiroplasma phoeniceum	47835	S	5	7	12	0.00000
SRR6145060	Spiroplasma cantharicola	362837	S	12	0	12	0.00000
SRR6145060	Spirochaeta africana	46355	S	12	0	12	0.00000
SRR6145060	Spiribacter roseus	1855875	S	12	0	12	0.00000
SRR6145060	Sphingopyxis sp. QXT-31	1357916	S	136	12	148	0.00002
SRR6145060	Sphingobacterium psychroaquaticum	561061	S	12	0	12	0.00000
SRR6145060	Sodalis praecaptivus	1239307	S	7	5	12	0.00000
SRR6145060	Slackia heliotrinireducens	84110	S	12	0	12	0.00000
SRR6145060	Sebaldella termitidis	826	S	12	0	12	0.00000
SRR6145060	Salinimonas sediminis	2303538	S	12	0	12	0.00000
SRR6145060	Runella slithyformis	106	S	11	1	12	0.00000
SRR6145060	Ruminococcus albus	1264	S	12	0	12	0.00000
SRR6145060	Rubinisphaera brasiliensis	119	S	12	0	12	0.00000
SRR6145060	Rodentibacter heylii	1906744	S	5	7	12	0.00000
SRR6145060	Rhodococcus sp. X156	2499145	S	160	12	172	0.00002
SRR6145060	Rhodobacteraceae bacterium SH-1	2605946	S	66	12	78	0.00001
SRR6145060	Rhizobium sp. JKLM19E	2583232	S	6	12	18	0.00000
SRR6145060	Renibacterium salmoninarum	1646	S	12	0	12	0.00000
SRR6145060	Pseudomonas sp. FDAARGOS_761	2545800	S	1	12	13	0.00000
SRR6145060	Pseudomonas brenneri	129817	S	11	1	12	0.00000
SRR6145060	Pseudobutyrivibrio xylanivorans	185007	S	12	0	12	0.00000
SRR6145060	Pseudoalteromonas carrageenovora	227	S	3	9	12	0.00000
SRR6145060	Pseudoalteromonas arctica	394751	S	10	2	12	0.00000
SRR6145060	Pseudarthrobacter sp. NIBRBAC000502772	2590775	S	25	12	37	0.00000
SRR6145060	Pseudanabaena sp. PCC 7367	82654	S	12	0	12	0.00000
SRR6145060	Providencia rustigianii	158850	S	12	0	12	0.00000
SRR6145060	Providencia heimbachae	333962	S	12	0	12	0.00000
SRR6145060	Providencia alcalifaciens	126385	S	12	0	12	0.00000
SRR6145060	Propionibacterium virus PHL025M00	1982274	S	14	12	26	0.00000
SRR6145060	Propionibacterium virus P144	1982262	S	20	12	32	0.00000
SRR6145060	Propionibacterium virus P101A	1982267	S	8	12	20	0.00000
SRR6145060	Propionibacterium virus P100D	1982266	S	13	12	25	0.00000
SRR6145060	Propionibacterium virus MrAK	1982258	S	9	12	21	0.00000
SRR6145060	Propionibacterium phage Enoki	1654780	S	15	12	27	0.00000
SRR6145060	Pontibacter korlensis	400092	S	12	0	12	0.00000
SRR6145060	Polaromonas vacuolata	37448	S	12	0	12	0.00000
SRR6145060	Piscirickettsia salmonis	1238	S	12	0	12	0.00000
SRR6145060	Paenibacillus thiaminolyticus	49283	S	12	0	12	0.00000
SRR6145060	Paenibacillus psychroresistens	1778678	S	12	0	12	0.00000
SRR6145060	Paenibacillus durus	44251	S	12	0	12	0.00000
SRR6145060	Oceanisphaera avium	1903694	S	12	0	12	0.00000
SRR6145060	Nostoc sp. NIES-3756	1751286	S	5	12	17	0.00000
SRR6145060	Nostoc sp. ATCC 53789	76335	S	12	8	20	0.00000
SRR6145060	Nonlabens dokdonensis	328515	S	12	0	12	0.00000
SRR6145060	Nitrospira defluvii	330214	S	12	0	12	0.00000
SRR6145060	Nitrosococcus watsonii	473531	S	9	3	12	0.00000
SRR6145060	Natronorubrum aibiense	348826	S	11	1	12	0.00000
SRR6145060	Mycoplasma iowae	2116	S	12	0	12	0.00000
SRR6145060	Mycobacterium sp. DL90	2487344	S	132	12	144	0.00002
SRR6145060	Moritella viscosa	80854	S	12	0	12	0.00000
SRR6145060	Moraxella ovis	29433	S	8	4	12	0.00000
SRR6145060	Micromonospora sp. WMMC415	2675222	S	82	12	94	0.00001
SRR6145060	Methylovorus glucosotrophus	266009	S	8	4	12	0.00000
SRR6145060	Methylomonas denitrificans	1538553	S	12	0	12	0.00000
SRR6145060	Methanosarcina siciliae	38027	S	12	0	12	0.00000
SRR6145060	Mesorhizobium sp. NIBRBAC000500504	2725666	S	81	12	93	0.00001
SRR6145060	Magnetospirillum sp. ME-1	1639348	S	36	12	48	0.00001
SRR6145060	Limnobaculum parvum	2172103	S	12	0	12	0.00000
SRR6145060	Libanicoccus massiliensis	1871022	S	7	5	12	0.00000
SRR6145060	Leminorella richardii	158841	S	12	0	12	0.00000
SRR6145060	Lactobacillus zhachilii	2304606	S	12	0	12	0.00000
SRR6145060	Lactobacillus rhamnosus	47715	S	12	0	12	0.00000
SRR6145060	Lactobacillus hilgardii	1588	S	12	0	12	0.00000
SRR6145060	Lactobacillus farciminis	1612	S	12	0	12	0.00000
SRR6145060	Lacrimispora saccharolytica	84030	S	12	0	12	0.00000
SRR6145060	Ktedonosporobacter rubrisoli	2509675	S	12	0	12	0.00000
SRR6145060	Kiritimatiella glycovorans	1307763	S	10	2	12	0.00000
SRR6145060	Hymenobacter sp. HDW8	2714932	S	8	12	20	0.00000
SRR6145060	Hydrogenophaga sp. RAC07	1842537	S	60	12	72	0.00001
SRR6145060	Hydrogenophaga sp. BPS33	2651974	S	94	12	106	0.00001
SRR6145060	Halorhabdus utahensis	146826	S	11	1	12	0.00000
SRR6145060	Haloferax mediterranei	2252	S	12	0	12	0.00000
SRR6145060	Halobacteriovorax marinus	97084	S	12	0	12	0.00000
SRR6145060	Haloarcula sp. CBA1115	1592728	S	3	12	15	0.00000
SRR6145060	Halioglobus pacificus	930806	S	12	0	12	0.00000
SRR6145060	Halapricum salinum	1457250	S	12	0	12	0.00000
SRR6145060	Hahella chejuensis	158327	S	11	1	12	0.00000
SRR6145060	Granulicella tundricola	940615	S	12	0	12	0.00000
SRR6145060	Gramella fulva	2126553	S	12	0	12	0.00000
SRR6145060	Gibbsiella quercinecans	929813	S	12	0	12	0.00000
SRR6145060	Geobacter pickeringii	345632	S	12	0	12	0.00000
SRR6145060	Flagellimonas maritima	1383885	S	12	0	12	0.00000
SRR6145060	Escherichia fergusonii	564	S	8	4	12	0.00000
SRR6145060	Dickeya sp. NCPPB 569	568768	S	12	0	12	0.00000
SRR6145060	Diaphorobacter sp. HDW4A	2714924	S	41	12	53	0.00001
SRR6145060	Desulfovibrio fairfieldensis	44742	S	12	0	12	0.00000
SRR6145060	Cronobacter condimenti	1163710	S	11	1	12	0.00000
SRR6145060	Crateriforma conspicua	2527996	S	12	0	12	0.00000
SRR6145060	Coxiella burnetii	777	S	11	1	12	0.00000
SRR6145060	Corynebacterium sp. NML98-0116	702967	S	246	12	258	0.00003
SRR6145060	Clostridium sp. SYSU GA15002T	2587161	S	12	0	12	0.00000
SRR6145060	Chryseobacterium sp. G0186	2487064	S	81	12	93	0.00001
SRR6145060	Chloracidobacterium thermophilum	458033	S	12	0	12	0.00000
SRR6145060	Campylobacter curvus	200	S	12	0	12	0.00000
SRR6145060	Campylobacter armoricus	2505970	S	12	0	12	0.00000
SRR6145060	Caldilinea aerophila	133453	S	12	0	12	0.00000
SRR6145060	Bordetella avium	521	S	12	0	12	0.00000
SRR6145060	Bacillus paranthracis	2026186	S	5	7	12	0.00000
SRR6145060	Bacillus paralicheniformis	1648923	S	12	0	12	0.00000
SRR6145060	Bacillus marisflavi	189381	S	12	0	12	0.00000
SRR6145060	Arcobacter molluscorum	1032072	S	12	0	12	0.00000
SRR6145060	Arcobacter cibarius	255507	S	12	0	12	0.00000
SRR6145060	Anoxybacter fermentans	1323375	S	12	0	12	0.00000
SRR6145060	Amphibacillus xylanus	1449	S	12	0	12	0.00000
SRR6145060	Aminomonas paucivorans	81412	S	12	0	12	0.00000
SRR6145060	Alkaliphilus oremlandii	461876	S	12	0	12	0.00000
SRR6145060	Actinomyces sp. 299	2057743	S	66	12	78	0.00001
SRR6145060	Acidithiobacillus ferrivorans	160808	S	12	0	12	0.00000
SRR6145060	bacterium BFN5	2717699	S	11	0	11	0.00000
SRR6145060	[Mannheimia] succiniciproducens	157673	S	3	8	11	0.00000
SRR6145060	[Clostridium] ultunense	45497	S	11	0	11	0.00000
SRR6145060	Yersinia rohdei	29485	S	11	0	11	0.00000
SRR6145060	Yersinia pseudotuberculosis	633	S	6	5	11	0.00000
SRR6145060	Wolbachia pipientis	955	S	3	8	11	0.00000
SRR6145060	Weissella ceti	759620	S	11	0	11	0.00000
SRR6145060	Vibrio nigripulchritudo	28173	S	11	0	11	0.00000
SRR6145060	Vibrio gazogenes	687	S	11	0	11	0.00000
SRR6145060	Vibrio cyclitrophicus	47951	S	10	1	11	0.00000
SRR6145060	Vibrio coralliilyticus	190893	S	8	3	11	0.00000
SRR6145060	Ureibacillus thermosphaericus	51173	S	10	1	11	0.00000
SRR6145060	Undibacterium parvum	401471	S	11	0	11	0.00000
SRR6145060	Tuwongella immobilis	692036	S	11	0	11	0.00000
SRR6145060	Thermodesulfobium narugense	184064	S	11	0	11	0.00000
SRR6145060	Thermincola potens	863643	S	11	0	11	0.00000
SRR6145060	Thauera sp. K11	2005884	S	98	11	109	0.00001
SRR6145060	Thalassospira marina	2048283	S	11	0	11	0.00000
SRR6145060	Terriglobus albidus	1592106	S	11	0	11	0.00000
SRR6145060	Terribacillus goriensis	386490	S	11	0	11	0.00000
SRR6145060	Tenacibaculum dicentrarchi	669041	S	11	0	11	0.00000
SRR6145060	Sulfurimonas gotlandica	1176482	S	11	0	11	0.00000
SRR6145060	Streptomyces sp. Z423-1	2730915	S	108	11	119	0.00002
SRR6145060	Streptomyces sp. WAC6273	2588707	S	8	11	19	0.00000
SRR6145060	Streptomyces sp. RLB3-6	2594457	S	1	11	12	0.00000
SRR6145060	Stenotrophomonas sp. ZAC14D2_NAIMI4_7	2072405	S	17	11	28	0.00000
SRR6145060	Staphylococcus phage IME-SA4	1610872	S	8	11	19	0.00000
SRR6145060	Sporolactobacillus terrae	269673	S	11	0	11	0.00000
SRR6145060	Sphingobium sp. RAC03	1843368	S	122	11	133	0.00002
SRR6145060	Silvanigrella aquatica	1915309	S	11	0	11	0.00000
SRR6145060	Shewanella maritima	2520507	S	11	0	11	0.00000
SRR6145060	Serratia quinivorans	137545	S	7	4	11	0.00000
SRR6145060	Salinivibrio kushneri	1908198	S	11	0	11	0.00000
SRR6145060	Roseovarius mucosus	215743	S	3	8	11	0.00000
SRR6145060	Rhodococcus sp. B7740	1564114	S	157	11	168	0.00002
SRR6145060	Rhizobium sp. IE4771	1301032	S	13	11	24	0.00000
SRR6145060	Psychrobacter sp. PRwf-1	349106	S	18	11	29	0.00000
SRR6145060	Pseudomonas sp. R2-37-08W	1173273	S	3	11	14	0.00000
SRR6145060	Pseudomonas salegens	1434072	S	11	0	11	0.00000
SRR6145060	Pseudomonas coronafaciens	53409	S	11	0	11	0.00000
SRR6145060	Pseudoalteromonas piratica	1348114	S	11	0	11	0.00000
SRR6145060	Pseudoalteromonas aliena	247523	S	11	0	11	0.00000
SRR6145060	Propionibacterium virus PHL141N00	1982292	S	9	11	20	0.00000
SRR6145060	Propionibacterium phage BruceLethal	1654740	S	53	11	64	0.00001
SRR6145060	Polynucleobacter wuianus	1743168	S	9	2	11	0.00000
SRR6145060	Polynucleobacter asymbioticus	576611	S	10	1	11	0.00000
SRR6145060	Planococcus halocryophilus	1215089	S	10	1	11	0.00000
SRR6145060	Photorhabdus laumondii	2218628	S	11	0	11	0.00000
SRR6145060	Paraphotobacterium marinum	1755811	S	11	0	11	0.00000
SRR6145060	Parageobacillus thermoglucosidasius	1426	S	11	0	11	0.00000
SRR6145060	Parachlamydia acanthamoebae	83552	S	11	0	11	0.00000
SRR6145060	Pandoravirus quercus	2107709	S	9	2	11	0.00000
SRR6145060	Paenibacillus swuensis	1178515	S	11	0	11	0.00000
SRR6145060	Paenibacillus sp. lzh-N1	2069255	S	3	11	14	0.00000
SRR6145060	Paenibacillus bovis	1616788	S	11	0	11	0.00000
SRR6145060	Paenibacillus albus	2495582	S	11	0	11	0.00000
SRR6145060	Otariodibacter oris	1032623	S	11	0	11	0.00000
SRR6145060	Nitrosomonadales bacterium 0125_3	2732067	S	46	11	57	0.00001
SRR6145060	Nitrosococcus wardiae	1814290	S	10	1	11	0.00000
SRR6145060	Neptunomonas concharum	1031538	S	11	0	11	0.00000
SRR6145060	Natronomonas moolapensis	416273	S	11	0	11	0.00000
SRR6145060	Natronobacterium gregoryi	44930	S	11	0	11	0.00000
SRR6145060	Natrinema pallidum	69527	S	9	2	11	0.00000
SRR6145060	Moorella glycerini	55779	S	11	0	11	0.00000
SRR6145060	Microbulbifer hydrolyticus	48074	S	11	0	11	0.00000
SRR6145060	Methanosarcina horonobensis	418008	S	11	0	11	0.00000
SRR6145060	Mesorhizobium sp. NZP2298	2483403	S	29	11	40	0.00001
SRR6145060	Martelella sp. AD-3	686597	S	51	11	62	0.00001
SRR6145060	Maritalea myrionectae	454601	S	11	0	11	0.00000
SRR6145060	Leptospira weilii	28184	S	7	4	11	0.00000
SRR6145060	Lactobacillus harbinensis	304207	S	11	0	11	0.00000
SRR6145060	Lactobacillus crustorum	392416	S	11	0	11	0.00000
SRR6145060	Lactobacillus acidophilus	1579	S	11	0	11	0.00000
SRR6145060	Ketobacter alkanivorans	1917421	S	11	0	11	0.00000
SRR6145060	Jonesia denitrificans	43674	S	11	0	11	0.00000
SRR6145060	Ichthyobacterium seriolicida	242600	S	11	0	11	0.00000
SRR6145060	Helicobacter canadensis	123841	S	11	0	11	0.00000
SRR6145060	Halorubrum sp. RHB-C	2739057	S	36	11	47	0.00001
SRR6145060	Halobacteroides halobius	42422	S	11	0	11	0.00000
SRR6145060	Haliscomenobacter hydrossis	2350	S	11	0	11	0.00000
SRR6145060	Halarcobacter bivalviorum	663364	S	11	0	11	0.00000
SRR6145060	Halanaeroarchaeum sulfurireducens	1604004	S	11	0	11	0.00000
SRR6145060	Granulosicoccus antarcticus	437505	S	11	0	11	0.00000
SRR6145060	Gramella forsetii	411153	S	11	0	11	0.00000
SRR6145060	Geobacillus subterraneus	129338	S	11	0	11	0.00000
SRR6145060	Frederiksenia canicola	123824	S	11	0	11	0.00000
SRR6145060	Flavobacterium magnum	2162713	S	11	0	11	0.00000
SRR6145060	Flavisolibacter tropicus	1492898	S	11	0	11	0.00000
SRR6145060	Fischerella sp. NIES-4106	2005456	S	44	11	55	0.00001
SRR6145060	Fervidobacterium pennivorans	93466	S	9	2	11	0.00000
SRR6145060	Faecalitalea cylindroides	39483	S	10	1	11	0.00000
SRR6145060	Ethanoligenens harbinense	253239	S	11	0	11	0.00000
SRR6145060	Enterococcus thailandicus	417368	S	11	0	11	0.00000
SRR6145060	Dickeya fangzhongdai	1778540	S	7	4	11	0.00000
SRR6145060	Desulfurispirillum indicum	936456	S	11	0	11	0.00000
SRR6145060	Desulfotomaculum reducens	59610	S	11	0	11	0.00000
SRR6145060	Comamonas sp. NLF-7-7	2597701	S	57	11	68	0.00001
SRR6145060	Colwellia sp. PAMC 21821	1816219	S	11	1	12	0.00000
SRR6145060	Cloacibacillus porcorum	1197717	S	11	0	11	0.00000
SRR6145060	Citrobacter sp. CFNIH10	1920110	S	2	11	13	0.00000
SRR6145060	Chryseobacterium sp. POL2	2713414	S	147	11	158	0.00002
SRR6145060	Chlorobaculum tepidum	1097	S	9	2	11	0.00000
SRR6145060	Celeribacter marinus	1397108	S	11	0	11	0.00000
SRR6145060	Campylobacter coli	195	S	10	1	11	0.00000
SRR6145060	Campylobacter blaseri	2042961	S	11	0	11	0.00000
SRR6145060	Burkholderia sp. KK1	1855726	S	11	11	22	0.00000
SRR6145060	Burkholderia pseudomultivorans	1207504	S	5	6	11	0.00000
SRR6145060	Bartonella grahamii	33045	S	10	1	11	0.00000
SRR6145060	Bacteroides sp. A1C1	2528203	S	23	11	34	0.00000
SRR6145060	Bacillus jeotgali	129985	S	11	0	11	0.00000
SRR6145060	Bacillus asahii	228899	S	11	0	11	0.00000
SRR6145060	Azoarcus sp. DD4	2027405	S	63	11	74	0.00001
SRR6145060	Avibacterium paragallinarum	728	S	11	0	11	0.00000
SRR6145060	Arcobacter trophiarum	708186	S	11	0	11	0.00000
SRR6145060	Arcobacter suis	1278212	S	11	0	11	0.00000
SRR6145060	Arcobacter sp. LPB0137	1850254	S	8	11	19	0.00000
SRR6145060	Arcobacter cloacae	1054034	S	10	1	11	0.00000
SRR6145060	Alkaliphilus metalliredigens	208226	S	11	0	11	0.00000
SRR6145060	Aliivibrio wodanis	80852	S	11	0	11	0.00000
SRR6145060	Aliivibrio salmonicida	40269	S	11	0	11	0.00000
SRR6145060	Algoriphagus machipongonensis	388413	S	11	0	11	0.00000
SRR6145060	Agrobacterium sp. T29	2580515	S	31	11	42	0.00001
SRR6145060	Agarivorans gilvus	680279	S	11	0	11	0.00000
SRR6145060	Xenorhabdus nematophila	628	S	10	0	10	0.00000
SRR6145060	Wigglesworthia glossinidia	51229	S	10	0	10	0.00000
SRR6145060	Virgibacillus phasianinus	2017483	S	10	0	10	0.00000
SRR6145060	Vibrio tapetis	52443	S	10	0	10	0.00000
SRR6145060	Vibrio taketomensis	2572923	S	10	0	10	0.00000
SRR6145060	Vibrio splendidus	29497	S	9	1	10	0.00000
SRR6145060	Vibrio mediterranei	689	S	10	0	10	0.00000
SRR6145060	Vibrio aphrogenes	1891186	S	10	0	10	0.00000
SRR6145060	Thermoclostridium stercorarium	1510	S	9	1	10	0.00000
SRR6145060	Thalassolituus oleivorans	187493	S	10	0	10	0.00000
SRR6145060	Tetragenococcus osmophilus	526944	S	10	0	10	0.00000
SRR6145060	Tardiphaga sp. vice304	2592817	S	1	10	11	0.00000
SRR6145060	Sutterella faecalis	2584944	S	10	0	10	0.00000
SRR6145060	Sulfolobus islandicus	43080	S	8	2	10	0.00000
SRR6145060	Streptosporangium sp. 'caverna'	2202249	S	120	10	130	0.00002
SRR6145060	Streptomyces sp. S1D4-11	2721246	S	45	10	55	0.00001
SRR6145060	Streptomyces sp. HF10	2692233	S	30	10	40	0.00001
SRR6145060	Streptomyces sp. ADI95-16	1522758	S	39	10	49	0.00001
SRR6145060	Streptomyces sp. 3211	1964449	S	25	10	35	0.00000
SRR6145060	Streptococcus pantholopis	1811193	S	10	0	10	0.00000
SRR6145060	Stenotrophomonas sp. 364	2691571	S	47	10	57	0.00001
SRR6145060	Sporosarcina psychrophila	1476	S	10	0	10	0.00000
SRR6145060	Spiroplasma citri	2133	S	3	7	10	0.00000
SRR6145060	Spirochaeta perfilievii	252967	S	10	0	10	0.00000
SRR6145060	Sphingomonas sp. PAMC26645	2565555	S	309	10	319	0.00004
SRR6145060	Sphingomonas sp. LMO-1	2681549	S	323	10	333	0.00004
SRR6145060	Sideroxydans lithotrophicus	63745	S	10	0	10	0.00000
SRR6145060	Shewanella sp. ANA-3	94122	S	27	10	37	0.00000
SRR6145060	Shewanella livingstonensis	150120	S	10	0	10	0.00000
SRR6145060	Serratia proteamaculans	28151	S	8	2	10	0.00000
SRR6145060	Selenomonas ruminantium	971	S	10	0	10	0.00000
SRR6145060	Sedimenticola thiotaurini	1543721	S	10	0	10	0.00000
SRR6145060	Rhizobium sp. TAL182	2020313	S	5	10	15	0.00000
SRR6145060	Reinekea forsetii	1336806	S	10	0	10	0.00000
SRR6145060	Rathayibacter toxicus	145458	S	10	0	10	0.00000
SRR6145060	Raoultella sp. X13	2259647	S	1	10	11	0.00000
SRR6145060	Ralstonia pseudosolanacearum	1310165	S	2	8	10	0.00000
SRR6145060	Psychromonas ingrahamii	357794	S	10	0	10	0.00000
SRR6145060	Pseudomonas xinjiangensis	487184	S	10	0	10	0.00000
SRR6145060	Pseudomonas avellanae	46257	S	1	9	10	0.00000
SRR6145060	Pseudohongiella spirulinae	1249552	S	10	0	10	0.00000
SRR6145060	Pseudoalteromonas tunicata	314281	S	10	0	10	0.00000
SRR6145060	Pseudoalteromonas donghaensis	621376	S	10	0	10	0.00000
SRR6145060	Pseudoalteromonas atlantica	288	S	10	0	10	0.00000
SRR6145060	Propionimicrobium sp. Marseille-P3275	1871034	S	319	10	329	0.00004
SRR6145060	Propioniciclava sp. HDW11	2714937	S	152	10	162	0.00002
SRR6145060	Propionibacterium virus Procrass1	1982304	S	13	10	23	0.00000
SRR6145060	Propionibacterium virus PHL092M00	1982282	S	17	10	27	0.00000
SRR6145060	Propionibacterium virus PHL070N00	1982279	S	44	10	54	0.00001
SRR6145060	Propionibacterium virus Keiki	1982255	S	2	10	12	0.00000
SRR6145060	Propionibacterium phage Moyashi	1654781	S	8	10	18	0.00000
SRR6145060	Plautia stali symbiont	891974	S	87	10	97	0.00001
SRR6145060	Planktothrix agardhii	1160	S	8	2	10	0.00000
SRR6145060	Planctomycetes bacterium V6	2528030	S	11	10	21	0.00000
SRR6145060	Pirellula staleyi	125	S	10	0	10	0.00000
SRR6145060	Phytobacter sp. SCO41	1756993	S	3	10	13	0.00000
SRR6145060	Photorhabdus asymbiotica	291112	S	10	0	10	0.00000
SRR6145060	Photobacterium gaetbulicola	1295392	S	10	0	10	0.00000
SRR6145060	Petrocella atlantisensis	2173034	S	10	0	10	0.00000
SRR6145060	Pelobacter acetylenicus	29542	S	10	0	10	0.00000
SRR6145060	Parvularcula bermudensis	208216	S	10	0	10	0.00000
SRR6145060	Parasedimentitalea marina	2483033	S	10	0	10	0.00000
SRR6145060	Paenibacillus sp. FSL R7-0273	1536772	S	10	0	10	0.00000
SRR6145060	Paenibacillus sabinae	365617	S	10	0	10	0.00000
SRR6145060	Paenibacillus lutimineralis	2707005	S	10	0	10	0.00000
SRR6145060	Paenibacillus guangzhouensis	1473112	S	10	0	10	0.00000
SRR6145060	Paenibacillus crassostreae	1763538	S	10	0	10	0.00000
SRR6145060	Paenibacillus antarcticus	253703	S	10	0	10	0.00000
SRR6145060	Oxalobacter formigenes	847	S	10	0	10	0.00000
SRR6145060	Orpheovirus IHUMI-LCC2	2023057	S	10	0	10	0.00000
SRR6145060	Oligella urethralis	90245	S	10	0	10	0.00000
SRR6145060	Oleispira antarctica	188908	S	10	0	10	0.00000
SRR6145060	Oenococcus oeni	1247	S	10	0	10	0.00000
SRR6145060	Octadecabacter temperatus	1458307	S	10	0	10	0.00000
SRR6145060	Nonlabens marinus	930802	S	10	0	10	0.00000
SRR6145060	Natronorubrum bangense	61858	S	9	1	10	0.00000
SRR6145060	Myroides profundi	480520	S	10	0	10	0.00000
SRR6145060	Mycoplasma penetrans	28227	S	10	0	10	0.00000
SRR6145060	Mycoplasma cynos	171284	S	10	0	10	0.00000
SRR6145060	Microcystis viridis	44822	S	1	9	10	0.00000
SRR6145060	Microbulbifer thermotolerans	252514	S	10	0	10	0.00000
SRR6145060	Microbacterium sp. BH-3-3-3	1906742	S	192	10	202	0.00003
SRR6145060	Methylomonas koyamae	702114	S	4	6	10	0.00000
SRR6145060	Methylobacillus flagellatus	405	S	10	0	10	0.00000
SRR6145060	Methanobrevibacter millerae	230361	S	10	0	10	0.00000
SRR6145060	Methanobacterium lacus	877455	S	10	0	10	0.00000
SRR6145060	Mesorhizobium sp. AA22	1854057	S	13	10	23	0.00000
SRR6145060	Mesoplasma lactucae	138853	S	10	0	10	0.00000
SRR6145060	Megavirus chiliensis	1094892	S	9	1	10	0.00000
SRR6145060	Marinirhabdus gelatinilytica	1703343	S	10	0	10	0.00000
SRR6145060	Magnetospirillum sp. XM-1	1663591	S	34	10	44	0.00001
SRR6145060	Magnetococcus marinus	1124597	S	10	0	10	0.00000
SRR6145060	Leisingera sp. NJS201	2508306	S	10	10	20	0.00000
SRR6145060	Legionella adelaidensis	45056	S	10	0	10	0.00000
SRR6145060	Lactobacillus vaginalis	1633	S	10	0	10	0.00000
SRR6145060	Lactobacillus ruminis	1623	S	10	0	10	0.00000
SRR6145060	Lactobacillus agilis	1601	S	10	0	10	0.00000
SRR6145060	Idiomarina piscisalsi	1096243	S	7	3	10	0.00000
SRR6145060	Helicobacter bilis	37372	S	10	0	10	0.00000
SRR6145060	Halogeometricum borinquense	60847	S	10	0	10	0.00000
SRR6145060	Halanaerobium praevalens	2331	S	10	0	10	0.00000
SRR6145060	Gramella salexigens	1913577	S	10	0	10	0.00000
SRR6145060	Gallaecimonas mangrovi	2291597	S	10	0	10	0.00000
SRR6145060	Fusobacterium gonidiaformans	849	S	10	0	10	0.00000
SRR6145060	Eubacterium limosum	1736	S	9	1	10	0.00000
SRR6145060	Erythrobacter sp. THAF29	2587851	S	42	10	52	0.00001
SRR6145060	Erwinia tasmaniensis	338565	S	10	0	10	0.00000
SRR6145060	Erwinia amylovora	552	S	8	2	10	0.00000
SRR6145060	Enterococcus gallinarum	1353	S	3	7	10	0.00000
SRR6145060	Enterococcus durans	53345	S	9	1	10	0.00000
SRR6145060	Endozoicomonas montiporae	1027273	S	10	0	10	0.00000
SRR6145060	Ectothiorhodospira haloalkaliphila	421628	S	8	2	10	0.00000
SRR6145060	Dysosmobacter welbionis	2093857	S	3	7	10	0.00000
SRR6145060	Desulfurivibrio alkaliphilus	427923	S	10	0	10	0.00000
SRR6145060	Desulfovibrio sp. G11	631220	S	8	10	18	0.00000
SRR6145060	Desulfosporosinus orientis	1563	S	10	0	10	0.00000
SRR6145060	Desulfococcus multivorans	897	S	10	0	10	0.00000
SRR6145060	Desulfitobacterium hafniense	49338	S	10	0	10	0.00000
SRR6145060	Desulfatibacillum aliphaticivorans	218208	S	10	0	10	0.00000
SRR6145060	Denitratisoma sp. DHT3	1981880	S	35	10	45	0.00001
SRR6145060	Deinococcus sp. NW-56	2080419	S	310	10	320	0.00004
SRR6145060	Cuniculiplasma divulgatum	1673428	S	9	1	10	0.00000
SRR6145060	Cronobacter muytjensii	413501	S	3	7	10	0.00000
SRR6145060	Clostridium tyrobutyricum	1519	S	10	0	10	0.00000
SRR6145060	Clostridium formicaceticum	1497	S	10	0	10	0.00000
SRR6145060	Cellvibrio sp. KY-GH-1	2303332	S	150	10	160	0.00002
SRR6145060	Candidatus Nitrotoga sp. AM1P	2559597	S	10	0	10	0.00000
SRR6145060	Campylobacter insulaenigrae	260714	S	10	0	10	0.00000
SRR6145060	Campylobacter canadensis	449520	S	10	0	10	0.00000
SRR6145060	Caldicellulosiruptor hydrothermalis	413888	S	5	5	10	0.00000
SRR6145060	Butyrivibrio fibrisolvens	831	S	10	0	10	0.00000
SRR6145060	Burkholderia sp. PAMC 26561	1795043	S	10	11	21	0.00000
SRR6145060	Burkholderia sp. KJ006	416344	S	2	10	12	0.00000
SRR6145060	Burkholderia sp. IDO3	1705310	S	35	10	45	0.00001
SRR6145060	Bifidobacterium actinocoloniiforme	638619	S	10	0	10	0.00000
SRR6145060	Bacillus smithii	1479	S	10	0	10	0.00000
SRR6145060	Bacillus muralis	264697	S	10	0	10	0.00000
SRR6145060	Bacillus methanolicus	1471	S	10	0	10	0.00000
SRR6145060	Bacillus foraminis	279826	S	10	0	10	0.00000
SRR6145060	Arcticibacterium luteifluviistationis	1784714	S	10	0	10	0.00000
SRR6145060	Arcobacter thereius	544718	S	9	1	10	0.00000
SRR6145060	Arcobacter peruensis	2320140	S	4	6	10	0.00000
SRR6145060	Arcobacter halophilus	197482	S	10	0	10	0.00000
SRR6145060	Aquicella siphonis	254247	S	10	0	10	0.00000
SRR6145060	Anoxybacillus kamchatkensis	196180	S	3	7	10	0.00000
SRR6145060	Anoxybacillus amylolyticus	294699	S	10	0	10	0.00000
SRR6145060	Aminipila butyrica	433296	S	10	0	10	0.00000
SRR6145060	Altererythrobacter sp. TH136	2067415	S	102	10	112	0.00001
SRR6145060	Alloactinosynnema sp. L-07	1653480	S	151	10	161	0.00002
SRR6145060	Agromyces sp. HY052	2585717	S	73	10	83	0.00001
SRR6145060	Adlercreutzia equolifaciens	446660	S	6	4	10	0.00000
SRR6145060	Acetohalobium arabaticum	28187	S	10	0	10	0.00000
SRR6145060	[Clostridium] hylemonae	89153	S	9	0	9	0.00000
SRR6145060	[Arcobacter] porcinus	1935204	S	8	1	9	0.00000
SRR6145060	Yersinia intermedia	631	S	3	6	9	0.00000
SRR6145060	Xylella fastidiosa	2371	S	9	0	9	0.00000
SRR6145060	Weissella cryptocerci	2506420	S	9	0	9	0.00000
SRR6145060	Vibrio anguillarum	55601	S	7	2	9	0.00000
SRR6145060	Ureaplasma parvum	134821	S	8	1	9	0.00000
SRR6145060	Thioploca ingrica	40754	S	9	0	9	0.00000
SRR6145060	Thermoproteus uzoniensis	184117	S	9	0	9	0.00000
SRR6145060	Thermoanaerobacter italicus	108150	S	3	6	9	0.00000
SRR6145060	Thermoactinomyces vulgaris	2026	S	9	0	9	0.00000
SRR6145060	Teredinibacter turnerae	2426	S	9	0	9	0.00000
SRR6145060	Synechocystis sp. PCC 6714	1147	S	9	1	10	0.00000
SRR6145060	Sulfitobacter sp. SK025	1389011	S	38	9	47	0.00001
SRR6145060	Streptomyces sp. SAT1	1849967	S	73	9	82	0.00001
SRR6145060	Streptomyces sp. S4.7	2705439	S	47	9	56	0.00001
SRR6145060	Streptomyces sp. RLB1-33	2721243	S	38	9	47	0.00001
SRR6145060	Streptomyces sp. CdTB01	1725411	S	84	9	93	0.00001
SRR6145060	Streptomyces sp. CLI2509	1984801	S	11	9	20	0.00000
SRR6145060	Stenotrophomonas sp. MYb57	1827305	S	3	9	12	0.00000
SRR6145060	Staphylococcus phage StB12	1147042	S	22	9	31	0.00000
SRR6145060	Sporosarcina ureilytica	298596	S	9	0	9	0.00000
SRR6145060	Spirosoma sp. BT328	2692134	S	27	9	36	0.00000
SRR6145060	Spiroplasma helicoides	216938	S	9	0	9	0.00000
SRR6145060	Spiroplasma eriocheiris	315358	S	9	0	9	0.00000
SRR6145060	Spiroplasma corruscae	216934	S	9	0	9	0.00000
SRR6145060	Spiribacter curvatus	1335757	S	9	0	9	0.00000
SRR6145060	Sphingomonas sp. Cra20	1327635	S	209	9	218	0.00003
SRR6145060	Sphaerochaeta globosa	1131703	S	9	0	9	0.00000
SRR6145060	Shigella boydii	621	S	1	8	9	0.00000
SRR6145060	Shewanella benthica	43661	S	9	0	9	0.00000
SRR6145060	Shewanella aestuarii	1028752	S	9	0	9	0.00000
SRR6145060	Saccharophagus degradans	86304	S	9	0	9	0.00000
SRR6145060	Rickettsia raoultii	369822	S	6	3	9	0.00000
SRR6145060	Rhodopirellula baltica	265606	S	9	0	9	0.00000
SRR6145060	Rhodoferax sp. BAB1	2741720	S	69	9	78	0.00001
SRR6145060	Psychrobacillus glaciei	2283160	S	9	0	9	0.00000
SRR6145060	Pseudomonas sp. R1-43-08	1173270	S	2	9	11	0.00000
SRR6145060	Pseudomonas sp. LPH1	1898684	S	53	9	62	0.00001
SRR6145060	Pseudomonas sp. ADAK22	2730851	S	5	9	14	0.00000
SRR6145060	Pseudomonas silesiensis	1853130	S	9	0	9	0.00000
SRR6145060	Pseudomonas granadensis	1421430	S	7	2	9	0.00000
SRR6145060	Pseudomonas fuscovaginae	50340	S	7	2	9	0.00000
SRR6145060	Pseudodesulfovibrio profundus	57320	S	8	1	9	0.00000
SRR6145060	Proteus columbae	1987580	S	7	2	9	0.00000
SRR6145060	Propionibacterium virus PHL301M00	1982301	S	19	9	28	0.00000
SRR6145060	Propionibacterium virus PHL114L00	1982287	S	41	9	50	0.00001
SRR6145060	Propionibacterium virus PAD20	1982271	S	10	9	19	0.00000
SRR6145060	Propionibacterium virus Lauchelly	1982257	S	36	9	45	0.00001
SRR6145060	Pragia fontium	82985	S	9	0	9	0.00000
SRR6145060	Planococcus sp. PAMC 21323	1526927	S	9	1	10	0.00000
SRR6145060	Planococcus antarcticus	161360	S	9	0	9	0.00000
SRR6145060	Planctopirus ephydatiae	2528019	S	9	0	9	0.00000
SRR6145060	Planctomycetes bacterium HG66A1	2527967	S	3	9	12	0.00000
SRR6145060	Petrotoga mobilis	69499	S	9	0	9	0.00000
SRR6145060	Pelobacter propionicus	29543	S	9	0	9	0.00000
SRR6145060	Pediococcus claussenii	187452	S	9	0	9	0.00000
SRR6145060	Paenibacillus sp. FSL H7-0357	1536774	S	9	0	9	0.00000
SRR6145060	Octadecabacter arcticus	53946	S	9	0	9	0.00000
SRR6145060	Nitrosomonas eutropha	916	S	9	0	9	0.00000
SRR6145060	Neorhizobium sp. SOG26	2060726	S	117	9	126	0.00002
SRR6145060	Nautilia profundicola	244787	S	9	0	9	0.00000
SRR6145060	Mycoplasma canis	29555	S	9	0	9	0.00000
SRR6145060	Mycobacterium ulcerans	1809	S	4	5	9	0.00000
SRR6145060	Moritella marina	90736	S	9	0	9	0.00000
SRR6145060	Moorella thermoacetica	1525	S	9	0	9	0.00000
SRR6145060	Mixta intestinalis	1615494	S	9	0	9	0.00000
SRR6145060	Microbulbifer aggregans	1769779	S	9	0	9	0.00000
SRR6145060	Microbacterium sp. LKL04	912630	S	155	9	164	0.00002
SRR6145060	Microbacterium sp. CBA3102	2603598	S	118	9	127	0.00002
SRR6145060	Methanosarcina vacuolata	2215	S	4	5	9	0.00000
SRR6145060	Methanococcus voltae	2188	S	9	0	9	0.00000
SRR6145060	Methanocaldococcus vulcanius	73913	S	9	0	9	0.00000
SRR6145060	Methanobrevibacter smithii	2173	S	9	0	9	0.00000
SRR6145060	Methanobrevibacter olleyae	294671	S	9	0	9	0.00000
SRR6145060	Metakosakonia sp. MRY16-398	2487150	S	3	9	12	0.00000
SRR6145060	Mesorhizobium sp. M7A.F.Ce.TU.012.03.2.1	2493681	S	28	9	37	0.00000
SRR6145060	Mesorhizobium sp. M3A.F.Ca.ET.080.04.2.1	2493676	S	38	9	47	0.00001
SRR6145060	Mesorhizobium sp. DCY119	2108445	S	79	9	88	0.00001
SRR6145060	Marinobacter adhaerens	1033846	S	5	4	9	0.00000
SRR6145060	Lysinibacillus varians	1145276	S	2	7	9	0.00000
SRR6145060	Listeria innocua	1642	S	9	0	9	0.00000
SRR6145060	Leptospira santarosai	28183	S	8	1	9	0.00000
SRR6145060	Leifsonia sp. PS1209	2724914	S	98	9	107	0.00001
SRR6145060	Legionella fallonii	96230	S	9	0	9	0.00000
SRR6145060	Legionella anisa	28082	S	9	0	9	0.00000
SRR6145060	Lactobacillus parabuchneri	152331	S	9	0	9	0.00000
SRR6145060	Lactobacillus oligofermentans	293371	S	9	0	9	0.00000
SRR6145060	Lactobacillus heilongjiangensis	1074467	S	9	0	9	0.00000
SRR6145060	Lactobacillus alimentarius	1602	S	9	0	9	0.00000
SRR6145060	Lactobacillus acetotolerans	1600	S	9	0	9	0.00000
SRR6145060	Komagataeibacter oboediens	65958	S	9	0	9	0.00000
SRR6145060	Klebsiella sp. FDAARGOS_511	2488567	S	22	9	31	0.00000
SRR6145060	Hungateiclostridium clariflavum	288965	S	9	0	9	0.00000
SRR6145060	Helicobacter cetorum	138563	S	9	0	9	0.00000
SRR6145060	Halomicronema hongdechloris	1209493	S	9	0	9	0.00000
SRR6145060	Halocynthiibacter arcticus	1579316	S	9	0	9	0.00000
SRR6145060	Halobacterium sp. DL1	751944	S	23	9	32	0.00000
SRR6145060	Haloarcula marismortui	2238	S	7	2	9	0.00000
SRR6145060	Halioglobus japonicus	930805	S	9	0	9	0.00000
SRR6145060	Halarcobacter ebronensis	1462615	S	9	0	9	0.00000
SRR6145060	Haemophilus aegyptius	197575	S	1	8	9	0.00000
SRR6145060	Gloeobacter violaceus	33072	S	9	0	9	0.00000
SRR6145060	Geobacter anodireducens	1340425	S	6	3	9	0.00000
SRR6145060	Francisella salina	573569	S	4	5	9	0.00000
SRR6145060	Francisella frigiditurris	1542390	S	9	0	9	0.00000
SRR6145060	Faecalibaculum rodentium	1702221	S	9	0	9	0.00000
SRR6145060	Erysipelothrix larvae	1514105	S	9	0	9	0.00000
SRR6145060	Ereboglobus luteus	1796921	S	9	0	9	0.00000
SRR6145060	Enterobacter sp. E20	1560339	S	4	9	13	0.00000
SRR6145060	Emcibacter congregatus	2043170	S	9	0	9	0.00000
SRR6145060	Ehrlichia ruminantium	779	S	9	0	9	0.00000
SRR6145060	Echinicola strongylocentroti	1795355	S	9	0	9	0.00000
SRR6145060	Dysgonomonas sp. HDW5B	2714927	S	8	9	17	0.00000
SRR6145060	Desulfovibrio piger	901	S	9	0	9	0.00000
SRR6145060	Desulfohalobium retbaense	45663	S	9	0	9	0.00000
SRR6145060	Desulfoglaeba alkanexedens	361111	S	9	0	9	0.00000
SRR6145060	Desulfobacter postgatei	2293	S	9	0	9	0.00000
SRR6145060	Desulfobacca acetoxidans	60893	S	9	0	9	0.00000
SRR6145060	Croceibacter atlanticus	313588	S	9	0	9	0.00000
SRR6145060	Citrobacter rodentium	67825	S	9	0	9	0.00000
SRR6145060	Chthonomonas calidirosea	454171	S	9	0	9	0.00000
SRR6145060	Chryseobacterium sp. 6424	2039166	S	207	9	216	0.00003
SRR6145060	Christensenella minuta	626937	S	9	0	9	0.00000
SRR6145060	Chondrocystis sp. NIES-4102	2005460	S	26	9	35	0.00000
SRR6145060	Cellulosimicrobium sp. BI34T	2587808	S	95	9	104	0.00001
SRR6145060	Campylobacter helveticus	28898	S	9	0	9	0.00000
SRR6145060	Caloranaerobacter azorensis	116090	S	9	0	9	0.00000
SRR6145060	Butyrivibrio proteoclasticus	43305	S	9	0	9	0.00000
SRR6145060	Buttiauxella agrestis	82977	S	9	0	9	0.00000
SRR6145060	Bradyrhizobium sp. CCGE-LA001	1223566	S	61	9	70	0.00001
SRR6145060	Borreliella afzelii	29518	S	5	4	9	0.00000
SRR6145060	Blattabacterium punctulatus	164514	S	6	3	9	0.00000
SRR6145060	Bifidobacterium angulatum	1683	S	9	0	9	0.00000
SRR6145060	Basilea psittacipulmonis	1472345	S	9	0	9	0.00000
SRR6145060	Bartonella krasnovii	2267275	S	8	1	9	0.00000
SRR6145060	Bacillus thermocopriae	1215031	S	9	0	9	0.00000
SRR6145060	Bacillus miscanthi	2598861	S	9	0	9	0.00000
SRR6145060	Bacillus mesonae	1193713	S	9	0	9	0.00000
SRR6145060	Anoxybacillus sp. PDR2	1636720	S	3	9	12	0.00000
SRR6145060	Amycolatopsis sp. AA4	1896961	S	150	9	159	0.00002
SRR6145060	Allopseudarcicella aquatilis	998844	S	9	0	9	0.00000
SRR6145060	Advenella kashmirensis	310575	S	9	0	9	0.00000
SRR6145060	Acinetobacter sp. WCHAc010052	2004647	S	45	9	54	0.00001
SRR6145060	Acinetobacter sp. WCHAc010034	1879049	S	132	9	141	0.00002
SRR6145060	Acinetobacter sp. LoGeW2-3	1808001	S	214	9	223	0.00003
SRR6145060	Acinetobacter sp. C16S1	2609668	S	49	9	58	0.00001
SRR6145060	Acidianus manzaensis	282676	S	9	0	9	0.00000
SRR6145060	Acetobacterium woodii	33952	S	6	3	9	0.00000
SRR6145060	Xylella taiwanensis	1444770	S	8	0	8	0.00000
SRR6145060	Weissella koreensis	165096	S	8	0	8	0.00000
SRR6145060	Vibrio tubiashii	29498	S	6	2	8	0.00000
SRR6145060	Vibrio tritonius	1435069	S	8	0	8	0.00000
SRR6145060	Vibrio alfacsensis	1074311	S	8	0	8	0.00000
SRR6145060	Treponema caldarium	215591	S	8	0	8	0.00000
SRR6145060	Thiomicrospira aerophila	92245	S	8	0	8	0.00000
SRR6145060	Thermus scotoductus	37636	S	8	0	8	0.00000
SRR6145060	Thermus aquaticus	271	S	8	0	8	0.00000
SRR6145060	Thermosynechococcus vulcanus	32053	S	1	7	8	0.00000
SRR6145060	Thermoleptolyngbya sp. PKUAC-SCTA183	2737172	S	10	8	18	0.00000
SRR6145060	Thermoanaerobacterium xylanolyticum	29329	S	7	1	8	0.00000
SRR6145060	Tetrasphaera sp. HKS02	1813880	S	174	8	182	0.00002
SRR6145060	Tatumella citrea	53336	S	8	0	8	0.00000
SRR6145060	Tardiphaga sp. vice154	2592814	S	1	8	9	0.00000
SRR6145060	Syntrophobotulus glycolicus	51197	S	8	0	8	0.00000
SRR6145060	Synechococcus sp. WH 8101	59932	S	8	1	9	0.00000
SRR6145060	Swingsia samuiensis	1293412	S	8	0	8	0.00000
SRR6145060	Sulfurospirillum sp. SL2-1	1986224	S	1	8	9	0.00000
SRR6145060	Sulfitobacter sp. D7	1968541	S	36	8	44	0.00001
SRR6145060	Succinivibrio dextrinosolvens	83771	S	8	0	8	0.00000
SRR6145060	Streptomyces sp. Z022	1442032	S	71	8	79	0.00001
SRR6145060	Streptomyces sp. W1SF4	2305220	S	61	8	69	0.00001
SRR6145060	Streptomyces sp. T44	2686304	S	70	8	78	0.00001
SRR6145060	Streptomyces sp. M2	646637	S	81	8	89	0.00001
SRR6145060	Streptomyces sp. GS7	2692234	S	86	8	94	0.00001
SRR6145060	Streptomyces sp. CCM_MD2014	1561022	S	25	8	33	0.00000
SRR6145060	Streptomyces sp. 3214.6	1882757	S	71	8	79	0.00001
SRR6145060	Starkeya sp. ORNL1	2709380	S	106	8	114	0.00002
SRR6145060	Spiroplasma floricola	216937	S	8	0	8	0.00000
SRR6145060	Spiroplasma chrysopicola	216933	S	8	0	8	0.00000
SRR6145060	Sphingomonas sp. HKS19	1813879	S	270	8	278	0.00004
SRR6145060	Sphingomonas sp. C33	2698679	S	171	8	179	0.00002
SRR6145060	Sodalis glossinidius	63612	S	8	0	8	0.00000
SRR6145060	Simiduia agarivorans	447471	S	8	0	8	0.00000
SRR6145060	Shewanella violacea	60217	S	8	0	8	0.00000
SRR6145060	Shewanella psychrophila	225848	S	8	0	8	0.00000
SRR6145060	Shewanella loihica	359303	S	8	0	8	0.00000
SRR6145060	Shewanella halifaxensis	271098	S	8	0	8	0.00000
SRR6145060	Serratia sp. ATCC 39006	104623	S	8	0	8	0.00000
SRR6145060	Serratia liquefaciens	614	S	6	2	8	0.00000
SRR6145060	Rickettsia typhi	785	S	6	2	8	0.00000
SRR6145060	Pseudomonas sp. URMO17WK12:I11	1283291	S	17	8	25	0.00000
SRR6145060	Pseudomonas sp. SWI7	2587597	S	2	8	10	0.00000
SRR6145060	Pseudomonas sp. Lz4W	1206777	S	6	8	14	0.00000
SRR6145060	Pseudomonas sp. DTU12.1	2654238	S	3	8	11	0.00000
SRR6145060	Pseudomonas asplenii	53407	S	6	2	8	0.00000
SRR6145060	Pseudoclostridium thermosuccinogenes	84032	S	8	0	8	0.00000
SRR6145060	Proteus cibarius	626774	S	5	3	8	0.00000
SRR6145060	Propionibacterium virus Pacnes201215	1982270	S	47	8	55	0.00001
SRR6145060	Propionibacterium virus Kubed	1982256	S	20	8	28	0.00000
SRR6145060	Polaribacter sp. KT 15	1896175	S	8	9	17	0.00000
SRR6145060	Polaribacter sp. BM10	1529069	S	7	8	15	0.00000
SRR6145060	Plantactinospora sp. KBS50	2024580	S	112	8	120	0.00002
SRR6145060	Planctomycetes bacterium Mal33	2527992	S	5	8	13	0.00000
SRR6145060	Phascolarctobacterium succinatutens	626940	S	3	5	8	0.00000
SRR6145060	Pectobacterium punjabense	2108399	S	7	1	8	0.00000
SRR6145060	Pasteurellaceae bacterium NI1060	1679001	S	5	8	13	0.00000
SRR6145060	Parasaccharibacter apium	1510841	S	8	0	8	0.00000
SRR6145060	Paraglaciecola psychrophila	326544	S	8	0	8	0.00000
SRR6145060	Paenisporosarcina antarctica	417367	S	8	0	8	0.00000
SRR6145060	Paenibacillus yonginensis	1462996	S	8	0	8	0.00000
SRR6145060	Paenibacillus sp. FSL H7-0737	1536775	S	8	1	9	0.00000
SRR6145060	Paenibacillus riograndensis	483937	S	8	0	8	0.00000
SRR6145060	Paenibacillus donghaensis	414771	S	8	0	8	0.00000
SRR6145060	Paenibacillus cellulositrophicus	562959	S	8	0	8	0.00000
SRR6145060	Paenibacillus barcinonensis	198119	S	8	0	8	0.00000
SRR6145060	Paenibacillus alvei	44250	S	8	0	8	0.00000
SRR6145060	Novosphingobium sp. THN1	1016987	S	98	8	106	0.00001
SRR6145060	Mycoplasma synoviae	2109	S	8	0	8	0.00000
SRR6145060	Mycoplasma hyopneumoniae	2099	S	8	0	8	0.00000
SRR6145060	Mycoplasma crocodyli	50052	S	8	0	8	0.00000
SRR6145060	Mycoplasma anserisalpingitidis	519450	S	8	0	8	0.00000
SRR6145060	Mycoavidus cysteinexigens	1553431	S	8	0	8	0.00000
SRR6145060	Microbacterium sp. PM5	2014534	S	199	8	207	0.00003
SRR6145060	Methylophilus medardicus	2588534	S	8	0	8	0.00000
SRR6145060	Methylacidiphilum fumariolicum	591154	S	6	2	8	0.00000
SRR6145060	Methanotorris igneus	2189	S	8	0	8	0.00000
SRR6145060	Methanocaldococcus fervens	83171	S	8	0	8	0.00000
SRR6145060	Mesorhizobium sp. M7D.F.Ca.US.005.01.1.1	2493678	S	27	8	35	0.00000
SRR6145060	Maribacter sp. 1_2014MBL_MicDiv	1644130	S	9	8	17	0.00000
SRR6145060	Lysinibacillus sphaericus	1421	S	5	3	8	0.00000
SRR6145060	Lysinibacillus fusiformis	28031	S	5	3	8	0.00000
SRR6145060	Litoricola lipolytica	418701	S	8	0	8	0.00000
SRR6145060	Liberibacter crescens	1273132	S	8	0	8	0.00000
SRR6145060	Leptospira mayottensis	1137606	S	5	3	8	0.00000
SRR6145060	Legionella oakridgensis	29423	S	8	0	8	0.00000
SRR6145060	Legionella israelensis	454	S	8	0	8	0.00000
SRR6145060	Lactobacillus paraplantarum	60520	S	8	0	8	0.00000
SRR6145060	Lactobacillus kullabergensis	1218493	S	8	0	8	0.00000
SRR6145060	Lactobacillus backii	375175	S	7	1	8	0.00000
SRR6145060	Lacrimispora sphenoides	29370	S	8	0	8	0.00000
SRR6145060	Hymenobacter sp. DG25B	1385664	S	39	8	47	0.00001
SRR6145060	Helicobacter sp. MIT 01-6242	222136	S	8	0	8	0.00000
SRR6145060	Helicobacter himalayensis	1591088	S	8	0	8	0.00000
SRR6145060	Halothiobacillus neapolitanus	927	S	8	0	8	0.00000
SRR6145060	Haloplanus sp. CBA1112	1547898	S	2	8	10	0.00000
SRR6145060	Halomonas alkaliphila	272774	S	5	3	8	0.00000
SRR6145060	Halohasta litchfieldiae	1073996	S	7	1	8	0.00000
SRR6145060	Halobacillus mangrovi	402384	S	8	0	8	0.00000
SRR6145060	Halobacillus litoralis	45668	S	8	0	8	0.00000
SRR6145060	Halalkaliarchaeum desulfuricum	2055893	S	8	0	8	0.00000
SRR6145060	Frondihabitans sp. 762G35	1446794	S	95	8	103	0.00001
SRR6145060	Francisella uliginis	573570	S	8	0	8	0.00000
SRR6145060	Exiguobacterium antarcticum	132920	S	8	0	8	0.00000
SRR6145060	Entomoplasma melaleucae	81459	S	8	0	8	0.00000
SRR6145060	Enterobacter sp. E76	2596949	S	30	8	38	0.00001
SRR6145060	Ehrlichia canis	944	S	8	0	8	0.00000
SRR6145060	Echinicola rosea	1807691	S	8	0	8	0.00000
SRR6145060	Desulfovibrio hydrothermalis	191026	S	8	0	8	0.00000
SRR6145060	Desulfovibrio ferrophilus	241368	S	8	0	8	0.00000
SRR6145060	Desulfosporosinus meridiei	79209	S	8	0	8	0.00000
SRR6145060	Desulfosporosinus acidiphilus	885581	S	8	0	8	0.00000
SRR6145060	Desulfitobacterium dehalogenans	36854	S	8	0	8	0.00000
SRR6145060	Desulfallas gibsoniae	102134	S	8	0	8	0.00000
SRR6145060	Cryptobacterium curtum	84163	S	8	0	8	0.00000
SRR6145060	Cronobacter sp. JZ38	1906275	S	4	8	12	0.00000
SRR6145060	Coriobacterium glomerans	33871	S	8	0	8	0.00000
SRR6145060	Coraliomargarita akajimensis	395922	S	8	0	8	0.00000
SRR6145060	Congregibacter litoralis	393662	S	7	1	8	0.00000
SRR6145060	Clostridium autoethanogenum	84023	S	2	6	8	0.00000
SRR6145060	Chryseobacterium sp. 3008163	2478663	S	203	8	211	0.00003
SRR6145060	Chromobacterium sp. 257-1	2605945	S	25	8	33	0.00000
SRR6145060	Chlorobium chlorochromatii	337090	S	8	0	8	0.00000
SRR6145060	Chlorobaculum parvum	274539	S	7	1	8	0.00000
SRR6145060	Cellvibrio sp. KY-YJ-3	454662	S	69	8	77	0.00001
SRR6145060	Candidatus Pelagibacter sp. HIMB1321	1388755	S	8	0	8	0.00000
SRR6145060	Candidatus Hamiltonella defensa	138072	S	17	8	25	0.00000
SRR6145060	Campylobacter lari	201	S	8	0	8	0.00000
SRR6145060	Campylobacter avium	522485	S	8	0	8	0.00000
SRR6145060	Calditerrivibrio nitroreducens	477976	S	8	0	8	0.00000
SRR6145060	Burkholderia sp. NRF60-BP8	1637853	S	17	8	25	0.00000
SRR6145060	Bradyrhizobium sp. 1(2017)	1404888	S	47	8	55	0.00001
SRR6145060	Borrelia miyamotoi	47466	S	8	0	8	0.00000
SRR6145060	Blautia sp. SC05B48	2479767	S	52	8	60	0.00001
SRR6145060	Blattabacterium cuenoti	1653831	S	8	0	8	0.00000
SRR6145060	Bartonella vinsonii	33047	S	8	0	8	0.00000
SRR6145060	Bacillus sonorensis	119858	S	8	0	8	0.00000
SRR6145060	Bacillus gobiensis	1441095	S	8	0	8	0.00000
SRR6145060	Bacillus cytotoxicus	580165	S	8	0	8	0.00000
SRR6145060	Avibacterium volantium	762	S	8	0	8	0.00000
SRR6145060	Aneurinibacillus soli	1500254	S	8	0	8	0.00000
SRR6145060	Anaerotignum propionicum	28446	S	8	0	8	0.00000
SRR6145060	Anaerohalosphaera lusitana	1936003	S	8	0	8	0.00000
SRR6145060	Akkermansia muciniphila	239935	S	7	1	8	0.00000
SRR6145060	Actinomyces sp. 2129	2321394	S	52	8	60	0.00001
SRR6145060	Actinobacillus indolicus	51049	S	7	1	8	0.00000
SRR6145060	Actinobacillus delphinicola	51161	S	8	0	8	0.00000
SRR6145060	Acidovorax sp. HDW3	2714923	S	54	8	62	0.00001
SRR6145060	Acholeplasma oculi	35623	S	8	0	8	0.00000
SRR6145060	Acholeplasma axanthum	29552	S	8	0	8	0.00000
SRR6145060	Acetobacter oryzoeni	2500548	S	5	3	8	0.00000
SRR6145060	Zhongshania aliphaticivorans	1470434	S	7	0	7	0.00000
SRR6145060	Yersinia similis	367190	S	7	0	7	0.00000
SRR6145060	Xenorhabdus poinarii	40577	S	7	0	7	0.00000
SRR6145060	Virgibacillus halodenitrificans	1482	S	6	1	7	0.00000
SRR6145060	Vibrio panuliri	1381081	S	7	0	7	0.00000
SRR6145060	Vibrio diabolicus	50719	S	1	6	7	0.00000
SRR6145060	Variovorax sp. HW608	1034889	S	120	7	127	0.00002
SRR6145060	Turicibacter sanguinis	154288	S	7	0	7	0.00000
SRR6145060	Thermus oshimai	56957	S	7	0	7	0.00000
SRR6145060	Thermus brockianus	56956	S	7	0	7	0.00000
SRR6145060	Thermosediminibacter oceani	291990	S	7	0	7	0.00000
SRR6145060	Thermodesulfobacterium commune	1741	S	7	0	7	0.00000
SRR6145060	Thermoanaerobacter wiegelii	46354	S	2	5	7	0.00000
SRR6145060	Thermoanaerobacter siderophilus	106578	S	1	6	7	0.00000
SRR6145060	Thermoanaerobacter kivui	2325	S	5	2	7	0.00000
SRR6145060	Thalassotalea crassostreae	1763536	S	7	0	7	0.00000
SRR6145060	Synechococcus sp. WH 7803	32051	S	7	0	7	0.00000
SRR6145060	Synechococcus sp. PCC 6312	195253	S	7	0	7	0.00000
SRR6145060	Sulfuriferula nivalis	2675298	S	7	0	7	0.00000
SRR6145060	Streptomyces sp. Tu6071	355249	S	9	7	16	0.00000
SRR6145060	Streptomyces sp. Sge12	1972846	S	15	7	22	0.00000
SRR6145060	Streptomyces sp. P3	2135430	S	79	7	86	0.00001
SRR6145060	Streptomyces sp. Mg1	465541	S	26	7	33	0.00000
SRR6145060	Streptomyces sp. GY16	2653200	S	79	7	86	0.00001
SRR6145060	Streptomyces sp. 2323.1	1938841	S	59	7	66	0.00001
SRR6145060	Staphylospora marina	2490858	S	7	0	7	0.00000
SRR6145060	Staphylococcus virus Sextaec	1922246	S	16	7	23	0.00000
SRR6145060	Staphylococcus delphini	53344	S	7	0	7	0.00000
SRR6145060	Spirosoma sp. I-24	2666025	S	24	7	31	0.00000
SRR6145060	Spiroplasma culicicola	216935	S	7	0	7	0.00000
SRR6145060	Spiroplasma clarkii	2139	S	7	0	7	0.00000
SRR6145060	Spiroplasma alleghenense	216931	S	7	0	7	0.00000
SRR6145060	Spirochaeta thermophila	154	S	7	0	7	0.00000
SRR6145060	Sphingomonas sp. XS-10	2599297	S	233	7	240	0.00003
SRR6145060	Sphingomonas sp. AP4-R1	2735134	S	246	7	253	0.00003
SRR6145060	Shigella sonnei	624	S	1	6	7	0.00000
SRR6145060	Shewanella woodyi	60961	S	7	0	7	0.00000
SRR6145060	Shewanella pealeana	70864	S	7	0	7	0.00000
SRR6145060	Shewanella denitrificans	192073	S	7	0	7	0.00000
SRR6145060	Serratia sp. FS14	1327989	S	3	7	10	0.00000
SRR6145060	Salicibibacter halophilus	2502791	S	7	0	7	0.00000
SRR6145060	Saccharopolyspora sp. ASAGF58	2719023	S	113	7	120	0.00002
SRR6145060	Saccharolobus solfataricus	2287	S	7	0	7	0.00000
SRR6145060	Ruegeria sp. THAF33	2587853	S	26	7	33	0.00000
SRR6145060	Roseovarius sp. THAF9	2587847	S	32	7	39	0.00001
SRR6145060	Rhodoluna limnophila	232537	S	7	0	7	0.00000
SRR6145060	Rhodocyclaceae bacterium ICHIJ1	1816604	S	1	7	8	0.00000
SRR6145060	Psychrobacter sp. P2G3	1699622	S	13	7	20	0.00000
SRR6145060	Pseudomonas sp. SXM-1	2169583	S	4	7	11	0.00000
SRR6145060	Pseudomonas sp. NC02	2067572	S	4	7	11	0.00000
SRR6145060	Pseudomonas sp. MYb193	1827300	S	9	7	16	0.00000
SRR6145060	Pseudomonas prosekii	1148509	S	7	0	7	0.00000
SRR6145060	Pseudomonas mandelii	75612	S	4	3	7	0.00000
SRR6145060	Pseudoalteromonas ruthenica	151081	S	5	2	7	0.00000
SRR6145060	Proteus hauseri	183417	S	7	0	7	0.00000
SRR6145060	Propionibacterium virus PHL171M01	1982297	S	42	7	49	0.00001
SRR6145060	Propionibacterium virus PHL041M10	1982276	S	10	7	17	0.00000
SRR6145060	Propionibacterium virus PAS50	1982272	S	8	7	15	0.00000
SRR6145060	Pontimonas salivibrio	1159327	S	7	0	7	0.00000
SRR6145060	Pleurocapsa minor	54308	S	6	1	7	0.00000
SRR6145060	Planktomarina temperata	1284658	S	7	0	7	0.00000
SRR6145060	Planctopirus limnophila	120	S	7	0	7	0.00000
SRR6145060	Planctomyces sp. SH-PL62	1636152	S	92	7	99	0.00001
SRR6145060	Photorhabdus thracensis	230089	S	7	0	7	0.00000
SRR6145060	Photobacterium profundum	74109	S	7	0	7	0.00000
SRR6145060	Pelolinea submarina	913107	S	7	0	7	0.00000
SRR6145060	Pelodictyon luteolum	1100	S	7	0	7	0.00000
SRR6145060	Parashewanella spongiae	342950	S	7	0	7	0.00000
SRR6145060	Pandoravirus macleodensis	2107707	S	7	0	7	0.00000
SRR6145060	Pandoravirus inopinatum	1605721	S	6	1	7	0.00000
SRR6145060	Paenibacillus sp. M-152	2487928	S	2	7	9	0.00000
SRR6145060	Paenibacillus sp. IHBB 10380	1566358	S	7	0	7	0.00000
SRR6145060	Paenibacillus protaetiae	2509456	S	7	0	7	0.00000
SRR6145060	Paenibacillus lautus	1401	S	7	0	7	0.00000
SRR6145060	Paenibacillus ihbetae	1870820	S	7	0	7	0.00000
SRR6145060	Paenibacillus chitinolyticus	79263	S	7	0	7	0.00000
SRR6145060	Paenibacillus cellulosilyticus	375489	S	7	0	7	0.00000
SRR6145060	Paenibacillus borealis	160799	S	7	0	7	0.00000
SRR6145060	Oleiphilus messinensis	141451	S	7	0	7	0.00000
SRR6145060	Oenococcus sp. UCMA 16435	2259623	S	7	0	7	0.00000
SRR6145060	Nitrospira japonica	1325564	S	7	0	7	0.00000
SRR6145060	Nitrosomonadales bacterium Swamp67	2732487	S	35	7	42	0.00001
SRR6145060	Natronolimnobius sulfurireducens	2044521	S	7	0	7	0.00000
SRR6145060	Myroides sp. A21	1583100	S	7	7	14	0.00000
SRR6145060	Mycoplasma phocirhinis	142650	S	7	0	7	0.00000
SRR6145060	Mycoplasma maculosum	114885	S	7	0	7	0.00000
SRR6145060	Mycoplasma hyorhinis	2100	S	7	0	7	0.00000
SRR6145060	Mycoplasma felis	33923	S	7	0	7	0.00000
SRR6145060	Mycoplasma arthritidis	2111	S	7	0	7	0.00000
SRR6145060	Mycobacterium sp. DL440	2675523	S	130	7	137	0.00002
SRR6145060	Methylomonas methanica	421	S	7	0	7	0.00000
SRR6145060	Methanothermus fervidus	2180	S	7	0	7	0.00000
SRR6145060	Methanosphaera stadtmanae	2317	S	7	0	7	0.00000
SRR6145060	Methanosarcina acetivorans	2214	S	7	0	7	0.00000
SRR6145060	Methanosaeta harundinacea	301375	S	7	0	7	0.00000
SRR6145060	Methanobacterium subterraneum	59277	S	3	4	7	0.00000
SRR6145060	Methanobacterium formicicum	2162	S	7	0	7	0.00000
SRR6145060	Mesorhizobium sp. NZP2234	2483402	S	1	7	8	0.00000
SRR6145060	Mesorhizobium sp. M4B.F.Ca.ET.058.02.1.1	2493675	S	30	7	37	0.00000
SRR6145060	Mesorhizobium sp. 8	2584466	S	85	7	92	0.00001
SRR6145060	Megamonas hypermegale	158847	S	7	0	7	0.00000
SRR6145060	Marinomonas primoryensis	178399	S	7	0	7	0.00000
SRR6145060	Marinobacter similis	1420916	S	7	0	7	0.00000
SRR6145060	Marinobacter salinus	1874317	S	7	0	7	0.00000
SRR6145060	Maribacter cobaltidurans	1178778	S	7	0	7	0.00000
SRR6145060	Lysobacter sp. TY2-98	2290922	S	143	7	150	0.00002
SRR6145060	Listeria weihenstephanensis	1006155	S	7	0	7	0.00000
SRR6145060	Leptolyngbya sp. O-77	1080068	S	10	7	17	0.00000
SRR6145060	Lelliottia jeotgali	1907578	S	7	0	7	0.00000
SRR6145060	Legionella jordanis	456	S	7	0	7	0.00000
SRR6145060	Lactobacillus terrae	2269374	S	7	0	7	0.00000
SRR6145060	Lactobacillus pentosus	1589	S	7	0	7	0.00000
SRR6145060	Lactobacillus paralimentarius	83526	S	7	0	7	0.00000
SRR6145060	Lactobacillus nenjiangensis	1296540	S	7	0	7	0.00000
SRR6145060	Lactobacillus mali	1618	S	7	0	7	0.00000
SRR6145060	Lactobacillus lindneri	53444	S	7	0	7	0.00000
SRR6145060	Lactobacillus hokkaidonensis	1193095	S	7	0	7	0.00000
SRR6145060	Lactobacillus bifermentans	1607	S	7	0	7	0.00000
SRR6145060	Lactobacillus acidipiscis	89059	S	7	0	7	0.00000
SRR6145060	Lacimicrobium alkaliphilum	1526571	S	7	0	7	0.00000
SRR6145060	Klebsiella sp. LY	2015795	S	1	7	8	0.00000
SRR6145060	Kangiella sediminilitoris	1144748	S	7	0	7	0.00000
SRR6145060	Jeotgalibaca dankookensis	708126	S	7	0	7	0.00000
SRR6145060	Jeotgalibaca arthritidis	1868794	S	4	3	7	0.00000
SRR6145060	Hydrogenovibrio crunogenus	39765	S	7	0	7	0.00000
SRR6145060	Helicobacter cinaedi	213	S	6	1	7	0.00000
SRR6145060	Haloquadratum walsbyi	293091	S	7	0	7	0.00000
SRR6145060	Halomonas sp. KO116	1504981	S	91	7	98	0.00001
SRR6145060	Halioglobus maricola	2601894	S	7	0	7	0.00000
SRR6145060	Halanaerobium hydrogeniformans	656519	S	7	0	7	0.00000
SRR6145060	Gynuella sunshinyii	1445505	S	7	0	7	0.00000
SRR6145060	Gordonia virus Getalong	2734200	S	2	7	9	0.00000
SRR6145060	Geobacter lovleyi	313985	S	7	0	7	0.00000
SRR6145060	Gemmata sp. SH-PL17	1630693	S	24	7	31	0.00000
SRR6145060	Francisella persica	954	S	7	0	7	0.00000
SRR6145060	Fischerella sp. NIES-3754	1752063	S	11	7	18	0.00000
SRR6145060	Eubacterium maltosivorans	2041044	S	5	2	7	0.00000
SRR6145060	Erwinia sp. Ejp617	215689	S	10	7	17	0.00000
SRR6145060	Erwinia pyrifoliae	79967	S	4	3	7	0.00000
SRR6145060	Enterocloster clostridioformis	1531	S	3	4	7	0.00000
SRR6145060	Enterobacter sp. 18A13	2565914	S	2	7	9	0.00000
SRR6145060	Dysgonomonas sp. HDW5A	2714926	S	6	7	13	0.00000
SRR6145060	Duganella sp. AF9R3	2728021	S	88	7	95	0.00001
SRR6145060	Dictyoglomus turgidum	513050	S	7	0	7	0.00000
SRR6145060	Dickeya sp. NCPPB 3274	568766	S	7	1	8	0.00000
SRR6145060	Dickeya solani	1089444	S	7	0	7	0.00000
SRR6145060	Diaphorobacter sp. HDW4B	2714925	S	52	7	59	0.00001
SRR6145060	Desulfurobacterium thermolithotrophum	64160	S	7	0	7	0.00000
SRR6145060	Desulfotomaculum ruminis	1564	S	7	0	7	0.00000
SRR6145060	Desulfotomaculum ferrireducens	1833852	S	7	0	7	0.00000
SRR6145060	Desulfofarcimen acetoxidans	58138	S	7	0	7	0.00000
SRR6145060	Desulfobacula toluolica	28223	S	7	0	7	0.00000
SRR6145060	Denitrovibrio acetiphilus	118000	S	7	0	7	0.00000
SRR6145060	Defluviitoga tunisiensis	1006576	S	7	0	7	0.00000
SRR6145060	Colwellia sp. PAMC 20917	1816218	S	7	0	7	0.00000
SRR6145060	Colwellia psychrerythraea	28229	S	7	0	7	0.00000
SRR6145060	Colwellia beringensis	1967665	S	7	0	7	0.00000
SRR6145060	Chloroflexus aggregans	152260	S	7	0	7	0.00000
SRR6145060	Chania multitudinisentens	1639108	S	7	0	7	0.00000
SRR6145060	Carboxydothermus hydrogenoformans	129958	S	7	0	7	0.00000
SRR6145060	Capnocytophaga sp. H4358	1945658	S	4	7	11	0.00000
SRR6145060	Candidatus Thioglobus sp. NP1	2508687	S	7	0	7	0.00000
SRR6145060	Candidatus Saccharibacteria bacterium YM_S32_TM7_50_20	2056494	S	7	0	7	0.00000
SRR6145060	Campylobacter sp. CCUG 57310	2517362	S	7	0	7	0.00000
SRR6145060	Campylobacter peloridis	488546	S	7	0	7	0.00000
SRR6145060	Campylobacter hepaticus	1813019	S	7	0	7	0.00000
SRR6145060	Caminibacter mediatlanticus	291048	S	7	0	7	0.00000
SRR6145060	Butyrivibrio hungatei	185008	S	7	0	7	0.00000
SRR6145060	Burkholderiales bacterium JOSHI_001	864051	S	129	7	136	0.00002
SRR6145060	Burkholderia mallei	13373	S	1	6	7	0.00000
SRR6145060	Burkholderia latens	488446	S	2	5	7	0.00000
SRR6145060	Bremerella volcania	2527984	S	7	0	7	0.00000
SRR6145060	Bradyrhizobium sp. BTAi1	288000	S	90	7	97	0.00001
SRR6145060	Bradyrhizobiaceae bacterium SG-6C	709797	S	79	7	86	0.00001
SRR6145060	Borreliella garinii	29519	S	2	5	7	0.00000
SRR6145060	Borreliella bissettii	64897	S	4	3	7	0.00000
SRR6145060	Borrelia coriaceae	144	S	7	0	7	0.00000
SRR6145060	Basfia succiniciproducens	653940	S	2	5	7	0.00000
SRR6145060	Bartonella quintana	803	S	7	0	7	0.00000
SRR6145060	Bacillus wiedmannii	1890302	S	7	0	7	0.00000
SRR6145060	Bacillus lehensis	300825	S	7	0	7	0.00000
SRR6145060	Bacillus halodurans	86665	S	7	0	7	0.00000
SRR6145060	Bacillus albus	2026189	S	7	0	7	0.00000
SRR6145060	Arthrobacter sp. FB24	290399	S	48	7	55	0.00001
SRR6145060	Ammonifex degensii	42838	S	7	0	7	0.00000
SRR6145060	Allofrancisella guangzhouensis	594679	S	7	0	7	0.00000
SRR6145060	Akkermansia glycaniphila	1679444	S	7	0	7	0.00000
SRR6145060	Aeromonas sp. 1805	2560028	S	4	7	11	0.00000
SRR6145060	Actinomyces sp. Chiba101	1851395	S	135	7	142	0.00002
SRR6145060	Actinobacillus lignieresii	720	S	5	2	7	0.00000
SRR6145060	Acinetobacter sp. NCu2D-2	1608473	S	112	7	119	0.00002
SRR6145060	Acholeplasma hippikon	264636	S	7	0	7	0.00000
SRR6145060	Acaryochloris marina	155978	S	7	0	7	0.00000
SRR6145060	[Clostridium] cellulosi	29343	S	6	0	6	0.00000
SRR6145060	Yersinia sp. KBS0713	1179669	S	3	6	9	0.00000
SRR6145060	Yersinia aldovae	29483	S	6	0	6	0.00000
SRR6145060	Xenorhabdus doucetiae	351671	S	6	0	6	0.00000
SRR6145060	Vibrio natriegens	691	S	3	3	6	0.00000
SRR6145060	Vibrio cincinnatiensis	675	S	6	0	6	0.00000
SRR6145060	Turneriella parva	29510	S	6	0	6	0.00000
SRR6145060	Treponema azotonutricium	150829	S	6	0	6	0.00000
SRR6145060	Thiolapillus brandeum	1076588	S	6	0	6	0.00000
SRR6145060	Thermosulfidibacter takaii	412593	S	6	0	6	0.00000
SRR6145060	Thermanaerovibrio acidaminovorans	81462	S	6	0	6	0.00000
SRR6145060	Tetragenococcus koreensis	290335	S	6	0	6	0.00000
SRR6145060	Tessaracoccus sp. T2.5-30	1909732	S	112	6	118	0.00002
SRR6145060	Taylorella asinigenitalis	84590	S	6	0	6	0.00000
SRR6145060	Tatlockia micdadei	451	S	6	0	6	0.00000
SRR6145060	Synechococcus sp. JA-3-3Ab	321327	S	24	6	30	0.00000
SRR6145060	Sulfurospirillum multivorans	66821	S	6	0	6	0.00000
SRR6145060	Sulfurisphaera tokodaii	111955	S	6	0	6	0.00000
SRR6145060	Sulfurimonas sp. 1-1N	2590021	S	1	6	7	0.00000
SRR6145060	Sulfurihydrogenibium azorense	309806	S	6	0	6	0.00000
SRR6145060	Streptomyces sp. TN58	234612	S	43	6	49	0.00001
SRR6145060	Streptomyces sp. SirexAA-E	862751	S	62	6	68	0.00001
SRR6145060	Streptomyces sp. QHH-9511	2684468	S	60	6	66	0.00001
SRR6145060	Streptomyces sp. HM190	2695266	S	57	6	63	0.00001
SRR6145060	Streptomyces sp. CNQ-509	444103	S	33	6	39	0.00001
SRR6145060	Sterolibacteriaceae bacterium M52	2496847	S	19	6	25	0.00000
SRR6145060	Staphylococcus virus P108	1924731	S	3	6	9	0.00000
SRR6145060	Spiroplasma turonicum	216946	S	6	0	6	0.00000
SRR6145060	Spiroplasma poulsonii	2138	S	6	0	6	0.00000
SRR6145060	Spiribacter salinus	1335746	S	6	0	6	0.00000
SRR6145060	Shewanella sp. W3-18-1	351745	S	2	6	8	0.00000
SRR6145060	Shewanella sp. MR-7	60481	S	11	6	17	0.00000
SRR6145060	Shewanella piezotolerans	404011	S	6	0	6	0.00000
SRR6145060	Shewanella chilikensis	558541	S	5	1	6	0.00000
SRR6145060	Shewanella amazonensis	60478	S	6	0	6	0.00000
SRR6145060	Serratia sp. SSNIH1	1758196	S	1	6	7	0.00000
SRR6145060	Salimicrobium jeotgali	1230341	S	6	0	6	0.00000
SRR6145060	Saccharomonospora sp. 31sw	2528243	S	83	6	89	0.00001
SRR6145060	Roseivivax sp. THAF30	2587852	S	43	6	49	0.00001
SRR6145060	Rickettsia helvetica	35789	S	4	2	6	0.00000
SRR6145060	Rhodococcus sp. WMMA185	679318	S	129	6	135	0.00002
SRR6145060	Rhodococcus sp. P1Y	1302308	S	165	6	171	0.00002
SRR6145060	Rhizobium sp. WL3	2603277	S	160	6	166	0.00002
SRR6145060	Rheinheimera sp. LHK132	2498451	S	550	6	556	0.00007
SRR6145060	Pseudomonas sp. TMW 2.1634	1886807	S	6	13	19	0.00000
SRR6145060	Pseudomonas sp. St29	1500687	S	3	6	9	0.00000
SRR6145060	Pseudomonas sp. NIBRBAC000502773	2590776	S	21	6	27	0.00000
SRR6145060	Pseudomonas sp. 09C 129	2054915	S	6	5	11	0.00000
SRR6145060	Pseudomonas cerasi	1583341	S	3	3	6	0.00000
SRR6145060	Pseudoalteromonas rubra	43658	S	6	0	6	0.00000
SRR6145060	Pseudoalteromonas issachenkonii	152297	S	2	4	6	0.00000
SRR6145060	Providencia sneebia	516075	S	6	0	6	0.00000
SRR6145060	Prosthecochloris sp. CIB 2401	1868325	S	6	0	6	0.00000
SRR6145060	Propionibacterium virus PHL111M01	1982284	S	6	6	12	0.00000
SRR6145060	Propionibacterium virus PA6	1982269	S	8	6	14	0.00000
SRR6145060	Porphyrobacter sp. HT-58-2	2023229	S	53	6	59	0.00001
SRR6145060	Polynucleobacter difficilis	556054	S	6	0	6	0.00000
SRR6145060	Planococcus versutus	1302659	S	6	0	6	0.00000
SRR6145060	Planctomycetes bacterium Pan153	2528029	S	5	6	11	0.00000
SRR6145060	Planctomycetes bacterium CA51	2527990	S	4	6	10	0.00000
SRR6145060	Phascolarctobacterium faecium	33025	S	2	4	6	0.00000
SRR6145060	Pectobacterium wasabiae	55208	S	5	1	6	0.00000
SRR6145060	Paenibacillus physcomitrellae	1619311	S	6	0	6	0.00000
SRR6145060	Paenibacillus naphthalenovorans	162209	S	6	0	6	0.00000
SRR6145060	Paenibacillus graminis	189425	S	6	0	6	0.00000
SRR6145060	Paenibacillus baekrokdamisoli	1712516	S	6	0	6	0.00000
SRR6145060	Oceanobacillus kimchii	746691	S	6	0	6	0.00000
SRR6145060	Obesumbacterium proteus	82983	S	5	1	6	0.00000
SRR6145060	Nitrosospira briensis	35799	S	6	0	6	0.00000
SRR6145060	Nitrosococcus halophilus	133539	S	6	0	6	0.00000
SRR6145060	Neorhizobium sp. NCHU2750	1825976	S	73	6	79	0.00001
SRR6145060	Natronomonas pharaonis	2257	S	6	0	6	0.00000
SRR6145060	Myroides sp. ZB35	1458492	S	6	6	12	0.00000
SRR6145060	Mycoplasma putrefaciens	2123	S	6	0	6	0.00000
SRR6145060	Mycoplasma pullorum	48003	S	6	0	6	0.00000
SRR6145060	Mycoplasma parvum	984991	S	6	0	6	0.00000
SRR6145060	Mycoplasma nasistruthionis	353852	S	6	0	6	0.00000
SRR6145060	Mycoplasma californicum	2113	S	6	0	6	0.00000
SRR6145060	Mycoplasma bovirhinis	29553	S	6	0	6	0.00000
SRR6145060	Mycoplasma bovigenitalium	2112	S	6	0	6	0.00000
SRR6145060	Mycoplasma agalactiae	2110	S	6	0	6	0.00000
SRR6145060	Monaibacterium sp. ALG8	2715211	S	35	6	41	0.00001
SRR6145060	Methylotenera mobilis	359408	S	6	0	6	0.00000
SRR6145060	Methylomusa anaerophila	1930071	S	6	0	6	0.00000
SRR6145060	Methylomonas sp. DH-1	1727196	S	4	6	10	0.00000
SRR6145060	Methanofollis liminatans	2201	S	6	0	6	0.00000
SRR6145060	Methanoculleus marisnigri	2198	S	6	0	6	0.00000
SRR6145060	Methanobrevibacter ruminantium	83816	S	6	0	6	0.00000
SRR6145060	Methanobacterium congolense	118062	S	6	0	6	0.00000
SRR6145060	Marinomonas posidonica	936476	S	6	0	6	0.00000
SRR6145060	Marinobacter psychrophilus	330734	S	5	1	6	0.00000
SRR6145060	Marinobacter fonticola	2603215	S	6	0	6	0.00000
SRR6145060	Maribacter sp. MAR_2009_60	1250153	S	7	6	13	0.00000
SRR6145060	Luteimonas sp. JM171	1896164	S	132	6	138	0.00002
SRR6145060	Longibaculum sp. KGMB06250	2584943	S	20	6	26	0.00000
SRR6145060	Listeria welshimeri	1643	S	6	0	6	0.00000
SRR6145060	Listeria grayi	1641	S	6	0	6	0.00000
SRR6145060	Limnospira indica	147322	S	1	5	6	0.00000
SRR6145060	Legionella waltersii	66969	S	6	0	6	0.00000
SRR6145060	Legionella geestiana	45065	S	6	0	6	0.00000
SRR6145060	Legionella clemsonensis	1867846	S	6	0	6	0.00000
SRR6145060	Lactobacillus sanfranciscensis	1625	S	6	0	6	0.00000
SRR6145060	Lactobacillus pontis	35787	S	6	0	6	0.00000
SRR6145060	Lactobacillus manihotivorans	88233	S	6	0	6	0.00000
SRR6145060	Lactobacillus futsaii	938155	S	6	0	6	0.00000
SRR6145060	Lactobacillus frumenti	104955	S	6	0	6	0.00000
SRR6145060	Lactobacillus coryniformis	1610	S	6	0	6	0.00000
SRR6145060	Lactobacillus buchneri	1581	S	6	0	6	0.00000
SRR6145060	Lactobacillus apis	303541	S	6	0	6	0.00000
SRR6145060	Lactobacillus amylolyticus	83683	S	6	0	6	0.00000
SRR6145060	Lachnospiraceae bacterium GAM79	2109691	S	24	6	30	0.00000
SRR6145060	Kosakonia arachidis	551989	S	6	0	6	0.00000
SRR6145060	Komagataeibacter europaeus	33995	S	6	0	6	0.00000
SRR6145060	Klebsiella virus vB_KpnM_KpS110	2079262	S	4	6	10	0.00000
SRR6145060	Klebsiella virus RaK2	2560545	S	7	6	13	0.00000
SRR6145060	Jeotgalibaca sp. PTS2502	1903686	S	8	6	14	0.00000
SRR6145060	Hydrogenovibrio thermophilus	265883	S	5	1	6	0.00000
SRR6145060	Humibacter sp. WJ7-1	2599293	S	99	6	105	0.00001
SRR6145060	Halothermothrix orenii	31909	S	6	0	6	0.00000
SRR6145060	Halomonas sp. SF2003	2136172	S	11	6	17	0.00000
SRR6145060	Halodesulfurarchaeum formicicum	1873524	S	6	0	6	0.00000
SRR6145060	Haematospirillum jordaniae	1549855	S	6	0	6	0.00000
SRR6145060	Geobacter uraniireducens	351604	S	6	0	6	0.00000
SRR6145060	Geobacter sp. DSM 9736	1277350	S	6	0	6	0.00000
SRR6145060	Geobacillus kaustophilus	1462	S	2	4	6	0.00000
SRR6145060	Gammapapillomavirus sp.	2049444	S	6	0	6	0.00000
SRR6145060	Fuerstia marisgermanicae	1891926	S	6	0	6	0.00000
SRR6145060	Frankineae bacterium MT45	1882833	S	86	6	92	0.00001
SRR6145060	Fervidobacterium nodosum	2424	S	6	0	6	0.00000
SRR6145060	Escherichia marmotae	1499973	S	6	0	6	0.00000
SRR6145060	Erythrobacter sp. HL-111	1798193	S	64	6	70	0.00001
SRR6145060	Erysipelotrichaceae bacterium GAM147	2109692	S	19	6	25	0.00000
SRR6145060	Ephemeroptericola cinctiostellae	2268024	S	6	0	6	0.00000
SRR6145060	Enterococcus sp. HSIEG1	1316414	S	1	6	7	0.00000
SRR6145060	Enterococcus sp. DA9	2603296	S	1	6	7	0.00000
SRR6145060	Enterobacter sp. ODB01	1827481	S	2	6	8	0.00000
SRR6145060	Enterobacter sp. LU1	1848517	S	1	6	7	0.00000
SRR6145060	Enterobacter oligotrophica	2478464	S	6	0	6	0.00000
SRR6145060	Elusimicrobium minutum	423605	S	6	0	6	0.00000
SRR6145060	Edwardsiella hoshinae	93378	S	6	0	6	0.00000
SRR6145060	Dictyoglomus thermophilum	14	S	6	0	6	0.00000
SRR6145060	Dialister massiliensis	2161821	S	1	5	6	0.00000
SRR6145060	Devosia sp. I507	2083786	S	78	6	84	0.00001
SRR6145060	Dehalogenimonas formicexedens	1839801	S	6	0	6	0.00000
SRR6145060	Dehalobacterium formicoaceticum	51515	S	6	0	6	0.00000
SRR6145060	Corynebacterium phage Dina	2588501	S	1	6	7	0.00000
SRR6145060	Cohnella abietis	2507935	S	6	0	6	0.00000
SRR6145060	Chryseobacterium sp. G0201	2487065	S	108	6	114	0.00002
SRR6145060	Chlorobium phaeobacteroides	1096	S	6	0	6	0.00000
SRR6145060	Cellulosilyticum sp. WCF-2	2497860	S	7	6	13	0.00000
SRR6145060	Candidatus Pelagibacter sp. RS39	1977864	S	6	0	6	0.00000
SRR6145060	Candidatus Pelagibacter sp. IMCC9063	1002672	S	6	0	6	0.00000
SRR6145060	Campylobacter subantarcticus	497724	S	6	0	6	0.00000
SRR6145060	Campylobacter lanienae	75658	S	6	0	6	0.00000
SRR6145060	Campylobacter iguaniorum	1244531	S	6	0	6	0.00000
SRR6145060	Caldimicrobium thiodismutans	1653476	S	6	0	6	0.00000
SRR6145060	Caldicellulosiruptor bescii	31899	S	2	4	6	0.00000
SRR6145060	Bythopirellula goksoyri	1400387	S	6	0	6	0.00000
SRR6145060	Burkholderia sp. KBS0801	1179675	S	3	6	9	0.00000
SRR6145060	Brevibacterium sp. WO024	2697563	S	186	6	192	0.00003
SRR6145060	Borrelia turcica	229155	S	6	0	6	0.00000
SRR6145060	Bartonella elizabethae	807	S	3	3	6	0.00000
SRR6145060	Bartonella ancashensis	1318743	S	6	0	6	0.00000
SRR6145060	Bacterioplanes sanyensis	1249553	S	6	0	6	0.00000
SRR6145060	Bacillus sp. L13 (2020)	2728853	S	6	0	6	0.00000
SRR6145060	Bacillus glycinifermentans	1664069	S	6	0	6	0.00000
SRR6145060	Bacillus cellulosilyticus	1413	S	6	0	6	0.00000
SRR6145060	Bacillus beveridgei	632773	S	6	0	6	0.00000
SRR6145060	Azoarcus sp. DN11	356837	S	40	6	46	0.00001
SRR6145060	Arcobacter sp. L	944547	S	5	6	11	0.00000
SRR6145060	Anaerolinea thermophila	167964	S	6	0	6	0.00000
SRR6145060	Alteromonas pelagimontana	1858656	S	6	0	6	0.00000
SRR6145060	Alteromonas australica	589873	S	6	0	6	0.00000
SRR6145060	Actinobacillus equuli	718	S	6	0	6	0.00000
SRR6145060	Acholeplasma palmae	38986	S	6	0	6	0.00000
SRR6145060	Acetobacter ascendens	481146	S	5	1	6	0.00000
SRR6145060	Acetoanaerobium sticklandii	1511	S	6	0	6	0.00000
SRR6145060	Yersinia entomophaga	935293	S	5	0	5	0.00000
SRR6145060	Weissella viridescens	1629	S	5	0	5	0.00000
SRR6145060	Vibrio crassostreae	246167	S	5	0	5	0.00000
SRR6145060	Vibrio chagasii	170679	S	5	0	5	0.00000
SRR6145060	Vibrio breoganii	553239	S	5	0	5	0.00000
SRR6145060	Treponema succinifaciens	167	S	5	0	5	0.00000
SRR6145060	Treponema brennaborense	81028	S	5	0	5	0.00000
SRR6145060	Thermus caldilimi	2483360	S	5	0	5	0.00000
SRR6145060	Thermosulfurimonas marina	2047767	S	5	0	5	0.00000
SRR6145060	Thermosipho melanesiensis	46541	S	5	0	5	0.00000
SRR6145060	Thermogutta terrifontis	1331910	S	5	0	5	0.00000
SRR6145060	Thermodesulfovibrio yellowstonii	28262	S	5	0	5	0.00000
SRR6145060	Thermococcus profundus	49899	S	5	0	5	0.00000
SRR6145060	Thermococcus barophilus	55802	S	5	0	5	0.00000
SRR6145060	Thermobaculum terrenum	166501	S	5	0	5	0.00000
SRR6145060	Tepidanaerobacter acetatoxydans	499229	S	5	0	5	0.00000
SRR6145060	Sulfurovum lithotrophicum	206403	S	4	1	5	0.00000
SRR6145060	Sulfurospirillum deleyianum	65553	S	5	0	5	0.00000
SRR6145060	Sulfurimonas autotrophica	202747	S	5	0	5	0.00000
SRR6145060	Streptomyces sp. fd1-xmd	1812480	S	37	5	42	0.00001
SRR6145060	Streptomyces sp. ZFG47	2184053	S	70	5	75	0.00001
SRR6145060	Streptomyces sp. TLI_053	1855352	S	116	5	121	0.00002
SRR6145060	Streptomyces sp. SM18	1736046	S	61	5	66	0.00001
SRR6145060	Streptomyces sp. RTd22	1841249	S	103	5	108	0.00001
SRR6145060	Streptomyces sp. QMT-12	2717324	S	108	5	113	0.00001
SRR6145060	Streptomyces sp. PAMC 26508	1265601	S	5	32	37	0.00000
SRR6145060	Streptomyces sp. CMB-StM0423	2059884	S	59	5	64	0.00001
SRR6145060	Streptomyces sp. C8S0	2585716	S	70	5	75	0.00001
SRR6145060	Streptococcus sp. HSISB1	1316409	S	4	5	9	0.00000
SRR6145060	Staphylothermus marinus	2280	S	5	0	5	0.00000
SRR6145060	Staphylococcus virus SA12	1924730	S	2	5	7	0.00000
SRR6145060	Staphylococcus virus Rodi	1980962	S	3	5	8	0.00000
SRR6145060	Staphylococcus virus BS2	2734047	S	3	5	8	0.00000
SRR6145060	Spiroplasma sabaudiense	216944	S	5	0	5	0.00000
SRR6145060	Spiroplasma melliferum	2134	S	2	3	5	0.00000
SRR6145060	Spiroplasma apis	2137	S	5	0	5	0.00000
SRR6145060	Sphingobium sp. EP60837	1855519	S	58	5	63	0.00001
SRR6145060	Simkania negevensis	83561	S	5	0	5	0.00000
SRR6145060	Shewanella donghaensis	238836	S	5	0	5	0.00000
SRR6145060	Serratia sp. FDAARGOS_506	2420306	S	14	5	19	0.00000
SRR6145060	Serratia sp. 1D1416	2447890	S	3	5	8	0.00000
SRR6145060	Saprospira grandis	1008	S	5	0	5	0.00000
SRR6145060	Saliniradius amylolyticus	2183582	S	5	0	5	0.00000
SRR6145060	Salinimonas lutimaris	914153	S	5	0	5	0.00000
SRR6145060	Saccharopolyspora sp. E2A	2665642	S	97	5	102	0.00001
SRR6145060	Rummeliibacillus stabekisii	241244	S	5	0	5	0.00000
SRR6145060	Rickettsia rickettsii	783	S	2	3	5	0.00000
SRR6145060	Rickettsia canadensis	788	S	5	0	5	0.00000
SRR6145060	Rickettsia amblyommatis	33989	S	4	1	5	0.00000
SRR6145060	Rhodovulum sp. P5	1564506	S	51	5	56	0.00001
SRR6145060	Rhodoluna lacicola	529884	S	5	0	5	0.00000
SRR6145060	Rhodobacteraceae bacterium QY30	2033435	S	120	5	125	0.00002
SRR6145060	Rhizobium sp. CIAT894	2020312	S	28	5	33	0.00000
SRR6145060	Rhizobium sp. ACO-34A	1571470	S	72	5	77	0.00001
SRR6145060	Pseudomonas sp. s211(2017)	2045200	S	2	5	7	0.00000
SRR6145060	Pseudomonas sp. R4-35-07	658643	S	1	5	6	0.00000
SRR6145060	Pseudomonas sp. LH1G9	2083055	S	4	5	9	0.00000
SRR6145060	Pseudomonas sp. FDAARGOS_380	2018067	S	11	5	16	0.00000
SRR6145060	Pseudomonas sp. ATCC 43928	676210	S	5	10	15	0.00000
SRR6145060	Pseudoalteromonas sp. Bsw20308	283699	S	4	5	9	0.00000
SRR6145060	Pseudoalteromonas marina	267375	S	3	2	5	0.00000
SRR6145060	Propionibacterium virus PHL199M00	1982300	S	29	5	34	0.00000
SRR6145060	Propionibacterium virus PHL095N00	1982283	S	4	5	9	0.00000
SRR6145060	Propionibacterium virus P91	1982260	S	5	5	10	0.00000
SRR6145060	Propionibacterium virus P100A	1982265	S	38	5	43	0.00001
SRR6145060	Prochlorococcus sp. MIT 0801	1501269	S	5	2	7	0.00000
SRR6145060	Polynucleobacter paneuropaeus	2527775	S	5	0	5	0.00000
SRR6145060	Picrophilus torridus	82076	S	5	0	5	0.00000
SRR6145060	Persephonella marina	309805	S	5	0	5	0.00000
SRR6145060	Paraglaciecola mesophila	197222	S	5	0	5	0.00000
SRR6145060	Pandoravirus dulcis	1349409	S	5	0	5	0.00000
SRR6145060	Paenibacillus xylanexedens	528191	S	5	0	5	0.00000
SRR6145060	Paenibacillus sp. FSL R5-0345	1536770	S	5	1	6	0.00000
SRR6145060	Paenibacillus peoriae	59893	S	1	4	5	0.00000
SRR6145060	Paenibacillus kribbensis	172713	S	5	0	5	0.00000
SRR6145060	Ornithinimicrobium sp. H23M54	2594265	S	130	5	135	0.00002
SRR6145060	Oerskovia sp. KBS0722	1179673	S	86	5	91	0.00001
SRR6145060	Oceanisphaera profunda	1416627	S	5	0	5	0.00000
SRR6145060	Novosphingobium sp. P6W	1609758	S	124	5	129	0.00002
SRR6145060	Nostocales cyanobacterium HT-58-2	1940762	S	27	5	32	0.00000
SRR6145060	Nitrosopumilus piranensis	1582439	S	5	0	5	0.00000
SRR6145060	Nitrosopumilus maritimus	338192	S	5	0	5	0.00000
SRR6145060	Nitrosomonas ureae	44577	S	4	1	5	0.00000
SRR6145060	Nitrosomonas sp. AL212	153948	S	7	5	12	0.00000
SRR6145060	Nitrosococcus oceani	1229	S	4	1	5	0.00000
SRR6145060	Mycoplasma struthionis	538220	S	5	0	5	0.00000
SRR6145060	Mycoplasma sp. Mirounga ES2806-GEN	754515	S	5	0	5	0.00000
SRR6145060	Mycoplasma phocicerebrale	142649	S	5	0	5	0.00000
SRR6145060	Mycoplasma mobile	2118	S	5	0	5	0.00000
SRR6145060	Mycoplasma hyosynoviae	29559	S	5	0	5	0.00000
SRR6145060	Mycoplasma haemocanis	136241	S	5	0	5	0.00000
SRR6145060	Mycoplasma gallopavonis	76629	S	5	0	5	0.00000
SRR6145060	Mycoplasma gallinaceum	29556	S	5	0	5	0.00000
SRR6145060	Mycoplasma conjunctivae	45361	S	4	1	5	0.00000
SRR6145060	Mycoplasma canadense	29554	S	5	0	5	0.00000
SRR6145060	Mycoplasma anatis	171279	S	5	0	5	0.00000
SRR6145060	Mycobacterium sp. MS1601	1936029	S	141	5	146	0.00002
SRR6145060	Mycobacterium sp. MOTT36Y	1168287	S	1	5	6	0.00000
SRR6145060	Mycobacterium sp. EPa45	1545728	S	104	5	109	0.00001
SRR6145060	Microlunatus sp. KUDC0627	2596828	S	125	5	130	0.00002
SRR6145060	Microbulbifer agarilyticus	260552	S	5	0	5	0.00000
SRR6145060	Microbacterium sp. XT11	367477	S	123	5	128	0.00002
SRR6145060	Microbacterium sp. RG1	2489212	S	127	5	132	0.00002
SRR6145060	Microbacterium sp. L-031	2614639	S	88	5	93	0.00001
SRR6145060	Microbacterium sp. 4R-513	2567934	S	133	5	138	0.00002
SRR6145060	Methylosinus sp. C49	2699395	S	46	5	51	0.00001
SRR6145060	Methylophaga nitratireducenticrescens	754476	S	5	0	5	0.00000
SRR6145060	Methylophaga frappieri	754477	S	5	0	5	0.00000
SRR6145060	Methanothermococcus okinawensis	155863	S	5	0	5	0.00000
SRR6145060	Methanosphaerula palustris	475088	S	5	0	5	0.00000
SRR6145060	Methanoplanus limicola	2315	S	5	0	5	0.00000
SRR6145060	Methanococcus vannielii	2187	S	5	0	5	0.00000
SRR6145060	Methanocella paludicola	570267	S	5	0	5	0.00000
SRR6145060	Methanocaldococcus bathoardescens	1301915	S	5	0	5	0.00000
SRR6145060	Mesorhizobium sp. NZP2077	2483404	S	25	5	30	0.00000
SRR6145060	Mesorhizobium sp. M6A.T.Cr.TU.016.01.1.1	2493677	S	24	5	29	0.00000
SRR6145060	Mesoplasma chauliocola	216427	S	5	0	5	0.00000
SRR6145060	Mariniblastus fucicola	980251	S	5	0	5	0.00000
SRR6145060	Listeria seeligeri	1640	S	5	0	5	0.00000
SRR6145060	Lactobacillus zymae	267363	S	5	0	5	0.00000
SRR6145060	Lactobacillus dextrinicus	51664	S	5	0	5	0.00000
SRR6145060	Lactobacillus animalis	1605	S	5	0	5	0.00000
SRR6145060	Lactobacillus amylophilus	1603	S	5	0	5	0.00000
SRR6145060	Lachnoclostridium sp. YL32	1834196	S	5	5	10	0.00000
SRR6145060	Kitasatospora sp. MMS16-BH015	2018025	S	106	5	111	0.00001
SRR6145060	Jatrophihabitans sp. GAS493	1907575	S	84	5	89	0.00001
SRR6145060	Intestinibaculum porci	2487118	S	5	0	5	0.00000
SRR6145060	Hymenobacter sp. BT182	2697562	S	96	5	101	0.00001
SRR6145060	Hymenobacter sp. BRD128	2675878	S	118	5	123	0.00002
SRR6145060	Hydrogenobaculum sp. Y04AAS1	380749	S	2	5	7	0.00000
SRR6145060	Heliorestis convoluta	356322	S	5	0	5	0.00000
SRR6145060	Helicobacter pullorum	35818	S	5	0	5	0.00000
SRR6145060	Helicobacter hepaticus	32025	S	4	1	5	0.00000
SRR6145060	Helicobacter apodemus	135569	S	5	0	5	0.00000
SRR6145060	Halorhodospira halochloris	1052	S	5	0	5	0.00000
SRR6145060	Halomonas sp. THAF12	2587849	S	35	5	40	0.00001
SRR6145060	Halomonas sp. AM6	2661553	S	8	5	13	0.00000
SRR6145060	Glaciecola nitratireducens	300231	S	5	0	5	0.00000
SRR6145060	Georgenia sp. Z294	2585135	S	118	5	123	0.00002
SRR6145060	Geobacter daltonii	1203471	S	5	0	5	0.00000
SRR6145060	Geobacillus thermodenitrificans	33940	S	5	0	5	0.00000
SRR6145060	Gallionella capsiferriformans	370405	S	5	0	5	0.00000
SRR6145060	Francisella noatunensis	657445	S	4	1	5	0.00000
SRR6145060	Francisella halioticida	549298	S	5	0	5	0.00000
SRR6145060	Flavobacterium sp. HYN0086	2249356	S	38	5	43	0.00001
SRR6145060	Erythrobacter sp. HKB08	2502843	S	58	5	63	0.00001
SRR6145060	Enterobacteriaceae bacterium S05	2052938	S	1	5	6	0.00000
SRR6145060	Enterobacter sp. HK169	1868135	S	2	5	7	0.00000
SRR6145060	Dichelobacter nodosus	870	S	5	0	5	0.00000
SRR6145060	Devosia sp. A16	1736675	S	121	5	126	0.00002
SRR6145060	Dehalococcoides mccartyi	61435	S	5	0	5	0.00000
SRR6145060	Corynebacterium sp. 2184	2079535	S	166	5	171	0.00002
SRR6145060	Corynebacterium sp. 2183	2080740	S	167	5	172	0.00002
SRR6145060	Corynebacterium sp. 2019	2675218	S	105	5	110	0.00001
SRR6145060	Citrobacter sp. SNU WT2	2562449	S	5	0	5	0.00000
SRR6145060	Chlorobaculum limnaeum	274537	S	5	0	5	0.00000
SRR6145060	Cetia pacifica	1424653	S	5	0	5	0.00000
SRR6145060	Cellulomonas sp. 40-2	2729175	S	100	5	105	0.00001
SRR6145060	Cedecea lapagei	158823	S	5	0	5	0.00000
SRR6145060	Candidatus Arthromitus sp. SFB-rat-Yit	1041504	S	5	0	5	0.00000
SRR6145060	Campylobacter volucris	1031542	S	5	0	5	0.00000
SRR6145060	Campylobacter cuniculorum	374106	S	5	0	5	0.00000
SRR6145060	Caldicellulosiruptor kronotskyensis	413889	S	2	3	5	0.00000
SRR6145060	Burkholderia sp. MSMB617WGS	1637831	S	3	5	8	0.00000
SRR6145060	Brevibacillus sp. SCSIO 07484	2496837	S	5	0	5	0.00000
SRR6145060	Brevefilum fermentans	1986204	S	5	0	5	0.00000
SRR6145060	Borreliella burgdorferi	139	S	2	3	5	0.00000
SRR6145060	Bombella sp. KACC 21507	2697033	S	5	0	5	0.00000
SRR6145060	Blattabacterium sp. (Nauphoeta cinerea)	1316444	S	5	0	5	0.00000
SRR6145060	Bartonella kosoyi	2133959	S	2	3	5	0.00000
SRR6145060	Bacillus vallismortis	72361	S	5	0	5	0.00000
SRR6145060	Bacillus tequilensis	227866	S	5	0	5	0.00000
SRR6145060	Bacillus krulwichiae	199441	S	5	0	5	0.00000
SRR6145060	Bacillus butanolivorans	421767	S	5	0	5	0.00000
SRR6145060	Bacillus bombysepticus	658666	S	2	3	5	0.00000
SRR6145060	Azoarcus sp. CIB	198107	S	33	5	38	0.00001
SRR6145060	Arthrobacter sp. U41	1849032	S	58	5	63	0.00001
SRR6145060	Arthrobacter sp. 24S4-2	2575374	S	57	5	62	0.00001
SRR6145060	Arcobacter marinus	505249	S	4	1	5	0.00000
SRR6145060	Archaeoglobus sulfaticallidus	1316941	S	5	0	5	0.00000
SRR6145060	Arcanobacterium phocae	131112	S	5	0	5	0.00000
SRR6145060	Apibacter sp. B2966	2656761	S	9	5	14	0.00000
SRR6145060	Anaerostipes rhamnosivorans	1229621	S	5	0	5	0.00000
SRR6145060	Alteromonas naphthalenivorans	715451	S	5	0	5	0.00000
SRR6145060	Alteromonas addita	287094	S	2	3	5	0.00000
SRR6145060	Aeromicrobium sp. A1-2	2107713	S	90	5	95	0.00001
SRR6145060	Aerococcus urinaehominis	128944	S	5	0	5	0.00000
SRR6145060	Aerococcus sanguinicola	119206	S	5	0	5	0.00000
SRR6145060	Adlercreutzia sp. 8CFCBH1	2707299	S	8	5	13	0.00000
SRR6145060	Actinobacillus succinogenes	67854	S	5	0	5	0.00000
SRR6145060	Acinetobacter sp. TTH0-4	1646498	S	126	5	131	0.00002
SRR6145060	Acinetobacter phage vB_AbaS_TRS1	1852629	S	3	5	8	0.00000
SRR6145060	Acidithiobacillus thiooxidans	930	S	5	0	5	0.00000
SRR6145060	Acidithiobacillus ferridurans	1232575	S	1	4	5	0.00000
SRR6145060	halophilic archaeon DL31	756883	S	13	4	17	0.00000
SRR6145060	[Bacillus] selenitireducens	85683	S	4	0	4	0.00000
SRR6145060	Yersinia mollaretii	33060	S	4	0	4	0.00000
SRR6145060	Yangia sp. CCB-MM3	1792508	S	64	4	68	0.00001
SRR6145060	Vulcanisaeta moutnovskia	985052	S	4	0	4	0.00000
SRR6145060	Virgibacillus dokdonensis	302167	S	3	1	4	0.00000
SRR6145060	Trichoplusia ni ascovirus 2c	328615	S	4	0	4	0.00000
SRR6145060	Tomitella sp. HY188	2597660	S	108	4	112	0.00001
SRR6145060	Thiomicrospira cyclica	147268	S	4	0	4	0.00000
SRR6145060	Thermovirga lienii	336261	S	4	0	4	0.00000
SRR6145060	Thermotoga neapolitana	2337	S	1	3	4	0.00000
SRR6145060	Thermosphaera aggregans	54254	S	4	0	4	0.00000
SRR6145060	Thermomicrobium roseum	500	S	4	0	4	0.00000
SRR6145060	Thermodesulfobium acidiphilum	1794699	S	4	0	4	0.00000
SRR6145060	Thermodesulfobacterium geofontis	1295609	S	4	0	4	0.00000
SRR6145060	Thermodesulfatator indicus	171695	S	4	0	4	0.00000
SRR6145060	Thermococcus gorgonarius	71997	S	4	0	4	0.00000
SRR6145060	Thermoanaerobacterium aotearoense	47490	S	4	0	4	0.00000
SRR6145060	Thermanaerovibrio velox	108007	S	4	0	4	0.00000
SRR6145060	Syntrophomonas wolfei	863	S	4	0	4	0.00000
SRR6145060	Syntrophobacter fumaroxidans	119484	S	4	0	4	0.00000
SRR6145060	Synechococcus phage S-RIM2 R1_1999	869662	S	4	0	4	0.00000
SRR6145060	Synechococcus elongatus	32046	S	2	2	4	0.00000
SRR6145060	Sulfurospirillum cavolei	366522	S	4	0	4	0.00000
SRR6145060	Sulfurisphaera ohwakuensis	69656	S	4	0	4	0.00000
SRR6145060	Sulfuricurvum kujiense	148813	S	4	0	4	0.00000
SRR6145060	Sulfuracidifex tepidarius	1294262	S	4	0	4	0.00000
SRR6145060	Sulfolobus acidocaldarius	2285	S	4	0	4	0.00000
SRR6145060	Stygiolobus azoricus	41675	S	4	0	4	0.00000
SRR6145060	Streptomyces sp. RPA4-2	2721244	S	47	4	51	0.00001
SRR6145060	Streptomyces sp. QMT-28	2662397	S	46	4	50	0.00001
SRR6145060	Streptococcus sp. CNU G2	2686210	S	4	8	12	0.00000
SRR6145060	Streptococcus ruminantium	1917441	S	2	2	4	0.00000
SRR6145060	Staphylococcus virus G15	1924732	S	1	4	5	0.00000
SRR6145060	Staphylococcus virus Andhra	2732591	S	19	4	23	0.00000
SRR6145060	Sporosarcina sp. P37	1930546	S	1	4	5	0.00000
SRR6145060	Sporomusa termitida	2377	S	4	0	4	0.00000
SRR6145060	Spirosoma sp. CJU-R4	2728024	S	123	4	127	0.00002
SRR6145060	Spiroplasma litorale	216942	S	4	0	4	0.00000
SRR6145060	Spiroplasma kunkelii	47834	S	2	2	4	0.00000
SRR6145060	Spiroplasma gladiatoris	2143	S	4	0	4	0.00000
SRR6145060	Spiroplasma diminutum	216936	S	4	0	4	0.00000
SRR6145060	Sphingobacterium sp. DR205	2713573	S	222	4	226	0.00003
SRR6145060	Sinorhizobium sp. RAC02	1842534	S	91	4	95	0.00001
SRR6145060	Shewanella sp. SNU WT4	2590015	S	4	0	4	0.00000
SRR6145060	Shewanella sp. Pdp11	2059264	S	12	4	16	0.00000
SRR6145060	Shewanella sp. MR-4	60480	S	7	4	11	0.00000
SRR6145060	Shewanella marisflavi	260364	S	4	0	4	0.00000
SRR6145060	Sedimentisphaera cyanobacteriorum	1940790	S	3	1	4	0.00000
SRR6145060	Scardovia inopinata	78259	S	4	0	4	0.00000
SRR6145060	Salegentibacter sp. T436	1729720	S	14	4	18	0.00000
SRR6145060	Ruminococcus champanellensis	1161942	S	4	0	4	0.00000
SRR6145060	Ruminococcaceae bacterium CPB6	1572656	S	3	4	7	0.00000
SRR6145060	Raoultella sp. NCTC 9189	2583577	S	4	6	10	0.00000
SRR6145060	Pyrolobus fumarii	54252	S	4	0	4	0.00000
SRR6145060	Pyrococcus yayanosii	1008460	S	4	0	4	0.00000
SRR6145060	Pyrococcus horikoshii	53953	S	4	0	4	0.00000
SRR6145060	Pyrobaculum ferrireducens	1104324	S	4	0	4	0.00000
SRR6145060	Pyrobaculum arsenaticum	121277	S	4	0	4	0.00000
SRR6145060	Pyrobaculum aerophilum	13773	S	4	0	4	0.00000
SRR6145060	Pseudomonas sp. SK	2729423	S	62	4	66	0.00001
SRR6145060	Pseudomonas sp. SGAir0191	2217867	S	11	4	15	0.00000
SRR6145060	Pseudomonas sp. R4-39-08	1173288	S	1	4	5	0.00000
SRR6145060	Pseudomonas sp. R4-34-07	658642	S	1	4	5	0.00000
SRR6145060	Pseudomonas sp. R3-18-08	1173283	S	2	4	6	0.00000
SRR6145060	Pseudomonas sp. CMR5c	658630	S	24	4	28	0.00000
SRR6145060	Pseudomonas sp. B14-6	2738843	S	3	4	7	0.00000
SRR6145060	Pseudomonas sp. B10	118613	S	14	4	18	0.00000
SRR6145060	Pseudodesulfovibrio piezophilus	879567	S	4	0	4	0.00000
SRR6145060	Pseudoalteromonas sp. 1_2015MBL_MicDiv	1720343	S	3	4	7	0.00000
SRR6145060	Providencia vermicola	333965	S	4	0	4	0.00000
SRR6145060	Propionibacterium virus ATCC29399BC	1982252	S	1	4	5	0.00000
SRR6145060	Planococcus maritimus	192421	S	4	0	4	0.00000
SRR6145060	Planococcus faecalis	1598147	S	1	3	4	0.00000
SRR6145060	Planococcus donghaensis	414778	S	4	0	4	0.00000
SRR6145060	Planctomycetes bacterium Pan110	2528028	S	1	4	5	0.00000
SRR6145060	Planctomycetes bacterium Mal52	2527995	S	4	4	8	0.00000
SRR6145060	Planctomycetes bacterium Enr10	2527978	S	1	4	5	0.00000
SRR6145060	Planctomycetes bacterium EC9	1930277	S	10	4	14	0.00000
SRR6145060	Pedobacter sp. KBS0701	2578106	S	27	4	31	0.00000
SRR6145060	Pedobacter sp. HDW13	2714940	S	35	4	39	0.00001
SRR6145060	Pediococcus damnosus	51663	S	4	0	4	0.00000
SRR6145060	Paraburkholderia sp. 7MH5	2547399	S	75	4	79	0.00001
SRR6145060	Pandoravirus neocaledonia	2107708	S	4	0	4	0.00000
SRR6145060	Paenibacillus terrae	159743	S	4	0	4	0.00000
SRR6145060	Paenibacillus sp. FSL R5-0912	1536771	S	4	1	5	0.00000
SRR6145060	Paenibacillus brasilensis	128574	S	4	0	4	0.00000
SRR6145060	Paenalcaligenes hominis	643674	S	4	0	4	0.00000
SRR6145060	Pacmanvirus A23	1932881	S	4	0	4	0.00000
SRR6145060	Oenococcus kitaharae	336988	S	4	0	4	0.00000
SRR6145060	Novibacillus thermophilus	1471761	S	4	0	4	0.00000
SRR6145060	Nostoc sp. TCL240-02	2572090	S	8	4	12	0.00000
SRR6145060	Nostoc sp. NIES-4103	2005458	S	20	4	24	0.00000
SRR6145060	Nonlabens sp. SY33080	2719911	S	6	4	10	0.00000
SRR6145060	Nonlabens sediminis	319236	S	2	2	4	0.00000
SRR6145060	Nitratireductor sp. SY7	2599600	S	64	4	68	0.00001
SRR6145060	Mycoplasma suis	57372	S	4	0	4	0.00000
SRR6145060	Mycoplasma pulmonis	2107	S	4	0	4	0.00000
SRR6145060	Mycoplasma ovipneumoniae	29562	S	4	0	4	0.00000
SRR6145060	Mycoplasma orale	2121	S	4	0	4	0.00000
SRR6145060	Mycoplasma meleagridis	29561	S	4	0	4	0.00000
SRR6145060	Mycoplasma glycophilum	171285	S	4	0	4	0.00000
SRR6145060	Mycoplasma gallisepticum	2096	S	4	0	4	0.00000
SRR6145060	Mycoplasma edwardii	53558	S	4	0	4	0.00000
SRR6145060	Mycoplasma columbinum	114881	S	4	0	4	0.00000
SRR6145060	Mycoplasma cloacale	92401	S	4	0	4	0.00000
SRR6145060	Mycoplasma bovis	28903	S	4	0	4	0.00000
SRR6145060	Mycoplasma arginini	2094	S	4	0	4	0.00000
SRR6145060	Mycoplasma anseris	92400	S	4	0	4	0.00000
SRR6145060	Mycobacterium liflandii	261524	S	1	3	4	0.00000
SRR6145060	Muribaculum sp. TLL-A4	2530390	S	20	4	24	0.00000
SRR6145060	Microbacterium sp. ST-M6	2614638	S	115	4	119	0.00002
SRR6145060	Methylophilus sp. TWE2	1662285	S	15	4	19	0.00000
SRR6145060	Methylomicrobium buryatense	95641	S	2	2	4	0.00000
SRR6145060	Methylomicrobium alcaliphilum	271065	S	2	2	4	0.00000
SRR6145060	Methanothrix soehngenii	2223	S	4	0	4	0.00000
SRR6145060	Methanosarcina lacustris	170861	S	4	0	4	0.00000
SRR6145060	Methanosarcina flavescens	1715806	S	4	0	4	0.00000
SRR6145060	Methanoregula formicica	882104	S	4	0	4	0.00000
SRR6145060	Methanopyrus kandleri	2320	S	4	0	4	0.00000
SRR6145060	Methanohalophilus mahii	2176	S	4	0	4	0.00000
SRR6145060	Methanohalobium evestigatum	2322	S	4	0	4	0.00000
SRR6145060	Mesotoga infera	1236046	S	4	0	4	0.00000
SRR6145060	Mesorhizobium sp. Pch-S	2082387	S	75	4	79	0.00001
SRR6145060	Melioribacter roseus	1134405	S	4	0	4	0.00000
SRR6145060	Mariprofundus ferrinatatus	1921087	S	4	0	4	0.00000
SRR6145060	Macrococcus sp. IME1552	1898474	S	79	4	83	0.00001
SRR6145060	Litorilituus sediminis	718192	S	4	0	4	0.00000
SRR6145060	Limihaloglobus sulfuriphilus	1851148	S	4	0	4	0.00000
SRR6145060	Leptospira kmetyi	408139	S	4	0	4	0.00000
SRR6145060	Lentibacillus amyloliquefaciens	1472767	S	4	0	4	0.00000
SRR6145060	Lactobacillus rossiae	231049	S	4	0	4	0.00000
SRR6145060	Lactobacillus paracollinoides	240427	S	4	0	4	0.00000
SRR6145060	Lactobacillus murinus	1622	S	4	0	4	0.00000
SRR6145060	Lactobacillus malefermentans	176292	S	4	0	4	0.00000
SRR6145060	Lactobacillus graminis	60519	S	4	0	4	0.00000
SRR6145060	Lactobacillus gastricus	227942	S	4	0	4	0.00000
SRR6145060	Lachnoclostridium phocaeense	1871021	S	4	0	4	0.00000
SRR6145060	Kyrpidia spormannii	2055160	S	2	2	4	0.00000
SRR6145060	Kosmotoga pacifica	1330330	S	4	0	4	0.00000
SRR6145060	Kosmotoga olearia	651457	S	4	0	4	0.00000
SRR6145060	Kangiella koreensis	261964	S	4	0	4	0.00000
SRR6145060	Idiomarina andamanensis	1940690	S	4	0	4	0.00000
SRR6145060	Hymenobacter sp. DG25A	1385663	S	20	4	24	0.00000
SRR6145060	Herbiconiux sp. SALV-R1	2735133	S	79	4	83	0.00001
SRR6145060	Halomicrobium sp. LC1Hm	2610902	S	18	4	22	0.00000
SRR6145060	Halobacillus halophilus	1570	S	4	0	4	0.00000
SRR6145060	Gryllotalpicola sp. 2DFW10M-5	2419771	S	93	4	97	0.00001
SRR6145060	Geovibrio thiophilus	139438	S	4	0	4	0.00000
SRR6145060	Geobacillus thermocatenulatus	33938	S	4	0	4	0.00000
SRR6145060	Gemmobacter sp. HYN0069	2169400	S	83	4	87	0.00001
SRR6145060	Ferroplasma acidiphilum	74969	S	2	2	4	0.00000
SRR6145060	Ferroglobus placidus	54261	S	4	0	4	0.00000
SRR6145060	Eubacterium callanderi	53442	S	4	0	4	0.00000
SRR6145060	Esparto virus	2072209	S	4	0	4	0.00000
SRR6145060	Endomicrobium proavitum	1408281	S	4	0	4	0.00000
SRR6145060	Edwardsiella ictaluri	67780	S	4	0	4	0.00000
SRR6145060	Dokdonia donghaensis	326320	S	3	1	4	0.00000
SRR6145060	Desulfotomaculum nigrificans	1565	S	4	0	4	0.00000
SRR6145060	Desulfomonile tiedjei	2358	S	4	0	4	0.00000
SRR6145060	Desulfocapsa sulfexigens	65555	S	4	0	4	0.00000
SRR6145060	Desulfitobacterium metallireducens	142877	S	4	0	4	0.00000
SRR6145060	Cryobacterium sp. LW097	1978566	S	49	4	53	0.00001
SRR6145060	Commensalibacter sp. ESL0284	2070537	S	3	4	7	0.00000
SRR6145060	Clostridiales bacterium CCNA10	2109688	S	17	4	21	0.00000
SRR6145060	Chryseobacterium sp. StRB126	878220	S	83	4	87	0.00001
SRR6145060	Chlorobium phaeovibrioides	1094	S	4	0	4	0.00000
SRR6145060	Chlorobium limicola	1092	S	4	0	4	0.00000
SRR6145060	Chlamydia trachomatis	813	S	4	0	4	0.00000
SRR6145060	Campylobacter upsaliensis	28080	S	4	0	4	0.00000
SRR6145060	Campylobacter ornithocola	1848766	S	4	0	4	0.00000
SRR6145060	Caldicellulosiruptor obsidiansis	717609	S	3	1	4	0.00000
SRR6145060	Caldanaerobacter subterraneus	911092	S	4	0	4	0.00000
SRR6145060	Burkholderia sp. PAMC 28687	1795874	S	4	6	10	0.00000
SRR6145060	Burkholderia sp. MSMB0266	1637837	S	4	4	8	0.00000
SRR6145060	Burkholderia sp. LA-2-3-30-S1-D2	1637862	S	10	4	14	0.00000
SRR6145060	Burkholderia sp. JP2-270	2217913	S	12	4	16	0.00000
SRR6145060	Bordetella genomosp. 9	1416803	S	42	4	46	0.00001
SRR6145060	Blattabacterium sp. (Periplaneta americana)	367488	S	4	1	5	0.00000
SRR6145060	Betapapillomavirus 2	333924	S	4	0	4	0.00000
SRR6145060	Bartonella sp. 1-1C	515256	S	1	4	5	0.00000
SRR6145060	Bartonella henselae	38323	S	4	0	4	0.00000
SRR6145060	Bartonella clarridgeiae	56426	S	4	0	4	0.00000
SRR6145060	Bacillus weihaiensis	1547283	S	4	0	4	0.00000
SRR6145060	Bacillus vietnamensis	218284	S	4	0	4	0.00000
SRR6145060	Bacillus sp. BS98	2608254	S	2	4	6	0.00000
SRR6145060	Bacillus pacificus	2026187	S	2	2	4	0.00000
SRR6145060	Bacillus mojavensis	72360	S	4	0	4	0.00000
SRR6145060	Bacillus kochii	859143	S	4	0	4	0.00000
SRR6145060	Bacillus halotolerans	260554	S	2	2	4	0.00000
SRR6145060	Aureimonas sp. AU20	1349819	S	114	4	118	0.00002
SRR6145060	Arthrobacter sp. PAMC25564	2565366	S	46	4	50	0.00001
SRR6145060	Aquitalea sp. USM4	1590041	S	12	4	16	0.00000
SRR6145060	Aquicella lusitana	254246	S	4	0	4	0.00000
SRR6145060	Actinomyces sp. 432	2057798	S	62	4	66	0.00001
SRR6145060	Aciduliprofundum boonei	379547	S	4	0	4	0.00000
SRR6145060	Acidianus brierleyi	41673	S	4	0	4	0.00000
SRR6145060	Absiella argi	1671597	S	1	3	4	0.00000
SRR6145060	[Eubacterium] cellulosolvens	29322	S	3	0	3	0.00000
SRR6145060	[Bacillus] caldolyticus	1394	S	1	2	3	0.00000
SRR6145060	Waddlia chondrophila	71667	S	3	0	3	0.00000
SRR6145060	Vulcanisaeta distributa	164451	S	3	0	3	0.00000
SRR6145060	Vagococcus sp. MN-17	2571750	S	12	3	15	0.00000
SRR6145060	Ureaplasma urealyticum	2130	S	3	0	3	0.00000
SRR6145060	Treponema primitia	88058	S	3	0	3	0.00000
SRR6145060	Thiomicrorhabdus aquaedulcis	2211106	S	3	0	3	0.00000
SRR6145060	Thermotoga profunda	1508420	S	3	0	3	0.00000
SRR6145060	Thermosulfuriphilus ammonigenes	1936021	S	3	0	3	0.00000
SRR6145060	Thermosipho africanus	2421	S	3	0	3	0.00000
SRR6145060	Thermoplasma volcanium	50339	S	3	0	3	0.00000
SRR6145060	Thermofilum adornatum	1365176	S	3	0	3	0.00000
SRR6145060	Thermococcus piezophilus	1712654	S	3	0	3	0.00000
SRR6145060	Thermococcus cleftensis	163003	S	3	0	3	0.00000
SRR6145060	Syntrophothermus lipocalidus	86170	S	3	0	3	0.00000
SRR6145060	Synechococcus sp. WH 8109	166314	S	3	0	3	0.00000
SRR6145060	Synechococcus sp. NIES-970	1827144	S	12	3	15	0.00000
SRR6145060	Synechococcus lividus	33070	S	3	0	3	0.00000
SRR6145060	Sulfurospirillum halorespirans	194424	S	3	0	3	0.00000
SRR6145060	Sulfurospirillum barnesii	44674	S	3	0	3	0.00000
SRR6145060	Sulfurimonas denitrificans	39766	S	3	0	3	0.00000
SRR6145060	Streptomyces sp. NHF165	2175864	S	120	3	123	0.00002
SRR6145060	Streptomyces sp. GSSD-12	2282738	S	81	3	84	0.00001
SRR6145060	Streptomonospora sp. M2	2498135	S	91	3	94	0.00001
SRR6145060	Streptococcus sp. CNU G3	2698804	S	3	5	8	0.00000
SRR6145060	Stenotrophomonas phage Mendera	2650877	S	16	3	19	0.00000
SRR6145060	Staphylococcus virus SEP9	1922247	S	7	3	10	0.00000
SRR6145060	Staphylococcus virus JD7	1924729	S	1	3	4	0.00000
SRR6145060	Stanieria sp. NIES-3757	1807358	S	7	3	10	0.00000
SRR6145060	Sphingomonas sp. MK52	2711156	S	104	3	107	0.00001
SRR6145060	Sphaerochaeta pleomorpha	1131707	S	3	0	3	0.00000
SRR6145060	Sinorhizobium sp. CCBAU 05631	794846	S	3	4	7	0.00000
SRR6145060	Shewanella polaris	2588449	S	2	1	3	0.00000
SRR6145060	Shewanella frigidimarina	56812	S	3	0	3	0.00000
SRR6145060	Serratia sp. YD25	1759437	S	14	3	17	0.00000
SRR6145060	Serratia sp. P2ACOL2	2482769	S	3	3	6	0.00000
SRR6145060	Sediminispirochaeta smaragdinae	55206	S	3	0	3	0.00000
SRR6145060	Sanguibacter sp. HDW7	2714931	S	100	3	103	0.00001
SRR6145060	Salmonella virus S16	1913658	S	1	3	4	0.00000
SRR6145060	Salinispira pacifica	1307761	S	3	0	3	0.00000
SRR6145060	Salicibibacter kimchii	2099786	S	3	0	3	0.00000
SRR6145060	Rufibacter sp. DG15C	1379909	S	9	3	12	0.00000
SRR6145060	Rickettsia massiliae	35791	S	2	1	3	0.00000
SRR6145060	Rhizobium sp. NXC14	1981173	S	21	3	24	0.00000
SRR6145060	Rheinheimera sp. D18	2545632	S	39	3	42	0.00001
SRR6145060	Pyrobaculum neutrophilum	70771	S	3	0	3	0.00000
SRR6145060	Pseudothermotoga hypogea	57487	S	2	1	3	0.00000
SRR6145060	Pseudomonas sp. S150	2559074	S	5	3	8	0.00000
SRR6145060	Pseudomonas sp. NS1(2017)	2025658	S	23	3	26	0.00000
SRR6145060	Pseudomonas lini	163011	S	3	0	3	0.00000
SRR6145060	Pseudolabrys sp. FHR47	2562284	S	51	3	54	0.00001
SRR6145060	Pseudoalteromonas sp. SM9913	234831	S	1	3	4	0.00000
SRR6145060	Pseudoalteromonas espejiana	28107	S	3	0	3	0.00000
SRR6145060	Pseudarthrobacter sp. YJ56	2697569	S	30	3	33	0.00000
SRR6145060	Proteus sp. ZN5	2697019	S	7	3	10	0.00000
SRR6145060	Prosthecochloris aestuarii	1102	S	3	0	3	0.00000
SRR6145060	Propionibacterium virus PHL112N00	1982285	S	4	3	7	0.00000
SRR6145060	Planococcus sp. MB-3u-03	2058136	S	7	3	10	0.00000
SRR6145060	Planococcus plakortidis	1038856	S	3	0	3	0.00000
SRR6145060	Planctomycetes bacterium MalM14	2527997	S	1	3	4	0.00000
SRR6145060	Phaeobacter sp. LSS9	681157	S	2	3	5	0.00000
SRR6145060	Peptoclostridium acidaminophilum	1731	S	3	0	3	0.00000
SRR6145060	Pelodictyon phaeoclathratiforme	34090	S	3	0	3	0.00000
SRR6145060	Paracoccus sp. BM15	1529068	S	151	3	154	0.00002
SRR6145060	Paraburkholderia sp. DHF22	2571748	S	57	3	60	0.00001
SRR6145060	Paraburkholderia sp. 7Q-K02	2571747	S	65	3	68	0.00001
SRR6145060	Pantoea sp. SO10	2575375	S	49	3	52	0.00001
SRR6145060	Pandoravirus salinus	1349410	S	3	0	3	0.00000
SRR6145060	Pajaroellobacter abortibovis	1882918	S	3	0	3	0.00000
SRR6145060	Paenibacillus sp. UniB2	2726185	S	22	3	25	0.00000
SRR6145060	Paenibacillus sp. FSL P4-0081	1536769	S	3	1	4	0.00000
SRR6145060	Paenibacillus lentus	1338368	S	3	0	3	0.00000
SRR6145060	Paenibacillus jilunlii	682956	S	3	0	3	0.00000
SRR6145060	Oscillibacter valericigenes	351091	S	3	0	3	0.00000
SRR6145060	Oscillibacter sp. PEA192	2109687	S	1	3	4	0.00000
SRR6145060	Olsenella sp. GAM18	2109685	S	18	3	21	0.00000
SRR6145060	Octadecabacter sp. SW4	2602067	S	23	3	26	0.00000
SRR6145060	Noviherbaspirillum sp. UKPF54	2601898	S	55	3	58	0.00001
SRR6145060	Nostoc sp. NIES-2111	1973475	S	2	3	5	0.00000
SRR6145060	Nitrosospira multiformis	1231	S	3	0	3	0.00000
SRR6145060	Nitrosospira lacus	1288494	S	3	0	3	0.00000
SRR6145060	Nitrososphaera viennensis	1034015	S	3	0	3	0.00000
SRR6145060	Nitrosopumilus adriaticus	1580092	S	3	0	3	0.00000
SRR6145060	Nitrosomonas stercoris	1444684	S	3	0	3	0.00000
SRR6145060	Nibribacter sp. BT10	2698458	S	12	3	15	0.00000
SRR6145060	Neorickettsia helminthoeca	33994	S	2	1	3	0.00000
SRR6145060	Neokomagataea tanensis	661191	S	3	0	3	0.00000
SRR6145060	Natranaerobius thermophilus	375929	S	3	0	3	0.00000
SRR6145060	Mycoplasma yeatsii	51365	S	3	0	3	0.00000
SRR6145060	Mycoplasma sp. Phocoena C-264-GEN	754517	S	3	0	3	0.00000
SRR6145060	Mycoplasma neurolyticum	2120	S	3	0	3	0.00000
SRR6145060	Mycoplasma dispar	86660	S	3	0	3	0.00000
SRR6145060	Mycoplasma columborale	171282	S	3	0	3	0.00000
SRR6145060	Mycoplasma bovoculi	45362	S	3	0	3	0.00000
SRR6145060	Mycoplasma alkalescens	45363	S	3	0	3	0.00000
SRR6145060	Mycobacterium sp. JS623	212767	S	197	3	200	0.00003
SRR6145060	Mycobacterium sp. DL592	2675524	S	104	3	107	0.00001
SRR6145060	Mycobacterium pseudoshottsii	265949	S	1	2	3	0.00000
SRR6145060	Mupapillomavirus 2	334204	S	3	0	3	0.00000
SRR6145060	Mollivirus sibericum	1678078	S	3	0	3	0.00000
SRR6145060	Microcystis sp. MC19	1967666	S	2	3	5	0.00000
SRR6145060	Microbacterium sp. ABRD_28	2268461	S	117	3	120	0.00002
SRR6145060	Methylovorus sp. MP688	887061	S	6	3	9	0.00000
SRR6145060	Methylotenera versatilis	1055487	S	3	0	3	0.00000
SRR6145060	Methanolacinia petrolearia	54120	S	3	0	3	0.00000
SRR6145060	Methanocorpusculum labreanum	83984	S	3	0	3	0.00000
SRR6145060	Methanocella arvoryzae	1175445	S	3	0	3	0.00000
SRR6145060	Methanocaldococcus infernus	67760	S	3	0	3	0.00000
SRR6145060	Methanobacterium paludis	868131	S	3	0	3	0.00000
SRR6145060	Mesoplasma tabanidae	219745	S	3	0	3	0.00000
SRR6145060	Mesoplasma entomophilum	2149	S	3	0	3	0.00000
SRR6145060	Mesoplasma coleopterae	324078	S	3	0	3	0.00000
SRR6145060	Massilistercora timonensis	2086584	S	3	0	3	0.00000
SRR6145060	Marivivens sp. JLT3646	1920883	S	9	3	12	0.00000
SRR6145060	Marinomonas mediterranea	119864	S	3	0	3	0.00000
SRR6145060	Mannheimia sp. ZY170218	2679994	S	25	3	28	0.00000
SRR6145060	Legionella spiritensis	452	S	3	0	3	0.00000
SRR6145060	Legionella hackeliae	449	S	3	0	3	0.00000
SRR6145060	Legionella cherrii	28084	S	3	0	3	0.00000
SRR6145060	Leclercia sp. 119287	2681308	S	3	3	6	0.00000
SRR6145060	Lactococcus sp. KACC 19320	2592653	S	3	2	5	0.00000
SRR6145060	Lactobacillus sp. C25	2692757	S	3	3	6	0.00000
SRR6145060	Lactobacillus kunkeei	148814	S	3	0	3	0.00000
SRR6145060	Lactobacillus koreensis	637971	S	3	0	3	0.00000
SRR6145060	Lactobacillus kefiri	33962	S	3	0	3	0.00000
SRR6145060	Lactobacillus ginsenosidimutans	1007676	S	3	0	3	0.00000
SRR6145060	Lactobacillus fuchuensis	164393	S	3	0	3	0.00000
SRR6145060	Lactobacillus bombi	1303590	S	3	0	3	0.00000
SRR6145060	Lactobacillus allii	1847728	S	3	0	3	0.00000
SRR6145060	Kyrpidia tusciae	33943	S	1	2	3	0.00000
SRR6145060	Kroppenstedtia eburnea	714067	S	3	0	3	0.00000
SRR6145060	Kangiella geojedonensis	914150	S	3	0	3	0.00000
SRR6145060	Invertebrate iridescent virus 9	345195	S	3	0	3	0.00000
SRR6145060	Hymenobacter sp. BT18	2724192	S	47	3	50	0.00001
SRR6145060	Hydrogenovibrio marinus	28885	S	3	0	3	0.00000
SRR6145060	Hydrogenobacter thermophilus	940	S	3	0	3	0.00000
SRR6145060	Human papillomavirus	10566	S	3	0	3	0.00000
SRR6145060	Helicobacter suis	104628	S	3	0	3	0.00000
SRR6145060	Helicobacter canis	29419	S	3	0	3	0.00000
SRR6145060	Halomonas sp. HG01	1609967	S	27	3	30	0.00000
SRR6145060	Gordonia sp. HY186	2597659	S	95	3	98	0.00001
SRR6145060	Gloeomargarita lithophora	1188228	S	3	0	3	0.00000
SRR6145060	Georgenia sp. ZLJ0423	2483799	S	107	3	110	0.00001
SRR6145060	Georgenia sp. Z443	2589797	S	125	3	128	0.00002
SRR6145060	Geobacter sp. M18	443143	S	26	3	29	0.00000
SRR6145060	Geobacter metallireducens	28232	S	3	0	3	0.00000
SRR6145060	Geobacillus sp. C56-T3	691437	S	2	3	5	0.00000
SRR6145060	Geminocystis sp. NIES-3709	1617448	S	42	3	45	0.00001
SRR6145060	Gammapapillomavirus 20	1513265	S	3	0	3	0.00000
SRR6145060	Frankia sp. EAN1pec	298653	S	118	3	121	0.00002
SRR6145060	Francisella hispaniensis	622488	S	3	0	3	0.00000
SRR6145060	Flexistipes sinusarabici	2352	S	3	0	3	0.00000
SRR6145060	Flavobacterium sp. KBS0721	1179672	S	33	3	36	0.00000
SRR6145060	Flavobacterium sp. 140616W15	2478552	S	42	3	45	0.00001
SRR6145060	Fervidicoccus fontis	683846	S	3	0	3	0.00000
SRR6145060	Exiguobacterium sp. AT1b	360911	S	230	3	233	0.00003
SRR6145060	Escherichia virus NC29	1945586	S	2	3	5	0.00000
SRR6145060	Escherichia virus ID52	1910968	S	1	3	4	0.00000
SRR6145060	Entomoplasma somnilux	215578	S	3	0	3	0.00000
SRR6145060	Enterococcus sp. CR-Ec1	2057791	S	3	3	6	0.00000
SRR6145060	Enterobacter sp. R4-368	1166130	S	7	3	10	0.00000
SRR6145060	Ehrlichia muris	35795	S	3	0	3	0.00000
SRR6145060	Ectothiorhodospira sp. BSL-9	1442136	S	13	3	16	0.00000
SRR6145060	Dolichospermum sp. UHCC 0315A	1914871	S	3	24	27	0.00000
SRR6145060	Desulfovibrio salexigens	880	S	3	0	3	0.00000
SRR6145060	Desulfosporosinus youngiae	339862	S	3	0	3	0.00000
SRR6145060	Desulfitobacterium dichloroeliminans	233055	S	3	0	3	0.00000
SRR6145060	Denitrobacterium detoxificans	79604	S	3	0	3	0.00000
SRR6145060	Dehalogenimonas lykanthroporepellens	552810	S	3	0	3	0.00000
SRR6145060	Cycloclasticus zancles	1329899	S	1	2	3	0.00000
SRR6145060	Cyanothece sp. PCC 7425	395961	S	3	0	3	0.00000
SRR6145060	Cyanobium sp. NIES-981	1851505	S	18	3	21	0.00000
SRR6145060	Corynebacterium sp. LMM-1652	2487892	S	177	3	180	0.00002
SRR6145060	Clostridium ljungdahlii	1538	S	1	2	3	0.00000
SRR6145060	Chloroherpeton thalassium	100716	S	3	0	3	0.00000
SRR6145060	Chlamydia pecorum	85991	S	3	0	3	0.00000
SRR6145060	Cellvibrio sp. PSBB023	1945512	S	57	3	60	0.00001
SRR6145060	Carboxydocella thermautotrophica	178899	S	3	0	3	0.00000
SRR6145060	Capnocytophaga sp. H2931	1945657	S	2	3	5	0.00000
SRR6145060	Candidatus Endomicrobium trichonymphae	1408204	S	1	3	4	0.00000
SRR6145060	Candidatus Arthromitus sp. SFB-mouse	49118	S	3	10	13	0.00000
SRR6145060	Candidatus Aquiluna sp. UB-MaderosW2red	1855377	S	3	0	3	0.00000
SRR6145060	Campylobacter sp. NCTC 13003	1660064	S	3	0	3	0.00000
SRR6145060	Campylobacter mucosalis	202	S	3	0	3	0.00000
SRR6145060	Calothrix sp. NIES-3974	2005462	S	19	3	22	0.00000
SRR6145060	Caldisphaera lagunensis	200415	S	3	0	3	0.00000
SRR6145060	Burkholderia sp. MSMB0856	1637869	S	7	3	10	0.00000
SRR6145060	Brevibacillus formosus	54913	S	3	0	3	0.00000
SRR6145060	Blattabacterium sp. (Mastotermes darwiniensis)	39768	S	3	0	3	0.00000
SRR6145060	Blattabacterium sp. (Blatta orientalis)	367806	S	3	0	3	0.00000
SRR6145060	Bifidobacterium coryneforme	1687	S	2	1	3	0.00000
SRR6145060	Betapapillomavirus 3	334207	S	3	0	3	0.00000
SRR6145060	Betapapillomavirus 1	337051	S	3	0	3	0.00000
SRR6145060	Bartonella schoenbuchensis	165694	S	3	0	3	0.00000
SRR6145060	Bartonella australis	388640	S	3	0	3	0.00000
SRR6145060	Bacillus virus IEBH	552525	S	1	3	4	0.00000
SRR6145060	Bacillus tropicus	2026188	S	1	2	3	0.00000
SRR6145060	Bacillus horikoshii	79883	S	3	0	3	0.00000
SRR6145060	Aster yellows witches'-broom phytoplasma	229545	S	3	0	3	0.00000
SRR6145060	Arthrobacter sp. ZXY-2	1806905	S	51	3	54	0.00001
SRR6145060	Arthrobacter sp. YC-RL1	1652545	S	91	3	94	0.00001
SRR6145060	Arthrobacter sp. QXT-31	1357915	S	61	3	64	0.00001
SRR6145060	Arthrobacter sp. PGP41	2079227	S	63	3	66	0.00001
SRR6145060	Anoxybacillus gonensis	198467	S	1	2	3	0.00000
SRR6145060	Alteromonas stellipolaris	233316	S	1	2	3	0.00000
SRR6145060	Alteromonas sp. MB-3u-76	2058133	S	2	3	5	0.00000
SRR6145060	Altererythrobacter sp. BO-6	2604537	S	54	3	57	0.00001
SRR6145060	Allofrancisella frigidaquae	1085644	S	3	0	3	0.00000
SRR6145060	Alcanivorax sp. N3-2A	2014542	S	61	3	64	0.00001
SRR6145060	African swine fever virus	10497	S	3	0	3	0.00000
SRR6145060	Actinobacteria bacterium IMCC19121	1848754	S	9	3	12	0.00000
SRR6145060	Acinetobacter sp. dk386	2662362	S	78	3	81	0.00001
SRR6145060	Acidaminococcus intestini	187327	S	3	0	3	0.00000
SRR6145060	Achromobacter sp. B7	2282475	S	32	3	35	0.00000
SRR6145060	Acetobacterium sp. KB-1	2184575	S	4	3	7	0.00000
SRR6145060	endosymbiont of Sipalinus gigas	1972134	S	2	0	2	0.00000
SRR6145060	Yersinia massiliensis	419257	S	1	1	2	0.00000
SRR6145060	Yersinia aleksiciae	263819	S	2	0	2	0.00000
SRR6145060	Wolinella succinogenes	844	S	2	0	2	0.00000
SRR6145060	White spot syndrome virus	342409	S	2	0	2	0.00000
SRR6145060	Vogesella sp. LIG4	1192162	S	44	2	46	0.00001
SRR6145060	Virgibacillus sp. Bac330	2419841	S	6	2	8	0.00000
SRR6145060	Vibrio tasmaniensis	212663	S	2	0	2	0.00000
SRR6145060	Vibrio sp. 2521-89	2014742	S	1	2	3	0.00000
SRR6145060	Vibrio rotiferianus	190895	S	2	0	2	0.00000
SRR6145060	Vibrio europaeus	300876	S	2	0	2	0.00000
SRR6145060	Vibrio astriarenae	1481923	S	2	0	2	0.00000
SRR6145060	Verrucomicrobia bacterium IMCC26134	1637999	S	25	2	27	0.00000
SRR6145060	Vagococcus sp. CF-49	2562451	S	9	2	11	0.00000
SRR6145060	Turkeypox virus	336486	S	2	0	2	0.00000
SRR6145060	Thiomicrorhabdus indica	2267253	S	2	0	2	0.00000
SRR6145060	Thermoproteus tenax	2271	S	2	0	2	0.00000
SRR6145060	Thermofilum pendens	2269	S	2	0	2	0.00000
SRR6145060	Thermocrinis ruber	75906	S	2	0	2	0.00000
SRR6145060	Thermococcus siculi	72803	S	2	0	2	0.00000
SRR6145060	Thermococcus peptonophilus	53952	S	2	0	2	0.00000
SRR6145060	Thermococcus pacificus	71998	S	2	0	2	0.00000
SRR6145060	Thermococcus onnurineus	342948	S	2	0	2	0.00000
SRR6145060	Thermococcus kodakarensis	311400	S	2	0	2	0.00000
SRR6145060	Thermococcus guaymasensis	110164	S	2	0	2	0.00000
SRR6145060	Thermococcus celer	2264	S	2	0	2	0.00000
SRR6145060	Thermanaeromonas toyohensis	161154	S	2	0	2	0.00000
SRR6145060	Synechococcus sp. PCC 7003	374981	S	2	0	2	0.00000
SRR6145060	Synechococcus sp. PCC 7002	32049	S	2	10	12	0.00000
SRR6145060	Sulfolobus sp. E5-1-F	2663019	S	1	2	3	0.00000
SRR6145060	Sulfodiicoccus acidiphilus	1670455	S	2	0	2	0.00000
SRR6145060	Streptococcus phage PH10	644007	S	18	2	20	0.00000
SRR6145060	Sterolibacteriaceae bacterium J5B	2211108	S	17	2	19	0.00000
SRR6145060	Spirosoma sp. TS118	2735870	S	40	2	42	0.00001
SRR6145060	Spiroplasma syrphidicola	216945	S	2	0	2	0.00000
SRR6145060	Spiroplasma monobiae	2136	S	2	0	2	0.00000
SRR6145060	Spiroplasma chinense	216932	S	2	0	2	0.00000
SRR6145060	Sphingorhabdus sp. YGSMI21	2077182	S	36	2	38	0.00001
SRR6145060	Sphingorhabdus sp. SMR4y	2584094	S	30	2	32	0.00000
SRR6145060	Sphingomonas sp. HDW15B	2714943	S	114	2	116	0.00002
SRR6145060	Shigella virus UTAM	1914162	S	1	2	3	0.00000
SRR6145060	Sheeppox virus	10266	S	1	1	2	0.00000
SRR6145060	Serratia sp. FGI94	671990	S	5	2	7	0.00000
SRR6145060	Sedimentisphaera salicampi	1941349	S	2	0	2	0.00000
SRR6145060	Salmonella virus FSL SP-076	2170217	S	2	1	3	0.00000
SRR6145060	Salinivibrio sp. YCSC6	2003370	S	2	2	4	0.00000
SRR6145060	Salinibacterium sp. dk2585	2603292	S	60	2	62	0.00001
SRR6145060	Runella sp. HYN0085	2259595	S	21	2	23	0.00000
SRR6145060	Rufibacter sp. DG31D	1379910	S	18	2	20	0.00000
SRR6145060	Ruegeria sp. TM1040	292414	S	22	2	24	0.00000
SRR6145060	Ruegeria sp. AD91A	2293862	S	18	2	20	0.00000
SRR6145060	Rickettsia prowazekii	782	S	2	0	2	0.00000
SRR6145060	Rickettsia parkeri	35792	S	1	1	2	0.00000
SRR6145060	Rickettsia monacensis	109232	S	2	0	2	0.00000
SRR6145060	Rickettsia conorii	781	S	1	1	2	0.00000
SRR6145060	Rickettsia australis	787	S	2	0	2	0.00000
SRR6145060	Rickettsia akari	786	S	2	0	2	0.00000
SRR6145060	Rhodospirillaceae bacterium B3	2728875	S	63	2	65	0.00001
SRR6145060	Rhodoplanes sp. Z2-YC6860	674703	S	76	2	78	0.00001
SRR6145060	Rhizobium sp. 11515TR	2028343	S	53	2	55	0.00001
SRR6145060	Pyrococcus kukulkanii	1609559	S	2	0	2	0.00000
SRR6145060	Psychroserpens sp. NJDZ02	2570561	S	21	2	23	0.00000
SRR6145060	Psychrobacter sp. P11F6	1699621	S	178	2	180	0.00002
SRR6145060	Pseudothermotoga thermarum	119394	S	2	0	2	0.00000
SRR6145060	Pseudomonas sp. UW4	1207075	S	22	2	24	0.00000
SRR6145060	Pseudomonas sp. SCB32	2653853	S	51	2	53	0.00001
SRR6145060	Pseudomonas sp. S34	1573718	S	19	2	21	0.00000
SRR6145060	Pseudomonas sp. S1-A32-2	2731681	S	81	2	83	0.00001
SRR6145060	Pseudomonas sp. R76	1573711	S	17	2	19	0.00000
SRR6145060	Pseudomonas sp. R32	1573704	S	36	2	38	0.00001
SRR6145060	Pseudomonas sp. PE08	2604832	S	53	2	55	0.00001
SRR6145060	Pseudomonas sp. Leaf58	1736226	S	45	2	47	0.00001
SRR6145060	Pseudomonas sp. LG1E9	2219057	S	19	2	21	0.00000
SRR6145060	Pseudomonas sp. LG1D9	2083054	S	1	2	3	0.00000
SRR6145060	Pseudomonas sp. DTU12.3	2073078	S	23	2	25	0.00000
SRR6145060	Pseudomonas sp. DR 5-09	1534110	S	2	0	2	0.00000
SRR6145060	Pseudogulbenkiania sp. NH8B	748280	S	28	2	30	0.00000
SRR6145060	Providencia sp. WCHPHu000369	2027290	S	9	2	11	0.00000
SRR6145060	Prochlorococcus sp. MIT 0604	1501268	S	2	22	24	0.00000
SRR6145060	Polynucleobacter acidiphobus	556053	S	2	0	2	0.00000
SRR6145060	Planctomycetes bacterium V202	2527965	S	8	2	10	0.00000
SRR6145060	Planctomycetes bacterium Poly24	2528017	S	10	2	12	0.00000
SRR6145060	Planctomycetes bacterium Pan258	2527981	S	2	2	4	0.00000
SRR6145060	Pigmentiphaga sp. H8	2488560	S	59	2	61	0.00001
SRR6145060	Phreatobacter sp. NMCR1094	2570229	S	59	2	61	0.00001
SRR6145060	Phenylobacterium sp. HYN0004	2201350	S	104	2	106	0.00001
SRR6145060	Pelosinus sp. UFO1	484770	S	17	2	19	0.00000
SRR6145060	Pedobacter sp. G11	2482728	S	33	2	35	0.00000
SRR6145060	Parageobacillus toebii	153151	S	2	0	2	0.00000
SRR6145060	Paraburkholderia sp. CCGE1002	640511	S	31	2	33	0.00000
SRR6145060	Pandoraea sp. XY-2	2518599	S	18	2	20	0.00000
SRR6145060	Paenibacillus sp. B01	2660554	S	17	2	19	0.00000
SRR6145060	Oxynema sp. AP17	2064643	S	10	2	12	0.00000
SRR6145060	Opitutus sp. GAS368	1882749	S	37	2	39	0.00001
SRR6145060	Oenococcus sicerae	2203724	S	2	0	2	0.00000
SRR6145060	Nostoc sp. CENA543	1869241	S	18	2	20	0.00000
SRR6145060	Nonlabens sp. MIC269	1476901	S	2	2	4	0.00000
SRR6145060	Nitratireductor sp. OM-1	1756988	S	41	2	43	0.00001
SRR6145060	Neisseria sp. KEM232	655307	S	118	2	120	0.00002
SRR6145060	Mycoplasma sp. Mirounga ES2806-NAS	754516	S	2	0	2	0.00000
SRR6145060	Mycoplasma flocculare	2128	S	2	0	2	0.00000
SRR6145060	Mycoplasma citelli	171281	S	2	0	2	0.00000
SRR6145060	Mycobacterium virus Twister	1993863	S	1	2	3	0.00000
SRR6145060	Moritella yayanosii	69539	S	2	0	2	0.00000
SRR6145060	Microcystis panniformis	513223	S	1	1	2	0.00000
SRR6145060	Methyloligella sp. GL2	2742204	S	57	2	59	0.00001
SRR6145060	Methylacidiphilum kamchatkense	431057	S	2	0	2	0.00000
SRR6145060	Methanosarcina sp. Kolksee	1434099	S	2	2	4	0.00000
SRR6145060	Methanosalsum zhilinae	39669	S	2	0	2	0.00000
SRR6145060	Methanomethylovorans hollandica	101192	S	2	0	2	0.00000
SRR6145060	Methanohalophilus halophilus	2177	S	2	0	2	0.00000
SRR6145060	Methanoculleus sp. MAB1	86622	S	3	2	5	0.00000
SRR6145060	Methanococcoides methylutens	2226	S	2	0	2	0.00000
SRR6145060	Methanocella conradii	1175444	S	2	0	2	0.00000
SRR6145060	Metallosphaera tengchongensis	1532350	S	2	0	2	0.00000
SRR6145060	Metallosphaera cuprina	1006005	S	2	0	2	0.00000
SRR6145060	Mesotoga prima	1184387	S	2	0	2	0.00000
SRR6145060	Marinobacter sp. es.042	1761794	S	5	2	7	0.00000
SRR6145060	Marinobacter sp. NP-4(2019)	2488665	S	30	2	32	0.00000
SRR6145060	Mannheimia sp. USDA-ARS-USMARC-1261	1432056	S	14	2	16	0.00000
SRR6145060	Limnohabitans sp. 63ED37-2	1678128	S	26	2	28	0.00000
SRR6145060	Leucobacter sp. HDW9A	2714933	S	27	2	29	0.00000
SRR6145060	Leptospirillum ferriphilum	178606	S	2	0	2	0.00000
SRR6145060	Leptospira tipperaryensis	2564040	S	2	0	2	0.00000
SRR6145060	Lactococcus virus CB14	665884	S	1	2	3	0.00000
SRR6145060	Lactococcus sp. 1JSPR-7	2419773	S	3	2	5	0.00000
SRR6145060	Lactobacillus fructivorans	1614	S	2	0	2	0.00000
SRR6145060	Lachnospiraceae bacterium KGMB03038	2594789	S	16	2	18	0.00000
SRR6145060	Laceyella sacchari	37482	S	2	0	2	0.00000
SRR6145060	Kluyvera sp. PO2S7	2705459	S	38	2	40	0.00001
SRR6145060	Klebsiella virus K64-1	2560541	S	3	2	5	0.00000
SRR6145060	Janthinobacterium sp. Marseille	375286	S	15	2	17	0.00000
SRR6145060	Ignicoccus hospitalis	160233	S	2	0	2	0.00000
SRR6145060	Idiomarina sp. X4	2055892	S	5	2	7	0.00000
SRR6145060	Human associated gemykibivirus 2	2004957	S	2	0	2	0.00000
SRR6145060	Hirschia baltica	2724	S	2	0	2	0.00000
SRR6145060	Heterosigma akashiwo virus 01	97195	S	2	0	2	0.00000
SRR6145060	Heliobacterium modesticaldum	35701	S	2	0	2	0.00000
SRR6145060	Helicobacter typhlonius	76936	S	2	0	2	0.00000
SRR6145060	Halomonas sp. THAF5a	2587844	S	44	2	46	0.00001
SRR6145060	Haloactinobacterium sp. HY164	2675754	S	89	2	91	0.00001
SRR6145060	Halieaceae bacterium IMCC3088	2518989	S	17	2	19	0.00000
SRR6145060	Gudongella oleilytica	1582259	S	2	0	2	0.00000
SRR6145060	Gordonia virus Wizard	2170254	S	2	2	4	0.00000
SRR6145060	Geoglobus acetivorans	565033	S	2	0	2	0.00000
SRR6145060	Geobacter sp. M21	443144	S	10	2	12	0.00000
SRR6145060	Geminocystis sp. NIES-3708	1615909	S	26	2	28	0.00000
SRR6145060	Gemella sp. ND 6198	2040624	S	2	12	14	0.00000
SRR6145060	Gammapapillomavirus 7	1175849	S	2	0	2	0.00000
SRR6145060	Gammapapillomavirus 5	333931	S	2	0	2	0.00000
SRR6145060	Gammapapillomavirus 4	333930	S	2	0	2	0.00000
SRR6145060	Gammapapillomavirus 26	1961683	S	2	0	2	0.00000
SRR6145060	Gammapapillomavirus 19	1513264	S	2	0	2	0.00000
SRR6145060	Gammapapillomavirus 1	333926	S	2	0	2	0.00000
SRR6145060	Francisella marina	2249302	S	1	1	2	0.00000
SRR6145060	Flavobacterium sp. M31R6	2739062	S	34	2	36	0.00000
SRR6145060	Flavisolibacter sp. 17J28-1	2502779	S	63	2	65	0.00001
SRR6145060	Escherichia virus N15	40631	S	1	2	3	0.00000
SRR6145060	Entomoplasma luminosum	214888	S	2	0	2	0.00000
SRR6145060	Enterococcus sp. FDAARGOS_375	2060307	S	4	2	6	0.00000
SRR6145060	Elephant endotheliotropic herpesvirus 4	548914	S	2	0	2	0.00000
SRR6145060	Dickeya sp. Secpp 1600	2037915	S	2	8	10	0.00000
SRR6145060	Diaminobutyricimonas sp. LJ205	2683590	S	65	2	67	0.00001
SRR6145060	Devosia sp. 1566	2499144	S	40	2	42	0.00001
SRR6145060	Desulfotalea psychrophila	84980	S	2	0	2	0.00000
SRR6145060	Desulfobacterium autotrophicum	2296	S	2	0	2	0.00000
SRR6145060	DPANN group archaeon LC1Nh	2565781	S	2	0	2	0.00000
SRR6145060	Cronobacter phage vB_CsaM_leB	1885242	S	1	2	3	0.00000
SRR6145060	Cotia virus	39444	S	2	0	2	0.00000
SRR6145060	Corynebacterium sp. 2039	2675219	S	119	2	121	0.00002
SRR6145060	Corynebacterium sp. 1959	2675216	S	83	2	85	0.00001
SRR6145060	Corynebacterium phage Adelaide	2588499	S	1	2	3	0.00000
SRR6145060	Conexivisphaera calidus	1874277	S	2	0	2	0.00000
SRR6145060	Citrobacter youngae	133448	S	1	1	2	0.00000
SRR6145060	Citrobacter sp. TSA-1	184912	S	2	2	4	0.00000
SRR6145060	Citrobacter sp. CRE-46	1703250	S	1	2	3	0.00000
SRR6145060	Citrobacter pasteurii	1563222	S	1	1	2	0.00000
SRR6145060	Chlamydia felis	83556	S	2	0	2	0.00000
SRR6145060	Chlamydia caviae	83557	S	2	0	2	0.00000
SRR6145060	Chelativorans sp. BNC1	266779	S	55	2	57	0.00001
SRR6145060	Candidatus Nitrosotalea devanaterra	1078905	S	11	2	13	0.00000
SRR6145060	Campylobacter virus Los1	2560370	S	1	2	3	0.00000
SRR6145060	Campylobacter sp. RM8964	1660074	S	3	2	5	0.00000
SRR6145060	Calothrix sp. 336/3	1337936	S	6	2	8	0.00000
SRR6145060	Caldisericum exile	693075	S	2	0	2	0.00000
SRR6145060	Caldicellulosiruptor saccharolyticus	44001	S	1	1	2	0.00000
SRR6145060	Caldicellulosiruptor owensensis	55205	S	2	0	2	0.00000
SRR6145060	Brucella sp. 2280	2592625	S	4	2	6	0.00000
SRR6145060	Bovine papular stomatitis virus	129727	S	2	1	3	0.00000
SRR6145060	Blattabacterium sp. (Cryptocercus kyebangensis)	298656	S	2	0	2	0.00000
SRR6145060	Blattabacterium sp. (Blaberus giganteus)	1186051	S	2	0	2	0.00000
SRR6145060	Betapapillomavirus 5	334209	S	2	0	2	0.00000
SRR6145060	Betapapillomavirus 4	334208	S	2	0	2	0.00000
SRR6145060	Bdellovibrio sp. ZAP7	2231053	S	11	2	13	0.00000
SRR6145060	Bartonella bovis	155194	S	2	0	2	0.00000
SRR6145060	Bacillus sp. MD-5	2009331	S	1	2	3	0.00000
SRR6145060	Bacillus sp. JAS24-2	2217832	S	3	2	5	0.00000
SRR6145060	Bacillus aryabhattai	412384	S	1	1	2	0.00000
SRR6145060	Azoarcus sp. SY39	2067960	S	38	2	40	0.00001
SRR6145060	Aurantimicrobium sp. MWH-Uga1	2079575	S	12	2	14	0.00000
SRR6145060	Aurantimicrobium minutum	708131	S	2	0	2	0.00000
SRR6145060	Athalassotoga saccharophila	1441386	S	2	0	2	0.00000
SRR6145060	Arthrobacter sp. YN	2020486	S	34	2	36	0.00000
SRR6145060	Arthrobacter sp. ERGS1:01	1704044	S	67	2	69	0.00001
SRR6145060	Aquitalea sp. THG-DN7.12	1537400	S	18	2	20	0.00000
SRR6145060	Aquifex aeolicus	63363	S	2	0	2	0.00000
SRR6145060	Apibacter sp. B3706	2656760	S	5	2	7	0.00000
SRR6145060	Anaplasma phagocytophilum	948	S	2	0	2	0.00000
SRR6145060	Aminobacterium colombiense	81468	S	2	0	2	0.00000
SRR6145060	Alteromonas sp. RW2A1	1917158	S	1	2	3	0.00000
SRR6145060	Alphapapillomavirus 4	337043	S	2	0	2	0.00000
SRR6145060	Alistipes sp. dk3624	2662363	S	12	2	14	0.00000
SRR6145060	Aeromonas rivipollensis	948519	S	1	1	2	0.00000
SRR6145060	Acinetobacter sp. 185	2715163	S	67	2	69	0.00001
SRR6145060	Acidilobus saccharovorans	242703	S	2	0	2	0.00000
SRR6145060	Acidianus sulfidivorans	312539	S	2	0	2	0.00000
SRR6145060	Acidaminococcus fermentans	905	S	2	0	2	0.00000
SRR6145060	endosymbiont of Pachyrhynchus infernalis	1971488	S	1	0	1	0.00000
SRR6145060	candidate division Zixibacteria bacterium	2053527	S	1	0	1	0.00000
SRR6145060	Yersinia virus D1	1914208	S	1	1	2	0.00000
SRR6145060	Yersinia hibernica	2339259	S	1	0	1	0.00000
SRR6145060	Yersinia canariae	2607663	S	1	0	1	0.00000
SRR6145060	Yellowstone lake phycodnavirus 3	1586715	S	1	0	1	0.00000
SRR6145060	Yellowstone lake phycodnavirus 2	1586714	S	1	0	1	0.00000
SRR6145060	Yellowstone Lake virophage 6	1557034	S	1	0	1	0.00000
SRR6145060	Xanthomonas citri phage CP2	1188795	S	1	0	1	0.00000
SRR6145060	Wenling crustacean virus 3	1923486	S	1	0	1	0.00000
SRR6145060	Virgibacillus sp. SK37	403957	S	5	1	6	0.00000
SRR6145060	Vibrio virus Thalassa	2060093	S	1	1	2	0.00000
SRR6145060	Vibrio qinghaiensis	2025808	S	1	0	1	0.00000
SRR6145060	Vibrio phage helene 12B3	573173	S	1	0	1	0.00000
SRR6145060	Vibrio jasicida	766224	S	1	0	1	0.00000
SRR6145060	Tsukamurella virus TIN2	1982570	S	1	1	2	0.00000
SRR6145060	Torque teno virus 19	687358	S	1	0	1	0.00000
SRR6145060	Thioalkalivibrio sp. K90mix	396595	S	28	1	29	0.00000
SRR6145060	Thermovibrio ammonificans	228745	S	1	0	1	0.00000
SRR6145060	Thermoplasma acidophilum	2303	S	1	0	1	0.00000
SRR6145060	Thermofilum uzonense	1550241	S	1	0	1	0.00000
SRR6145060	Thermocrinis minervae	381751	S	1	0	1	0.00000
SRR6145060	Thermococcus thioreducens	277988	S	1	0	1	0.00000
SRR6145060	Thermococcus sp. EXT12c	2016361	S	4	1	5	0.00000
SRR6145060	Thermococcus sp. 5-4	2008440	S	1	1	2	0.00000
SRR6145060	Thermococcus sp. 4557	1042877	S	4	1	5	0.00000
SRR6145060	Thermococcus sibiricus	172049	S	1	0	1	0.00000
SRR6145060	Thermococcus paralvinellae	582419	S	1	0	1	0.00000
SRR6145060	Thermococcus litoralis	2265	S	1	0	1	0.00000
SRR6145060	Thermococcus eurythermalis	1505907	S	1	0	1	0.00000
SRR6145060	Thermococcus barossii	54077	S	1	0	1	0.00000
SRR6145060	Thermaerobacter sp. PB12/4term	2293838	S	23	1	24	0.00000
SRR6145060	Thermacetogenium phaeum	85874	S	1	0	1	0.00000
SRR6145060	Thalassotalea sp. HSM 43	2552945	S	1	0	1	0.00000
SRR6145060	Tetraselmis viridis virus S20	754070	S	1	0	1	0.00000
SRR6145060	Tanapox virus	99000	S	1	0	1	0.00000
SRR6145060	Syntrophus aciditrophicus	316277	S	1	0	1	0.00000
SRR6145060	Synechocystis sp. CACIAM 05	1933929	S	1	1	2	0.00000
SRR6145060	Synechococcus sp. WH 8103	29410	S	1	10	11	0.00000
SRR6145060	Synechococcus sp. SynAce01	1916956	S	13	1	14	0.00000
SRR6145060	Synechococcus sp. RSCCF101	2511069	S	10	1	11	0.00000
SRR6145060	Synechococcus sp. PCC 7117	195498	S	1	5	6	0.00000
SRR6145060	Synechococcus sp. PCC 11901	2579791	S	1	5	6	0.00000
SRR6145060	Synechococcus sp. JA-2-3B'a(2-13)	321332	S	6	1	7	0.00000
SRR6145060	Swinepox virus	10276	S	1	0	1	0.00000
SRR6145060	Sulfolobus spindle-shaped virus 8	2032563	S	1	0	1	0.00000
SRR6145060	Streptomyces sp. PVA 94-07	1223307	S	1	7	8	0.00000
SRR6145060	Streptomyces sp. GBA 94-10	1218177	S	1	6	7	0.00000
SRR6145060	Streptomyces phage SF3	1690818	S	1	1	2	0.00000
SRR6145060	Streptococcus virus ALQ132	682370	S	1	1	2	0.00000
SRR6145060	Streptococcus sp. DAT741	1940319	S	1	1	2	0.00000
SRR6145060	Streptococcus sp. CNU 77-61	2684658	S	1	2	3	0.00000
SRR6145060	Streptococcus phage EJ-1	12402	S	9	1	10	0.00000
SRR6145060	Staphylococcus virus MCE2014	1924733	S	1	1	2	0.00000
SRR6145060	Squirrelpox virus	240426	S	1	0	1	0.00000
SRR6145060	Sphingosinicella sp. BN140058	1892855	S	169	1	170	0.00002
SRR6145060	Sphingorhabdus sp. M41	1806885	S	27	1	28	0.00000
SRR6145060	Sphingomonas sp. HDW15C	2714944	S	78	1	79	0.00001
SRR6145060	Sphingomonas sp. HDW15A	2714942	S	64	1	65	0.00001
SRR6145060	Sphingobacterium sp. dk4302	2662364	S	40	1	41	0.00001
SRR6145060	Sphaerochaeta coccoides	273376	S	1	0	1	0.00000
SRR6145060	Sinimarinibacterium sp. NLF-5-8	2698684	S	15	1	16	0.00000
SRR6145060	Sindbis virus	11034	S	1	0	1	0.00000
SRR6145060	Shuangao sobemo-like virus 1	1923474	S	1	0	1	0.00000
SRR6145060	Shuangao insect virus 12	1923468	S	1	0	1	0.00000
SRR6145060	Shewanella sp. WE21	2029986	S	10	1	11	0.00000
SRR6145060	Shewanella sp. MEBiC00475	2575361	S	2	1	3	0.00000
SRR6145060	Serratia sp. KUDC3025	2597702	S	2	1	3	0.00000
SRR6145060	Serratia sp. 3ACOL1	2448483	S	2	1	3	0.00000
SRR6145060	Salmon pancreas disease virus	84589	S	1	0	1	0.00000
SRR6145060	Salivirus FHB	1547495	S	1	0	1	0.00000
SRR6145060	Saccharomyces 23S RNA narnavirus	198599	S	1	0	1	0.00000
SRR6145060	Ruminococcaceae bacterium LBM 19010	2666138	S	1	1	2	0.00000
SRR6145060	Ruania sp. HY168	2603206	S	78	1	79	0.00001
SRR6145060	Roseiflexus sp. RS-1	357808	S	17	1	18	0.00000
SRR6145060	Rockport orthohantavirus	1980488	S	1	0	1	0.00000
SRR6145060	Rickettsia rhipicephali	33992	S	1	0	1	0.00000
SRR6145060	Rickettsia montanensis	33991	S	1	0	1	0.00000
SRR6145060	Rhodoferax sp. Gr-4	2527691	S	14	1	15	0.00000
SRR6145060	Rhizobium sp. NXC24	2048897	S	39	1	40	0.00001
SRR6145060	Raineyella sp. CBA3103	2662261	S	96	1	97	0.00001
SRR6145060	Pyrodictium delaneyi	1273541	S	1	0	1	0.00000
SRR6145060	Pyrococcus abyssi	29292	S	1	0	1	0.00000
SRR6145060	Pyrobaculum islandicum	2277	S	1	0	1	0.00000
SRR6145060	Psychrobacter sp. AntiMn-1	1720344	S	68	1	69	0.00001
SRR6145060	Psychrobacillus sp. AK 1817	2303505	S	1	0	1	0.00000
SRR6145060	Pseudomonas virus PaMx25	1982241	S	1	1	2	0.00000
SRR6145060	Pseudomonas virus MP1412	1981049	S	1	1	2	0.00000
SRR6145060	Pseudomonas sp. gcc21	2726989	S	16	1	17	0.00000
SRR6145060	Pseudomonas sp. Z003-0.4C(8344-21)	1855380	S	5	1	6	0.00000
SRR6145060	Pseudomonas sp. TCU-HL1	1856685	S	34	1	35	0.00000
SRR6145060	Pseudomonas sp. StFLB209	1028989	S	39	1	40	0.00001
SRR6145060	Pseudomonas sp. S35	1573719	S	16	1	17	0.00000
SRR6145060	Pseudomonas sp. R84	1573712	S	10	1	11	0.00000
SRR6145060	Pseudomonas sp. QZS01	2213226	S	4	1	5	0.00000
SRR6145060	Pseudomonas sp. MPC6	2498848	S	15	1	16	0.00000
SRR6145060	Pseudomonas sp. LBUM920	2126069	S	1	1	2	0.00000
SRR6145060	Pseudomonas sp. LAB-08	143813	S	21	1	22	0.00000
SRR6145060	Pseudomonas sp. K2W31S-8	2320867	S	52	1	53	0.00001
SRR6145060	Pseudomonas sp. IB20	1702250	S	8	1	9	0.00000
SRR6145060	Pseudomonas sp. HLS-6	2049589	S	22	1	23	0.00000
SRR6145060	Pseudomonas sp. ADAK13	2730847	S	14	1	15	0.00000
SRR6145060	Pseudomonas sp. 31-12	2201356	S	9	1	10	0.00000
SRR6145060	Pseudomonas sp. 11K1	2505979	S	15	1	16	0.00000
SRR6145060	Pseudomonadaceae bacterium SI-3	2079806	S	5	1	6	0.00000
SRR6145060	Pseudoalteromonas sp. THAF3	2587843	S	3	1	4	0.00000
SRR6145060	Pseudoalteromonas sp. DL-6	1390185	S	15	1	16	0.00000
SRR6145060	Pseudoalteromonas sp. 16-SW-7	2583375	S	6	1	7	0.00000
SRR6145060	Pseudoalteromonas sp. 13-15	1761891	S	3	1	4	0.00000
SRR6145060	Pseudanabaena sp. ABRG5-3	685565	S	17	1	18	0.00000
SRR6145060	Pseudactinotalea sp. HY158	2654547	S	104	1	105	0.00001
SRR6145060	Proteus sp. CD3	1921565	S	7	1	8	0.00000
SRR6145060	Proteus phage Mydo	2483610	S	1	1	2	0.00000
SRR6145060	Privet leaf blotch-associated virus	1811408	S	1	0	1	0.00000
SRR6145060	Pontibacter sp. SGAir0037	2571030	S	16	1	17	0.00000
SRR6145060	Pontibacter sp. BT214	2694930	S	24	1	25	0.00000
SRR6145060	Polynucleobacter duraquae	1835254	S	1	0	1	0.00000
SRR6145060	Polaribacter sp. SA4-10	754397	S	24	1	25	0.00000
SRR6145060	Polaribacter sp. MED152	313598	S	14	1	15	0.00000
SRR6145060	Polaribacter sp. L3A8	2686361	S	22	1	23	0.00000
SRR6145060	Polaribacter sp. KT25b	1855336	S	23	1	24	0.00000
SRR6145060	Polaribacter sp. Hel1_33_78	1336804	S	17	1	18	0.00000
SRR6145060	Polaribacter sp. ALD11	2058137	S	23	1	24	0.00000
SRR6145060	Plantago asiatica mosaic virus	28354	S	1	0	1	0.00000
SRR6145060	Planctomycetes bacterium V144	2527964	S	4	1	5	0.00000
SRR6145060	Planctomycetes bacterium I41	2528024	S	18	1	19	0.00000
SRR6145060	Pigeonpox virus	10264	S	1	0	1	0.00000
SRR6145060	Peridroma alphabaculovirus	1346829	S	1	0	1	0.00000
SRR6145060	Penguinpox virus	648998	S	1	0	1	0.00000
SRR6145060	Pedobacter sp. eg	2201271	S	15	1	16	0.00000
SRR6145060	Pediococcus inopinatus	114090	S	1	0	1	0.00000
SRR6145060	Pectobacterium virus phiTE	1980961	S	2	1	3	0.00000
SRR6145060	Pectobacterium phage phiA41	1965354	S	1	1	2	0.00000
SRR6145060	Pantoea sp. CCBC3-3-1	2490851	S	24	1	25	0.00000
SRR6145060	Pantoea sp. At-9b	592316	S	40	1	41	0.00001
SRR6145060	Pantoea sp. 201603H	2479547	S	58	1	59	0.00001
SRR6145060	Oscillatoriales cyanobacterium JSC-12	864702	S	7	1	8	0.00000
SRR6145060	Omegapapillomavirus 1	1177763	S	1	0	1	0.00000
SRR6145060	Olleya sp. Bg11-27	2058135	S	16	1	17	0.00000
SRR6145060	Olive latent virus 2	33773	S	1	0	1	0.00000
SRR6145060	Oceanicola sp. D3	2587163	S	66	1	67	0.00001
SRR6145060	Nitratifractor salsuginis	269261	S	1	0	1	0.00000
SRR6145060	Nemesia ring necrosis virus	312009	S	1	0	1	0.00000
SRR6145060	Natrinema sp. J7-2	406552	S	11	1	12	0.00000
SRR6145060	Nanohaloarchaea archaeon	2594798	S	1	0	1	0.00000
SRR6145060	NY_014 poxvirus	2025360	S	1	0	1	0.00000
SRR6145060	Mycoplasma pneumoniae	2104	S	1	0	1	0.00000
SRR6145060	Mycoplasma phocidae	142651	S	1	0	1	0.00000
SRR6145060	Mycoplasma ovis	171632	S	1	0	1	0.00000
SRR6145060	Mycobacterium virus Brujita	561996	S	2	1	3	0.00000
SRR6145060	Mycobacterium phage RhynO	1458846	S	2	1	3	0.00000
SRR6145060	Mycobacterium phage Lilac	1070990	S	1	1	2	0.00000
SRR6145060	Mycobacterium phage Kratio	1606763	S	1	1	2	0.00000
SRR6145060	Mycetocola sp. 449	2079792	S	46	1	47	0.00001
SRR6145060	Murmansk poxvirus	2025359	S	1	0	1	0.00000
SRR6145060	Murine roseolovirus	1940555	S	1	0	1	0.00000
SRR6145060	Mucilaginibacter sp. 14171R-50	2703789	S	25	1	26	0.00000
SRR6145060	Mint vein banding-associated virus	265877	S	1	0	1	0.00000
SRR6145060	Microbacterium virus RobsFeet	2734255	S	1	1	2	0.00000
SRR6145060	Methylococcus sp. IM1	2681310	S	21	1	22	0.00000
SRR6145060	Methylacidiphilum infernorum	511746	S	1	0	1	0.00000
SRR6145060	Methanothermobacter wolfeii	145261	S	1	0	1	0.00000
SRR6145060	Methanothermobacter thermautotrophicus	145262	S	1	0	1	0.00000
SRR6145060	Methanothermobacter sp. THM-2	2606912	S	1	1	2	0.00000
SRR6145060	Methanospirillum hungatei	2203	S	1	0	1	0.00000
SRR6145060	Methanosarcina sp. WWM596	1434103	S	4	1	5	0.00000
SRR6145060	Methanosarcina sp. WH1	1434102	S	3	1	4	0.00000
SRR6145060	Methanoregula boonei	358766	S	1	0	1	0.00000
SRR6145060	Methanohalophilus portucalensis	39664	S	1	0	1	0.00000
SRR6145060	Methanoculleus bourgensis	83986	S	1	0	1	0.00000
SRR6145060	Methanococcoides burtonii	29291	S	1	0	1	0.00000
SRR6145060	Methanocaldococcus jannaschii	2190	S	1	0	1	0.00000
SRR6145060	Metallosphaera hakonensis	79601	S	1	0	1	0.00000
SRR6145060	Mesoplasma syrphidae	225999	S	1	0	1	0.00000
SRR6145060	Marinilactibacillus sp. 15R	1911586	S	25	1	26	0.00000
SRR6145060	Maprik virus	1590836	S	1	0	1	0.00000
SRR6145060	Lysobacter sp. HDW10	2714936	S	25	1	26	0.00000
SRR6145060	Lysinibacillus sp. YS11	2072025	S	23	1	24	0.00000
SRR6145060	Lymantria dispar multiple nucleopolyhedrovirus	10449	S	1	0	1	0.00000
SRR6145060	Loxodonta africana polyomavirus 1	1891766	S	1	0	1	0.00000
SRR6145060	Leucobacter sp. HDW9C	2714935	S	22	1	23	0.00000
SRR6145060	Leucobacter sp. HDW9B	2714934	S	29	1	30	0.00000
SRR6145060	Leptospirillum ferrooxidans	180	S	1	0	1	0.00000
SRR6145060	Leptolyngbya sp. NIES-3755	1752064	S	22	1	23	0.00000
SRR6145060	Legionella lansingensis	45067	S	1	0	1	0.00000
SRR6145060	Leclercia sp. 29361	2714951	S	14	1	15	0.00000
SRR6145060	Lactococcus virus ASCC191	1165134	S	1	1	2	0.00000
SRR6145060	Lactococcus phage BM13	1229751	S	1	1	2	0.00000
SRR6145060	Lactobacillus gallinarum	52242	S	1	0	1	0.00000
SRR6145060	Lachnospiraceae bacterium Choco86	2109690	S	11	1	12	0.00000
SRR6145060	Kroppenstedtia pulmonis	1380685	S	1	0	1	0.00000
SRR6145060	Kokobera virus	44024	S	1	0	1	0.00000
SRR6145060	Klebsiella virus IME260	2560539	S	2	1	3	0.00000
SRR6145060	Klebsiella virus 1513	1920862	S	1	1	2	0.00000
SRR6145060	Klebsiella phage vB_KpnM_KpV477	1852625	S	1	1	2	0.00000
SRR6145060	Joinjakaka hapavirus	1972615	S	1	0	1	0.00000
SRR6145060	Jeongeupia sp. USM3	1906741	S	42	1	43	0.00001
SRR6145060	Janthinobacterium sp. B9-8	1236179	S	14	1	15	0.00000
SRR6145060	Janthinobacterium sp. 17J80-10	2497863	S	29	1	30	0.00000
SRR6145060	Invertebrate iridescent virus 30	345585	S	1	1	2	0.00000
SRR6145060	Ignicoccus islandicus	54259	S	1	0	1	0.00000
SRR6145060	Iaco orthobunyavirus	2560527	S	1	0	1	0.00000
SRR6145060	Hyperthermus butylicus	54248	S	1	0	1	0.00000
SRR6145060	Hymenobacter sp. TS19	2735321	S	31	1	32	0.00000
SRR6145060	Human endogenous retrovirus K	45617	S	1	45	46	0.00001
SRR6145060	Hubei sobemo-like virus 45	1923233	S	1	0	1	0.00000
SRR6145060	Huangpi Tick Virus 1	1608047	S	1	0	1	0.00000
SRR6145060	Hepatovirus F	1987127	S	1	0	1	0.00000
SRR6145060	Helicobacter mustelae	217	S	1	0	1	0.00000
SRR6145060	Helicobacter heilmannii	35817	S	1	0	1	0.00000
SRR6145060	Helicobacter felis	214	S	1	0	1	0.00000
SRR6145060	Helicobacter bizzozeronii	56877	S	1	0	1	0.00000
SRR6145060	Halorubrum sp. PV6	634157	S	20	1	21	0.00000
SRR6145060	Halorubrum sp. BOL3-1	2497325	S	23	1	24	0.00000
SRR6145060	Halomonas sp. N3-2A	2014541	S	12	1	13	0.00000
SRR6145060	Halomonas sp. GFAJ-1	1118153	S	104	1	105	0.00001
SRR6145060	Hahella sp. KA22	1628392	S	6	1	7	0.00000
SRR6145060	Gordonia virus Kita	2170041	S	1	1	2	0.00000
SRR6145060	Gordonia virus Apricot	2734216	S	1	1	2	0.00000
SRR6145060	Gordonia phage Utz	1838081	S	2	1	3	0.00000
SRR6145060	Gordonia phage UmaThurman	1821563	S	2	1	3	0.00000
SRR6145060	Gordonia phage Guacamole	1821553	S	1	1	2	0.00000
SRR6145060	Golden Marseillevirus	1720526	S	1	0	1	0.00000
SRR6145060	Gimesia sp. E7	2608982	S	1	1	2	0.00000
SRR6145060	Geoglobus ahangari	113653	S	1	0	1	0.00000
SRR6145060	Geobacillus sp. WCH70	471223	S	2	1	3	0.00000
SRR6145060	Geobacillus sp. JS12	1813182	S	2	1	3	0.00000
SRR6145060	Geobacillus sp. GHH01	1233873	S	1	1	2	0.00000
SRR6145060	Geobacillus sp. E263	391290	S	2	1	3	0.00000
SRR6145060	Gemmatimonas sp. TET16	2732249	S	31	1	32	0.00000
SRR6145060	Gammaproteobacteria bacterium ESL0073	2070539	S	3	1	4	0.00000
SRR6145060	Gammapapillomavirus 8	1175850	S	1	0	1	0.00000
SRR6145060	Gammapapillomavirus 21	1961678	S	1	0	1	0.00000
SRR6145060	Gammapapillomavirus 2	333928	S	1	0	1	0.00000
SRR6145060	Gammapapillomavirus 18	1513263	S	1	0	1	0.00000
SRR6145060	Gammapapillomavirus 11	1513256	S	1	0	1	0.00000
SRR6145060	Flavobacterium sp. Sr18	935222	S	30	1	31	0.00000
SRR6145060	Flavihumibacter sp. SB-02	2676868	S	41	1	42	0.00001
SRR6145060	Flanders hapavirus	1972612	S	1	0	1	0.00000
SRR6145060	Fibrella sp. ES10-3-2-2	1834519	S	23	1	24	0.00000
SRR6145060	Escherichia virus JSE	1980959	S	1	1	2	0.00000
SRR6145060	Escherichia virus HY03	2560446	S	2	1	3	0.00000
SRR6145060	Escherichia virus HY02	1985308	S	1	1	2	0.00000
SRR6145060	Erysipelothrix sp. 15TAL0474	2485784	S	7	1	8	0.00000
SRR6145060	Erwinia virus Ea214	1965384	S	2	1	3	0.00000
SRR6145060	Entomoplasma freundtii	74700	S	1	0	1	0.00000
SRR6145060	Enterobacteria phage 285P	669008	S	1	1	2	0.00000
SRR6145060	Enterobacter sp. N18-03635	2500132	S	1	1	2	0.00000
SRR6145060	Ectothiorhodospiraceae bacterium 2226	2740164	S	23	1	24	0.00000
SRR6145060	Dyosigmapapillomavirus 1	1513254	S	1	0	1	0.00000
SRR6145060	Dyella sp. M7H15-1	2501295	S	24	1	25	0.00000
SRR6145060	Draconibacterium sp. M1	2706887	S	14	1	15	0.00000
SRR6145060	Dokdonia sp. MED134	313590	S	4	1	5	0.00000
SRR6145060	Dokdonia sp. Dokd-P16	2173169	S	6	1	7	0.00000
SRR6145060	Dokdonia sp. 4H-3-7-5	983548	S	6	1	7	0.00000
SRR6145060	Desulfurococcus mucosus	2275	S	1	0	1	0.00000
SRR6145060	Deinococcus sp. AJ005	2652443	S	96	1	97	0.00001
SRR6145060	Dactylococcopsis salina	292566	S	1	0	1	0.00000
SRR6145060	Cyanophage S-RIM32	1278479	S	1	0	1	0.00000
SRR6145060	Cyanophage PSS2	658401	S	1	0	1	0.00000
SRR6145060	Cyanophage P-RSM1	536444	S	1	0	1	0.00000
SRR6145060	Cronobacter universalis	535744	S	1	0	1	0.00000
SRR6145060	Coriobacteriaceae bacterium 68-1-3	1531429	S	7	1	8	0.00000
SRR6145060	Clostridium sp. DL-VIII	641107	S	33	1	34	0.00000
SRR6145060	Clostridiaceae bacterium 14S0207	2082193	S	23	1	24	0.00000
SRR6145060	Clostera anastomosis granulovirus B	1986290	S	1	0	1	0.00000
SRR6145060	Citrobacter sp. NMI7904_11	2653932	S	6	1	7	0.00000
SRR6145060	Citrobacter sp. FDAARGOS_156	1702170	S	1	1	2	0.00000
SRR6145060	Chryseobacterium sp. T16E-39	2015076	S	101	1	102	0.00001
SRR6145060	Chryseobacterium sp. H3001	2487073	S	114	1	115	0.00002
SRR6145060	Chromobacterium sp. IIBBL 112-1	2202141	S	1	16	17	0.00000
SRR6145060	Choristoneura fumiferana multiple nucleopolyhedrovirus	208973	S	1	0	1	0.00000
SRR6145060	Chlamydia suis	83559	S	1	0	1	0.00000
SRR6145060	Chlamydia gallinacea	1457153	S	1	0	1	0.00000
SRR6145060	Chitinophaga sp. H33E-04	2703787	S	14	1	15	0.00000
SRR6145060	Cellulophaga sp. L1A9	2686362	S	20	1	21	0.00000
SRR6145060	Carnobacterium sp. 17-4	208596	S	17	1	18	0.00000
SRR6145060	Candidatus Solibacter usitatus	332163	S	58	1	59	0.00001
SRR6145060	Candidatus Sodalis pierantonius	1486991	S	2	1	3	0.00000
SRR6145060	Candidatus Planktophila vernalis	1884907	S	3	1	4	0.00000
SRR6145060	Candidatus Pelagibacter ubique	198252	S	7	1	8	0.00000
SRR6145060	Candidatus Pelagibacter giovannonii	2563896	S	11	1	12	0.00000
SRR6145060	Candidatus Methylopumilus universalis	2588536	S	13	1	14	0.00000
SRR6145060	Candidatus Methylopumilus planktonicus	1581557	S	8	1	9	0.00000
SRR6145060	Candidatus Frankia datiscae	2716812	S	71	1	72	0.00001
SRR6145060	Candidatus Blochmannia pennsylvanicus	101534	S	2	1	3	0.00000
SRR6145060	Candidatus Arthromitus sp. SFB-mouse-NL	1508644	S	1	2	3	0.00000
SRR6145060	Campylobacter sp. RM16704	1500960	S	23	1	24	0.00000
SRR6145060	Caldivirga maquilingensis	76887	S	1	0	1	0.00000
SRR6145060	Burkholderia sp. THE68	758782	S	35	1	36	0.00000
SRR6145060	Burkholderia sp. DHOD12	2571746	S	37	1	38	0.00001
SRR6145060	Burkholderia sp. CCGE1003	640512	S	24	1	25	0.00000
SRR6145060	Burkholderia sp. Bp7605	1740163	S	25	1	26	0.00000
SRR6145060	Burkholderia sp. BDU8	1385592	S	12	1	13	0.00000
SRR6145060	Burkholderia sp. BDU6	1385591	S	12	1	13	0.00000
SRR6145060	Brucella sp. 141012304	1885919	S	2	1	3	0.00000
SRR6145060	Brucella sp. 09RB8471	1149952	S	2	1	3	0.00000
SRR6145060	Breoghania sp. L-A4	2304600	S	49	1	50	0.00001
SRR6145060	Borrelia turicatae	142	S	1	0	1	0.00000
SRR6145060	Borrelia sp. CA690	1476873	S	3	1	4	0.00000
SRR6145060	Bordetella sp. N	1746199	S	40	1	41	0.00001
SRR6145060	Bordetella sp. H567	1697043	S	38	1	39	0.00001
SRR6145060	Bordetella genomosp. 8	1416806	S	38	1	39	0.00001
SRR6145060	Bifidobacterium indicum	1691	S	1	0	1	0.00000
SRR6145060	Betaproteobacteria bacterium GR16-43	1904640	S	54	1	55	0.00001
SRR6145060	Beihai picorna-like virus 44	1922588	S	1	0	1	0.00000
SRR6145060	Bdellovibrio sp. NC01	2220073	S	7	1	8	0.00000
SRR6145060	Bastrovirus BAS-2	2025397	S	1	0	1	0.00000
SRR6145060	Bartonella tribocorum	85701	S	1	0	1	0.00000
SRR6145060	Bartonella birtlesii	111504	S	1	0	1	0.00000
SRR6145060	Bacillus xiamenensis	1178537	S	1	0	1	0.00000
SRR6145060	Bacillus sp. ms-22	2683680	S	3	1	4	0.00000
SRR6145060	Bacillus sp. WP8	756828	S	8	1	9	0.00000
SRR6145060	Bacillus sp. HBCD-sjtu	2053832	S	2	1	3	0.00000
SRR6145060	Bacillus sp. Cs-700	2589818	S	7	1	8	0.00000
SRR6145060	Bacillus sp. ABP14	1892404	S	3	1	4	0.00000
SRR6145060	Bacillus phage Nemo	1805950	S	1	1	2	0.00000
SRR6145060	Azoarcus sp. M9-3-2	2016596	S	56	1	57	0.00001
SRR6145060	Azoarcus sp. KH32C	748247	S	40	1	41	0.00001
SRR6145060	Avian endogenous retrovirus EAV-HP	93465	S	1	0	1	0.00000
SRR6145060	Avian coronavirus	694014	S	1	0	1	0.00000
SRR6145060	Astrovirus VA4	1247113	S	1	0	1	0.00000
SRR6145060	Archaeoglobus veneficus	58290	S	1	0	1	0.00000
SRR6145060	Archaeoglobus profundus	84156	S	1	0	1	0.00000
SRR6145060	Aquaspirillum sp. LM1	1938604	S	36	1	37	0.00000
SRR6145060	Anaplasma ovis	142058	S	1	0	1	0.00000
SRR6145060	Alphapapillomavirus 1	337048	S	1	0	1	0.00000
SRR6145060	Algibacter sp. L3A6	2686366	S	23	1	24	0.00000
SRR6145060	Aeropyrum pernix	56636	S	1	0	1	0.00000
SRR6145060	Aeromonas sp. CU5	2033033	S	8	1	9	0.00000
SRR6145060	Aeromonas sp. CA23	2033032	S	12	1	13	0.00000
SRR6145060	Acinetobacter virus AbP2	2560264	S	3	1	4	0.00000
SRR6145060	Acinetobacter virus AB2	1915207	S	1	1	2	0.00000
SRR6145060	Acinetobacter sp. TGL-Y2	1407071	S	73	1	74	0.00001
SRR6145060	Acinetobacter sp. 323-1	2715164	S	70	1	71	0.00001
SRR6145060	Acidithiobacillus sp. 'AMD consortium'	2614801	S	1	5	6	0.00000
SRR6145060	Acholeplasma laidlawii	2148	S	1	0	1	0.00000
SRR6145060	Acholeplasma brassicae	61635	S	1	0	1	0.00000
SRR6145060	Acetomicrobium mobile	97477	S	1	0	1	0.00000
SRR6145060	secondary endosymbiont of Trabutina mannipara	1835721	S	2	0	2	0.00000
SRR6145060	secondary endosymbiont of Heteropsylla cubana	134287	S	4	0	4	0.00000
SRR6145060	secondary endosymbiont of Ctenarytaina eucalypti	1199245	S	1	0	1	0.00000
SRR6145060	methanogenic archaeon ISO4-H5	1495144	S	3	0	3	0.00000
SRR6145060	gamma proteobacterium SS-5	947516	S	19	0	19	0.00000
SRR6145060	gamma proteobacterium HdN1	83406	S	12	0	12	0.00000
SRR6145060	endosymbiont of unidentified scaly snail isolate Monju	1248727	S	16	0	16	0.00000
SRR6145060	endosymbiont of Acanthamoeba sp. UWC8	86106	S	7	0	7	0.00000
SRR6145060	endosymbiont 'TC1' of Trimyema compressum	243899	S	12	0	12	0.00000
SRR6145060	cyanobacterium endosymbiont of Rhopalodia gibberula	1763363	S	6	8	14	0.00000
SRR6145060	cyanobacterium endosymbiont of Epithemia turgida	718217	S	7	10	17	0.00000
SRR6145060	blood disease bacterium A2-HR MARDI	1944648	S	2	4	6	0.00000
SRR6145060	beta proteobacterium CB	543913	S	1	0	1	0.00000
SRR6145060	alpha proteobacterium HIMB59	744985	S	15	0	15	0.00000
SRR6145060	alpha proteobacterium HIMB5	859653	S	12	0	12	0.00000
SRR6145060	Yersinia virus Yen9-04	2560849	S	2	0	2	0.00000
SRR6145060	Xylella virus Sano	2560848	S	1	0	1	0.00000
SRR6145060	Xylella virus Salvo	2560847	S	3	0	3	0.00000
SRR6145060	Xanthomonas phage Xp15	322855	S	1	0	1	0.00000
SRR6145060	Wolbachia endosymbiont of Trichogramma pretiosum	125593	S	2	0	2	0.00000
SRR6145060	Wolbachia endosymbiont of Folsomia candida	169402	S	4	0	4	0.00000
SRR6145060	Wolbachia endosymbiont of Diaphorina citri	116598	S	2	1	3	0.00000
SRR6145060	Wolbachia endosymbiont of Culex quinquefasciatus	263437	S	5	9	14	0.00000
SRR6145060	Wolbachia endosymbiont of Ctenocephalides felis	212123	S	13	0	13	0.00000
SRR6145060	Wolbachia endosymbiont of Cimex lectularius	246273	S	5	0	5	0.00000
SRR6145060	Wolbachia endosymbiont of Chrysomya megacephala	1335053	S	1	3	4	0.00000
SRR6145060	Wolbachia endosymbiont of Bemisia tabaci	215173	S	5	5	10	0.00000
SRR6145060	Winogradskyella sp. RHA_55	1249933	S	20	0	20	0.00000
SRR6145060	Winogradskyella sp. PG-2	754409	S	18	0	18	0.00000
SRR6145060	Winogradskyella sp. PC-19	754417	S	23	0	23	0.00000
SRR6145060	Winogradskyella sp. J14-2	1936080	S	14	0	14	0.00000
SRR6145060	Weissella sp. HDW19	2714949	S	14	0	14	0.00000
SRR6145060	Walkabout Creek virus	1569258	S	1	0	1	0.00000
SRR6145060	Vitreoscilla sp. C1	96942	S	19	0	19	0.00000
SRR6145060	Virgibacillus sp. MSP4-1	2700081	S	9	0	9	0.00000
SRR6145060	Virgibacillus sp. Bac332	2419842	S	7	0	7	0.00000
SRR6145060	Virgibacillus sp. 6R	1911587	S	12	0	12	0.00000
SRR6145060	Vibrio virus nt1	1914020	S	1	0	1	0.00000
SRR6145060	Vibrio sp. ZWAL4003	2711221	S	2	0	2	0.00000
SRR6145060	Vibrio sp. THAF190c	2587865	S	4	0	4	0.00000
SRR6145060	Vibrio sp. THAF100	2587862	S	9	0	9	0.00000
SRR6145060	Vibrio sp. SM1977	2662262	S	15	0	15	0.00000
SRR6145060	Vibrio sp. HDW18	2714948	S	3	0	3	0.00000
SRR6145060	Vibrio sp. HBUAS61001	2479546	S	14	0	14	0.00000
SRR6145060	Vibrio phage JA-1	1283071	S	1	0	1	0.00000
SRR6145060	Vibrio phage ICP2	979533	S	1	0	1	0.00000
SRR6145060	Vibrio phage ICP1	979525	S	2	0	2	0.00000
SRR6145060	Verrucomicrobium sp. GAS474	1882831	S	33	0	33	0.00000
SRR6145060	Verrucomicrobia phage P8625	1636271	S	1	0	1	0.00000
SRR6145060	Verrucomicrobia bacterium S94	2488809	S	4	0	4	0.00000
SRR6145060	Vampirococcus sp. LiM	1930593	S	4	0	4	0.00000
SRR6145060	Vagococcus sp. HDW17B	2714947	S	18	0	18	0.00000
SRR6145060	Vagococcus sp. HDW17A	2714946	S	7	0	7	0.00000
SRR6145060	Ustilaginoidea virens RNA virus 1	1312445	S	1	0	1	0.00000
SRR6145060	Undibacterium sp. YM2	2058625	S	18	0	18	0.00000
SRR6145060	Undibacterium sp. KW1	2058624	S	15	0	15	0.00000
SRR6145060	Turicibacter sp. H121	1712675	S	8	0	8	0.00000
SRR6145060	Tupaiid betaherpesvirus 1	10397	S	1	0	1	0.00000
SRR6145060	Tsukamurella phage TPA4	1647476	S	5	0	5	0.00000
SRR6145060	Tropheryma whipplei	2039	S	3	-3	0	0.00000
SRR6145060	Tobacco virus 1	1692045	S	1	0	1	0.00000
SRR6145060	Tissierellia sp. JN-28	2507161	S	19	0	19	0.00000
SRR6145060	Thysanoplusia orichalcea nucleopolyhedrovirus	101850	S	1	0	1	0.00000
SRR6145060	Thiomicrospira sp. S5	1803865	S	1	0	1	0.00000
SRR6145060	Thiomicrorhabdus sp. aks77	2675054	S	12	0	12	0.00000
SRR6145060	Thiomicrorhabdus sp. G2	2739063	S	9	0	9	0.00000
SRR6145060	Thiomicrorhabdus sp. G1	2580412	S	8	0	8	0.00000
SRR6145060	Thiomicrorhabdus sp. AkT22	2675053	S	17	0	17	0.00000
SRR6145060	Thermus sp. CCB_US3_UF1	1111069	S	9	0	9	0.00000
SRR6145060	Thermosynechococcus sp. NK55a	1394889	S	2	0	2	0.00000
SRR6145060	Thermosynechococcus sp. CL-1	2583530	S	2	0	2	0.00000
SRR6145060	Thermoplasmatales archaeon BRNA1	1054217	S	1	0	1	0.00000
SRR6145060	Thermodesulfobacterium sp. TA1	2234087	S	2	0	2	0.00000
SRR6145060	Thermococcus sp. SY113	2598455	S	3	0	3	0.00000
SRR6145060	Thermococcus sp. IOH1	2586643	S	1	0	1	0.00000
SRR6145060	Thermococcus sp. AM4	246969	S	2	0	2	0.00000
SRR6145060	Thermococcus sp. 2319x1	1674923	S	2	0	2	0.00000
SRR6145060	Thermoanaerobacterium sp. RBIITD	1550240	S	5	0	5	0.00000
SRR6145060	Thermoanaerobacterales bacterium SK-G1	2316383	S	6	0	6	0.00000
SRR6145060	Thermaerobacter sp. FW80	2546351	S	16	0	16	0.00000
SRR6145060	Thalassotalea sp. PS06	2594005	S	11	0	11	0.00000
SRR6145060	Thalassococcus sp. S3	2017482	S	33	0	33	0.00000
SRR6145060	Terasakiella sp. SH-1	2560057	S	4	0	4	0.00000
SRR6145060	Tenericutes bacterium MZ-XQ	1911683	S	4	0	4	0.00000
SRR6145060	Tenericutes bacterium MO-XQ	1911684	S	7	0	7	0.00000
SRR6145060	Tenacibaculum sp. SZ-18	754423	S	19	0	19	0.00000
SRR6145060	Tatumella sp. TA1	2487345	S	26	0	26	0.00000
SRR6145060	Tannerella sp. oral taxon HOT-286	712710	S	232	2	234	0.00003
SRR6145060	Tamlana sp. UJ94	2069432	S	18	0	18	0.00000
SRR6145060	Synechococcus virus Bellamy	2734095	S	1	0	1	0.00000
SRR6145060	Synechococcus sp. RCC307	316278	S	1	0	1	0.00000
SRR6145060	Synechococcus sp. KORDI-52	585425	S	4	0	4	0.00000
SRR6145060	Synechococcus sp. KORDI-49	585423	S	7	0	7	0.00000
SRR6145060	Synechococcus sp. KORDI-100	1280380	S	4	0	4	0.00000
SRR6145060	Synechococcus sp. CC9902	316279	S	2	0	2	0.00000
SRR6145060	Synechococcus sp. CC9605	110662	S	4	0	4	0.00000
SRR6145060	Synechococcus sp. CC9311	64471	S	1	0	1	0.00000
SRR6145060	Synechococcus sp. CB0101	232348	S	6	0	6	0.00000
SRR6145060	Synechococcus phage S-SSM4	536466	S	1	0	1	0.00000
SRR6145060	Synechococcus phage S-SKS1	754042	S	2	0	2	0.00000
SRR6145060	Synechococcus phage S-CAM8	754038	S	1	0	1	0.00000
SRR6145060	Synechococcus phage S-CAM3	1883366	S	1	0	1	0.00000
SRR6145060	Synechococcus phage S-CAM22	1883365	S	1	0	1	0.00000
SRR6145060	Synechococcus phage ACG-2014h	1340810	S	1	0	1	0.00000
SRR6145060	Synechococcus phage ACG-2014f	1493511	S	1	0	1	0.00000
SRR6145060	Swingsia sp. F3b2	2558361	S	5	0	5	0.00000
SRR6145060	Sulfurovum sp. NBC37-1	387093	S	1	0	1	0.00000
SRR6145060	Sulfurospirillum sp. UCH001	1581011	S	6	0	6	0.00000
SRR6145060	Sulfurospirillum sp. JPD-1	220622	S	3	0	3	0.00000
SRR6145060	Sulfurimonas sp. NW10	2509341	S	5	0	5	0.00000
SRR6145060	Sulfurimonas sp. GYSZ_1	2590022	S	8	0	8	0.00000
SRR6145060	Sulfurihydrogenibium sp. YO3AOP1	436114	S	3	0	3	0.00000
SRR6145060	Sulfuriferula sp. AH1	1985873	S	5	0	5	0.00000
SRR6145060	Sulfolobus sp. S-194	2512240	S	2	0	2	0.00000
SRR6145060	Sulfolobus sp. A20	1891280	S	9	0	9	0.00000
SRR6145060	Sulfolobus islandicus rod-shaped virus 4	1983547	S	1	0	1	0.00000
SRR6145060	Sulfolobus islandicus rod-shaped virus 2	157899	S	1	0	1	0.00000
SRR6145060	Sulfitobacter sp. SK012	1389005	S	12	0	12	0.00000
SRR6145060	Sulfitobacter sp. SK011	1389004	S	15	0	15	0.00000
SRR6145060	Sulfitobacter sp. JL08	2070369	S	16	0	16	0.00000
SRR6145060	Sulfitobacter sp. BSw21498	664426	S	11	0	11	0.00000
SRR6145060	Suid alphaherpesvirus 1	10345	S	1	0	1	0.00000
SRR6145060	Streptomyces virus phiHau3	1982895	S	3	0	3	0.00000
SRR6145060	Streptomyces virus Scap1	2560792	S	2	0	2	0.00000
SRR6145060	Streptomyces virus R4	1982894	S	1	0	1	0.00000
SRR6145060	Streptomyces virus Picard	2734264	S	1	0	1	0.00000
SRR6145060	Streptomyces virus Lannister	1982889	S	1	0	1	0.00000
SRR6145060	Streptomyces virus Darolandstone	2734266	S	1	0	1	0.00000
SRR6145060	Streptomyces virus Bing	2560785	S	1	0	1	0.00000
SRR6145060	Streptomyces phage phiSASD1	747763	S	1	0	1	0.00000
SRR6145060	Streptomyces phage WRightOn	2053723	S	1	0	1	0.00000
SRR6145060	Streptomyces phage Comrade	2301714	S	1	0	1	0.00000
SRR6145060	Streptococcus virus phiAbc2	633135	S	1	0	1	0.00000
SRR6145060	Streptococcus virus Cp7	1982585	S	1	0	1	0.00000
SRR6145060	Streptococcus virus 7201	112023	S	1	0	1	0.00000
SRR6145060	Streptococcus sp. oral taxon 431	712633	S	1453	112	1565	0.00021
SRR6145060	Streptococcus sp. oral taxon 064	712624	S	364	498	862	0.00011
SRR6145060	Streptococcus sp. Z15	2173853	S	11	0	11	0.00000
SRR6145060	Streptococcus phage phiNJ2	1239381	S	1	0	1	0.00000
SRR6145060	Streptococcus phage YMC-2011	1051631	S	1	0	1	0.00000
SRR6145060	Streptococcus phage Str-PAP-1	1589270	S	2	0	2	0.00000
SRR6145060	Streptococcus phage SM1	157924	S	8	0	8	0.00000
SRR6145060	Streptococcus phage PH15	537874	S	3	0	3	0.00000
SRR6145060	Streptococcus constellatus	76860	S	31	-31	0	0.00000
SRR6145060	Stenotrophomonas virus DLP5	2560782	S	1	0	1	0.00000
SRR6145060	Stappia sp. ES.058	1881061	S	36	0	36	0.00000
SRR6145060	Staphylococcus virus Twort	55510	S	5	0	5	0.00000
SRR6145060	Staphylococcus virus GRCS	2732598	S	1	0	1	0.00000
SRR6145060	Staphylococcus virus BP39	2732596	S	2	0	2	0.00000
SRR6145060	Staphylococcus phage vB_SscM-1	1868844	S	3	0	3	0.00000
SRR6145060	Staphylococcus phage phiRS7	1403390	S	1	0	1	0.00000
SRR6145060	Sporosarcina sp. PTS2304	2283194	S	6	0	6	0.00000
SRR6145060	Spongiibacter sp. IMCC21906	1620392	S	5	0	5	0.00000
SRR6145060	Spodoptera frugiperda granulovirus	307454	S	2	0	2	0.00000
SRR6145060	Spiroplasma sp. TIUS-1	216963	S	5	0	5	0.00000
SRR6145060	Spiroplasma sp. BIUS-1	216964	S	8	0	8	0.00000
SRR6145060	Spiribacter sp. 2438	2666185	S	11	0	11	0.00000
SRR6145060	Sphingorhabdus sp. JK6	2725558	S	12	0	12	0.00000
SRR6145060	Sphingorhabdus sp. IMCC1753	2509719	S	30	0	30	0.00000
SRR6145060	Sphingopyxis sp. LPB0140	1913578	S	7	0	7	0.00000
SRR6145060	Sphingomonas virus Scott	2733954	S	2	0	2	0.00000
SRR6145060	Sphingomonas sp. YZ-8	2319844	S	51	0	51	0.00001
SRR6145060	Sphingomonas sp. CSW-10	2698828	S	52	0	52	0.00001
SRR6145060	Sphingomonas sp. AE3	2594473	S	56	0	56	0.00001
SRR6145060	Sphingobium virus Lacusarx	2560778	S	2	0	2	0.00000
SRR6145060	Sphingobium sp. SCG-1	2072936	S	57	0	57	0.00001
SRR6145060	Sphingobacterium sp. ML3W	1538644	S	46	0	46	0.00001
SRR6145060	Sphingobacteriaceae bacterium GW460-11-11-14-LB5	1986952	S	21	0	21	0.00000
SRR6145060	Southern rice black-streaked dwarf virus	519497	S	1	0	1	0.00000
SRR6145060	Solimonas sp. K1W22B-7	2303331	S	100	0	100	0.00001
SRR6145060	Solibacillus sp. R5-41	2048654	S	8	0	8	0.00000
SRR6145060	Sodalis phage phiSG1	373126	S	1	0	1	0.00000
SRR6145060	Snake atadenovirus A	1146872	S	1	0	1	0.00000
SRR6145060	Sinorhizobium phage phiLM21	1524882	S	2	0	2	0.00000
SRR6145060	Simian retrovirus 8	1904439	S	1	0	1	0.00000
SRR6145060	Silvanigrellales bacterium RF1110005	2493639	S	16	0	16	0.00000
SRR6145060	Shigella virus Sb1	1920761	S	2	0	2	0.00000
SRR6145060	Shewanella sp. YLB-06	2593655	S	3	0	3	0.00000
SRR6145060	Shewanella sp. M2	2487742	S	9	0	9	0.00000
SRR6145060	Shewanella sp. Arc9-LZ	2698686	S	3	0	3	0.00000
SRR6145060	Seonamhaeicola sp. S2-3	1936081	S	19	0	19	0.00000
SRR6145060	Selenomonas sp. oral taxon 920	1884263	S	49	0	49	0.00001
SRR6145060	Selenomonas sp. oral taxon 478	712538	S	24	11	35	0.00000
SRR6145060	Selenomonas sp. oral taxon 136	713030	S	21	9	30	0.00000
SRR6145060	Selenomonas sp. oral taxon 126	712528	S	63	1	64	0.00001
SRR6145060	Sediminicola sp. YIK13	1453352	S	10	0	10	0.00000
SRR6145060	Salmonella virus f18SE	1981032	S	1	0	1	0.00000
SRR6145060	Salmonella virus STG2	2732034	S	1	0	1	0.00000
SRR6145060	Salmonella virus SP31	1911006	S	3	0	3	0.00000
SRR6145060	Salmonella virus S132	2732029	S	1	0	1	0.00000
SRR6145060	Salmonella phage 7-11	1054968	S	2	0	2	0.00000
SRR6145060	Salinisphaera sp. LB1	2183911	S	34	0	34	0.00000
SRR6145060	Salinimonas sp. KX18D6	2572577	S	9	0	9	0.00000
SRR6145060	Salinibacterium sp. UTAS2018	2508880	S	18	0	18	0.00000
SRR6145060	Salinarchaeum sp. Harcht-Bsk1	1333523	S	21	0	21	0.00000
SRR6145060	Salarchaeum sp. JOR-1	2599399	S	18	0	18	0.00000
SRR6145060	Saimiriine gammaherpesvirus 2	10381	S	1	0	1	0.00000
SRR6145060	Runella sp. SP2	2268026	S	33	0	33	0.00000
SRR6145060	Ruminococcus sp. JE7A12	2564099	S	15	0	15	0.00000
SRR6145060	Ruegeria phage DSS3-P1	1555208	S	1	0	1	0.00000
SRR6145060	Roseovarius sp. MME-070	2494550	S	31	0	31	0.00000
SRR6145060	Roseobacter virus SIO1	136084	S	1	0	1	0.00000
SRR6145060	Roseimicrobium sp. ORNL1	2711231	S	39	0	39	0.00001
SRR6145060	Romboutsia sp. CE17	2724150	S	19	0	19	0.00000
SRR6145060	Rickettsiales endosymbiont of Stachyamoeba lipophora	2486578	S	11	0	11	0.00000
SRR6145060	Rickettsiales bacterium Ac37b	1528098	S	11	0	11	0.00000
SRR6145060	Rickettsia slovaca	35794	S	1	-1	0	0.00000
SRR6145060	Rickettsia endosymbiont of Ixodes scapularis	444612	S	4	1	5	0.00000
SRR6145060	Rickettsia endosymbiont of Bemisia tabaci	337479	S	12	2	14	0.00000
SRR6145060	Rhodocytophaga sp. 172606-1	2704465	S	33	0	33	0.00000
SRR6145060	Rhodococcus virus Weasel	2560706	S	2	0	2	0.00000
SRR6145060	Rhodococcus virus Pepy6	1982368	S	1	0	1	0.00000
SRR6145060	Rhodococcus phage RRH1	1109717	S	1	0	1	0.00000
SRR6145060	Rhodococcus phage Jace	2182360	S	1	0	1	0.00000
SRR6145060	Rhodococcus phage E3	1007869	S	1	0	1	0.00000
SRR6145060	Rhodobacteraceae bacterium BAR1	2171755	S	17	0	17	0.00000
SRR6145060	Rhizobium virus RHEph01	2733939	S	1	0	1	0.00000
SRR6145060	Rhizobium phage RR1-A	929833	S	1	0	1	0.00000
SRR6145060	Rhinolophus gammaherpesvirus 1	2054179	S	1	0	1	0.00000
SRR6145060	Ralstonia virus RSL1	1980923	S	1	0	1	0.00000
SRR6145060	Ralstonia virus RSB3	2733922	S	1	0	1	0.00000
SRR6145060	Rahnella sp. ERMR1:05	1805933	S	12	0	12	0.00000
SRR6145060	Pyrococcus sp. NA2	342949	S	3	0	3	0.00000
SRR6145060	Pyrococcus furiosus	2261	S	2	-2	0	0.00000
SRR6145060	Pusillimonas sp. ye3	2028345	S	16	0	16	0.00000
SRR6145060	Pusillimonas sp. T7-7	1007105	S	12	0	12	0.00000
SRR6145060	Pusillimonas sp. DMV24BSW_D	2716226	S	7	0	7	0.00000
SRR6145060	Puniceispirillum phage HMO-2011	948071	S	1	0	1	0.00000
SRR6145060	Psychromonas sp. CNPT3	314282	S	6	0	6	0.00000
SRR6145060	Psychrobacter sp. P11G3	1699623	S	63	0	63	0.00001
SRR6145060	Psychrobacter sp. G	571800	S	15	0	15	0.00000
SRR6145060	Psychrobacter sp. FME2	86185	S	24	0	24	0.00000
SRR6145060	Psychrobacter sp. DAB_AL43B	1028416	S	41	0	41	0.00001
SRR6145060	Pseudovibrio sp. FO-BEG1	911045	S	10	0	10	0.00000
SRR6145060	Pseudorhodobacter sp. S12M18	2500533	S	30	0	30	0.00000
SRR6145060	Pseudomonas virus nickie	2560688	S	1	0	1	0.00000
SRR6145060	Pseudomonas virus PollyC	2560679	S	1	0	1	0.00000
SRR6145060	Pseudomonas virus PaMx74	1982358	S	1	0	1	0.00000
SRR6145060	Pseudomonas virus PaMx28	1982357	S	1	0	1	0.00000
SRR6145060	Pseudomonas virus PaBG	2734089	S	3	0	3	0.00000
SRR6145060	Pseudomonas virus Noxifer	2560671	S	2	0	2	0.00000
SRR6145060	Pseudomonas virus Njord	2733332	S	1	0	1	0.00000
SRR6145060	Pseudomonas virus NV1	2560670	S	1	0	1	0.00000
SRR6145060	Pseudomonas virus KIL2	2560665	S	1	0	1	0.00000
SRR6145060	Pseudomonas virus EL	1984787	S	2	0	2	0.00000
SRR6145060	Pseudomonas virus 119X	347326	S	1	0	1	0.00000
SRR6145060	Pseudomonas syringae group genomosp. 3	251701	S	19	2	21	0.00000
SRR6145060	Pseudomonas sp. S-6-2	1931241	S	27	0	27	0.00000
SRR6145060	Pseudomonas sp. R5-89-07	658644	S	4	0	4	0.00000
SRR6145060	Pseudomonas sp. OIL-1	2706126	S	16	0	16	0.00000
SRR6145060	Pseudomonas sp. M30-35	1981174	S	9	0	9	0.00000
SRR6145060	Pseudomonas sp. DY-1	1755504	S	24	0	24	0.00000
SRR6145060	Pseudomonas sp. DG56-2	2320270	S	25	0	25	0.00000
SRR6145060	Pseudomonas sp. CC6-YY-74	1930532	S	32	0	32	0.00000
SRR6145060	Pseudomonas sp. C27(2019)	2604941	S	15	0	15	0.00000
SRR6145060	Pseudomonas sp. ADAK18	2730848	S	16	0	16	0.00000
SRR6145060	Pseudomonas sp. ACM7	2052956	S	5	0	5	0.00000
SRR6145060	Pseudomonas sp. 7SR1	1881017	S	17	0	17	0.00000
SRR6145060	Pseudomonas phage phiPSA1	1500757	S	1	0	1	0.00000
SRR6145060	Pseudomonas phage PhiPA3	998086	S	1	0	1	0.00000
SRR6145060	Pseudomonas phage PS-1	1573458	S	1	0	1	0.00000
SRR6145060	Pseudomonas phage O4	1784982	S	1	0	1	0.00000
SRR6145060	Pseudomonas phage Lu11	1161927	S	1	0	1	0.00000
SRR6145060	Pseudomonas phage 201phi2-1	198110	S	1	0	1	0.00000
SRR6145060	Pseudodesulfovibrio sp. zrk46	2725288	S	9	0	9	0.00000
SRR6145060	Pseudodesulfovibrio sp. SRB007	2678688	S	10	0	10	0.00000
SRR6145060	Pseudoalteromonas sp. R3	1709477	S	11	0	11	0.00000
SRR6145060	Pseudoalteromonas sp. NC201	1514074	S	3	0	3	0.00000
SRR6145060	Pseudoalteromonas sp. A25	116092	S	4	0	4	0.00000
SRR6145060	Pseudoalteromonas phage pYD6-A	754052	S	1	0	1	0.00000
SRR6145060	Pseudoalteromonas phage SL20	2023998	S	2	0	2	0.00000
SRR6145060	Pseudoalteromonas phage Pq0	1667322	S	1	0	1	0.00000
SRR6145060	Pseudenhygromyxa sp. WMMC2535	2712867	S	100	0	100	0.00001
SRR6145060	Proteus phage VB_PmiS-Isfahan	1969841	S	14	0	14	0.00000
SRR6145060	Prosthecochloris sp. HL-130-GSB	1974213	S	6	0	6	0.00000
SRR6145060	Prosthecochloris sp. GSB1	281093	S	3	0	3	0.00000
SRR6145060	Prolixibacteraceae bacterium WC007	2681766	S	19	0	19	0.00000
SRR6145060	Prochlorococcus phage P-TIM68	1542477	S	12	0	12	0.00000
SRR6145060	Primate bocaparvovirus 1	1511871	S	1	0	1	0.00000
SRR6145060	Prevotella sp. oral taxon 299	652716	S	357	40	397	0.00005
SRR6145060	Pragia sp. CF-458	2498113	S	8	0	8	0.00000
SRR6145060	Pradoshia sp. D12	2651284	S	15	0	15	0.00000
SRR6145060	Porcine type-C oncovirus	369960	S	3	0	3	0.00000
SRR6145060	Pontibacter sp. BT326	2694929	S	29	0	29	0.00000
SRR6145060	Pontibacillus sp. HMF3514	2692425	S	9	0	9	0.00000
SRR6145060	Polynucleobacter sp. MWH-UH21B	1743174	S	8	0	8	0.00000
SRR6145060	Polynucleobacter sp. LimPoW16	1743162	S	6	0	6	0.00000
SRR6145060	Polaribacter sp. SA4-12	1312072	S	11	0	11	0.00000
SRR6145060	Planococcus sp. Y42	2213202	S	9	0	9	0.00000
SRR6145060	Planctomycetes bacterium V22	2528027	S	8	0	8	0.00000
SRR6145060	Planctomycetes bacterium TBK1r	2527963	S	12	0	12	0.00000
SRR6145060	Planctomycetes bacterium SV_7m_r	2528025	S	5	0	5	0.00000
SRR6145060	Planctomycetes bacterium SRT547	2596890	S	13	0	13	0.00000
SRR6145060	Planctomycetes bacterium Q31a	2527968	S	9	0	9	0.00000
SRR6145060	Planctomycetes bacterium Poly30	2528018	S	35	0	35	0.00000
SRR6145060	Planctomycetes bacterium Pla85_3_4	2528010	S	20	0	20	0.00000
SRR6145060	Planctomycetes bacterium Pla175	2528009	S	36	0	36	0.00000
SRR6145060	Planctomycetes bacterium Pla163	2528008	S	40	0	40	0.00001
SRR6145060	Planctomycetes bacterium Pla110	2528007	S	8	0	8	0.00000
SRR6145060	Planctomycetes bacterium Pan44	2527983	S	39	0	39	0.00001
SRR6145060	Planctomycetes bacterium Pan265	2527982	S	16	0	16	0.00000
SRR6145060	Planctomycetes bacterium Pan241w	2527973	S	9	0	9	0.00000
SRR6145060	Planctomycetes bacterium Pan216	2527975	S	16	0	16	0.00000
SRR6145060	Planctomycetes bacterium Pan189	2527980	S	6	0	6	0.00000
SRR6145060	Planctomycetes bacterium Pan181	2527972	S	9	0	9	0.00000
SRR6145060	Planctomycetes bacterium Pan161	2527971	S	4	0	4	0.00000
SRR6145060	Planctomycetes bacterium MalM25	2527998	S	26	0	26	0.00000
SRR6145060	Planctomycetes bacterium Mal48	2527994	S	5	0	5	0.00000
SRR6145060	Planctomycetes bacterium Mal4	2528026	S	22	0	22	0.00000
SRR6145060	Planctomycetes bacterium KS4	2528020	S	3	0	3	0.00000
SRR6145060	Planctomycetes bacterium K23_9	1930275	S	1	0	1	0.00000
SRR6145060	Planctomycetes bacterium K22_7	1930273	S	13	0	13	0.00000
SRR6145060	Planctomycetes bacterium HG15A2	1930276	S	5	0	5	0.00000
SRR6145060	Planctomycetes bacterium FF011L	1930274	S	11	0	11	0.00000
SRR6145060	Planctomycetes bacterium Enr17	2527976	S	5	0	5	0.00000
SRR6145060	Planctomycetes bacterium Enr13	2527979	S	15	0	15	0.00000
SRR6145060	Planctomycetes bacterium ElP	2527974	S	94	0	94	0.00001
SRR6145060	Planctomycetes bacterium ETA_A8	2528021	S	14	0	14	0.00000
SRR6145060	Planctomycetes bacterium ETA_A1	2528023	S	109	0	109	0.00001
SRR6145060	Planctomycetales bacterium 10988	2603660	S	11	0	11	0.00000
SRR6145060	Planctomyces sp. SH-PL14	1632864	S	70	0	70	0.00001
SRR6145060	Pirellula sp. SH-Sr6A	1632865	S	12	0	12	0.00000
SRR6145060	Phycisphaerae bacterium RAS2	2528035	S	15	0	15	0.00000
SRR6145060	Perigonia lusca nucleopolyhedrovirus	2560642	S	1	0	1	0.00000
SRR6145060	Peptostreptococcaceae bacterium oral taxon 929	2081703	S	629	27	656	0.00009
SRR6145060	Peptoniphilus sp. ING2-D1G	1912856	S	25	0	25	0.00000
SRR6145060	Peptococcaceae bacterium DCMF	1761012	S	7	0	7	0.00000
SRR6145060	Pelobacter sp. SFB93	1842532	S	6	0	6	0.00000
SRR6145060	Pelistega sp. NLN63	2652177	S	9	0	9	0.00000
SRR6145060	Pelagibacter virus HTVC019P	2733944	S	1	0	1	0.00000
SRR6145060	Pelagibacter virus HTVC011P	2733960	S	1	0	1	0.00000
SRR6145060	Pedobacter sp. CJ43	2605747	S	37	0	37	0.00000
SRR6145060	Pectobacterium virus PM1	2733976	S	1	0	1	0.00000
SRR6145060	Pectobacterium phage CBB	1792242	S	6	0	6	0.00000
SRR6145060	Pectobacterium bacteriophage PM2	1429794	S	1	0	1	0.00000
SRR6145060	Pectinobacterium virus PEAT2	2560629	S	1	0	1	0.00000
SRR6145060	Pasteurellaceae bacterium RH1A	1823760	S	17	0	17	0.00000
SRR6145060	Pasteurellaceae bacterium Orientalotternb1	1524976	S	9	0	9	0.00000
SRR6145060	Paramecium bursaria Chlorella virus NY2A	46021	S	1	2	3	0.00000
SRR6145060	Paraliobacillus sp. X-1125	2213194	S	9	0	9	0.00000
SRR6145060	Paraglaciecola sp. L3A3	2686358	S	8	0	8	0.00000
SRR6145060	Paraglaciecola sp. L1A13	2686359	S	5	0	5	0.00000
SRR6145060	Parageobacillus genomosp. 1	1295642	S	7	0	7	0.00000
SRR6145060	Paracoccus virus Shpa	2560625	S	2	0	2	0.00000
SRR6145060	Paraburkholderia sp. SOS3	1926494	S	34	0	34	0.00000
SRR6145060	Papiine alphaherpesvirus 2	340907	S	1	0	1	0.00000
SRR6145060	Pantoea virus Limelight	1985729	S	1	0	1	0.00000
SRR6145060	Panteoa phage Kyle	2589665	S	1	0	1	0.00000
SRR6145060	Panine betaherpesvirus 2	188763	S	4	0	4	0.00000
SRR6145060	Panine alphaherpesvirus 3	2003507	S	1	0	1	0.00000
SRR6145060	Paenisporosarcina sp. K2R23-3	2320858	S	10	0	10	0.00000
SRR6145060	Paenibacillus sp. Y412MC10	481743	S	4	0	4	0.00000
SRR6145060	Paenibacillus sp. RUD330	2023772	S	16	0	16	0.00000
SRR6145060	Paenibacillus sp. JDR-2	324057	S	4	0	4	0.00000
SRR6145060	Paenibacillus sp. IHB B 3084	867076	S	4	0	4	0.00000
SRR6145060	Paenibacillus sp. HB172198	2565926	S	2	0	2	0.00000
SRR6145060	Paenibacillus sp. DCT19	2211212	S	8	0	8	0.00000
SRR6145060	Paenibacillus sp. CAA11	1532905	S	11	0	11	0.00000
SRR6145060	Paenibacillus sp. BIHB4019	1870819	S	13	0	13	0.00000
SRR6145060	Paenibacillus sp. 37	2607911	S	1	0	1	0.00000
SRR6145060	Paenibacillus sp. 32O-W	1695218	S	7	0	7	0.00000
SRR6145060	Paenibacillus sp. 14171R-81	2704463	S	18	0	18	0.00000
SRR6145060	Paenibacillus sp. 12200R-189	2704462	S	12	0	12	0.00000
SRR6145060	Paenibacillus phage PG1	754053	S	1	0	1	0.00000
SRR6145060	Paenibacillus larvae	1464	S	8	-8	0	0.00000
SRR6145060	Paenibacillaceae bacterium GAS479	1882832	S	6	0	6	0.00000
SRR6145060	Ottowia sp. oral taxon 894	1658672	S	254	9	263	0.00003
SRR6145060	Oryza sativa alphaendornavirus	362693	S	1	0	1	0.00000
SRR6145060	Oryctes rhinoceros nudivirus	92521	S	1	0	1	0.00000
SRR6145060	Orbus sp. IPMB12	1635327	S	7	0	7	0.00000
SRR6145060	Opitutaceae bacterium TAV5	794903	S	45	0	45	0.00001
SRR6145060	Olsenella sp. oral taxon 807	712411	S	104	1	105	0.00001
SRR6145060	Oligotropha carboxidovorans	40137	S	47	-47	0	0.00000
SRR6145060	Oceanospirillales bacterium S2-4-1H	2683272	S	12	0	12	0.00000
SRR6145060	Oceanobacillus sp. 160	2052660	S	4	0	4	0.00000
SRR6145060	Oceanispirochaeta sp. K2	2518645	S	5	0	5	0.00000
SRR6145060	Oceanimonas sp. GK1	511062	S	10	0	10	0.00000
SRR6145060	Oceanihabitans sp. IOP_32	2529032	S	12	0	12	0.00000
SRR6145060	Nonlabens sp. MJ115	2496866	S	4	0	4	0.00000
SRR6145060	Nonlabens sp. MB-3u-79	2058134	S	11	0	11	0.00000
SRR6145060	Nonlabens sp. Hel1_33_55	1336802	S	4	0	4	0.00000
SRR6145060	Nonlabens sp. Ci31	2608253	S	5	0	5	0.00000
SRR6145060	Nitrospira sp. KM1	1936990	S	7	0	7	0.00000
SRR6145060	Nitrosopumilus spindle-shaped virus	2508184	S	1	0	1	0.00000
SRR6145060	Nitrosomonas sp. Is79A3	261292	S	8	0	8	0.00000
SRR6145060	Nitrosomonadales bacterium skT11	2715678	S	16	0	16	0.00000
SRR6145060	Nitrincola sp. KXZD1103	2614693	S	25	0	25	0.00000
SRR6145060	Nitrincola phage 1M3-16	1472912	S	1	0	1	0.00000
SRR6145060	Nitratiruptor sp. SB155-2	387092	S	8	0	8	0.00000
SRR6145060	Nissabacter sp. SGAir0207	2126321	S	27	0	27	0.00000
SRR6145060	Nesterenkonia sp. NBAIMH1	2600320	S	59	0	59	0.00001
SRR6145060	Neokomagataea sp. Ha5	2558360	S	8	0	8	0.00000
SRR6145060	Neochlamydia sp. S13	1353976	S	7	0	7	0.00000
SRR6145060	Neisseria sp. oral taxon 014	641148	S	532	49	581	0.00008
SRR6145060	Neisseria sp. 10022	1853276	S	10	0	10	0.00000
SRR6145060	Nautilia sp. PV-1	2579250	S	12	0	12	0.00000
SRR6145060	Nakamurella sp. s14-144	1902245	S	26	0	26	0.00000
SRR6145060	Mythimna unipuncta nucleopolyhedrovirus	447897	S	2	0	2	0.00000
SRR6145060	Myroides sp. CJ210	2572594	S	12	0	12	0.00000
SRR6145060	Mycoplasma sp. OR1901	2742195	S	3	0	3	0.00000
SRR6145060	Mycoplasma sp. NEAQ87857	2683967	S	9	0	9	0.00000
SRR6145060	Mycoplasma sp. C264-NAS	2726117	S	4	0	4	0.00000
SRR6145060	Mycoplasma sp. 1654_15	2725994	S	4	0	4	0.00000
SRR6145060	Mycoplasma sp. (ex Biomphalaria glabrata)	1749074	S	3	0	3	0.00000
SRR6145060	Mycoplasma genitalium	2097	S	3	-3	0	0.00000
SRR6145060	Mycobacterium virus Vincenzo	1983110	S	1	0	1	0.00000
SRR6145060	Mycobacterium virus Trixie	1993867	S	1	0	1	0.00000
SRR6145060	Mycobacterium virus Tortellini	2560608	S	1	0	1	0.00000
SRR6145060	Mycobacterium virus Stinger	1983119	S	1	0	1	0.00000
SRR6145060	Mycobacterium virus Pukovnik	540068	S	1	0	1	0.00000
SRR6145060	Mycobacterium virus Plot	2170099	S	2	0	2	0.00000
SRR6145060	Mycobacterium virus Papyrus	1982555	S	1	0	1	0.00000
SRR6145060	Mycobacterium virus Nigel	1983118	S	2	0	2	0.00000
SRR6145060	Mycobacterium virus Macncheese	1195070	S	1	0	1	0.00000
SRR6145060	Mycobacterium virus Larva	1056831	S	1	0	1	0.00000
SRR6145060	Mycobacterium virus Gaia	1982148	S	1	0	1	0.00000
SRR6145060	Mycobacterium virus Crimd	861045	S	1	0	1	0.00000
SRR6145060	Mycobacterium virus BrownCNA	1983108	S	1	0	1	0.00000
SRR6145060	Mycobacterium virus Bignuz	1983736	S	1	0	1	0.00000
SRR6145060	Mycobacterium virus Bernal13	1982102	S	3	0	3	0.00000
SRR6145060	Mycobacterium virus Barnyard	1982363	S	1	0	1	0.00000
SRR6145060	Mycobacterium virus Anaya	1034152	S	1	0	1	0.00000
SRR6145060	Mycobacterium phage Redno2	1340709	S	2	0	2	0.00000
SRR6145060	Mycobacterium phage Myrna	546805	S	2	0	2	0.00000
SRR6145060	Mycobacterium phage Murucutumbu	1560286	S	1	0	1	0.00000
SRR6145060	Mycobacterium phage DS6A	45764	S	1	0	1	0.00000
SRR6145060	Mycobacterium phage CRB1	1458841	S	1	0	1	0.00000
SRR6145060	Mycobacterium phage Brocalys	1815608	S	1	0	1	0.00000
SRR6145060	Mycobacterium phage Bactobuster	1784956	S	1	0	1	0.00000
SRR6145060	Mycobacterium phage Adler	1327959	S	1	0	1	0.00000
SRR6145060	Muriicola sp. MMS17-SY002	2507538	S	2	0	2	0.00000
SRR6145060	Murid betaherpesvirus 2	28304	S	2	0	2	0.00000
SRR6145060	Muricauda sp. 501str8	2698672	S	10	0	10	0.00000
SRR6145060	Mucilaginibacter sp. HYN0043	2305508	S	15	0	15	0.00000
SRR6145060	Mucilaginibacter sp. F39-2	2728022	S	27	0	27	0.00000
SRR6145060	Moumouvirus	985782	S	6	0	6	0.00000
SRR6145060	Morganella phage vB_MmoM_MP1	1852628	S	4	0	4	0.00000
SRR6145060	Moraxellaceae bacterium HYN0046	2283318	S	31	0	31	0.00000
SRR6145060	Mobilicoccus sp. NJES-13	2716227	S	87	0	87	0.00001
SRR6145060	Microvirga sp. 17 mud 1-3	2082949	S	82	11	93	0.00001
SRR6145060	Microbulbifer sp. THAF38	2587856	S	3	0	3	0.00000
SRR6145060	Microbulbifer sp. SH-1	2681547	S	17	0	17	0.00000
SRR6145060	Microbulbifer sp. GL-2	2591606	S	12	0	12	0.00000
SRR6145060	Microbulbifer sp. ALW1	1516059	S	9	0	9	0.00000
SRR6145060	Microbulbifer sp. A4B17	359370	S	9	0	9	0.00000
SRR6145060	Microbacterium virus Zeta1847	2734292	S	2	0	2	0.00000
SRR6145060	Microbacterium virus Squash	2734281	S	2	0	2	0.00000
SRR6145060	Microbacterium virus OneinaGillian	2734236	S	1	0	1	0.00000
SRR6145060	Microbacterium virus MementoMori	2734252	S	1	0	1	0.00000
SRR6145060	Microbacterium virus Krampus	2734242	S	1	0	1	0.00000
SRR6145060	Microbacterium virus Hyperion	2734280	S	1	0	1	0.00000
SRR6145060	Microbacterium virus Hendrix	2734268	S	1	0	1	0.00000
SRR6145060	Microbacterium virus Goodman	2734238	S	1	0	1	0.00000
SRR6145060	Microbacterium virus Golden	2560590	S	1	0	1	0.00000
SRR6145060	Microbacterium virus Dismas	2560588	S	3	0	3	0.00000
SRR6145060	Methyloversatilis sp. RAC08	1842540	S	24	0	24	0.00000
SRR6145060	Methylomonas sp. LW13	107637	S	8	0	8	0.00000
SRR6145060	Methylomonas sp. GJ1	2608981	S	12	0	12	0.00000
SRR6145060	Methylomicrobium sp. wino1	2049332	S	4	0	4	0.00000
SRR6145060	Methyloceanibacter sp. wino2	2170729	S	22	0	22	0.00000
SRR6145060	Methanosphaera sp. BMS	1789762	S	6	0	6	0.00000
SRR6145060	Methanosarcina thermophila	2210	S	2	-2	0	0.00000
SRR6145060	Methanosarcina sp. MTP4	1434100	S	5	0	5	0.00000
SRR6145060	Methanofervidicoccus sp. A16	2607662	S	6	0	6	0.00000
SRR6145060	Methanocaldococcus sp. FS406-22	644281	S	6	0	6	0.00000
SRR6145060	Methanobrevibacter sp. YE315	1609968	S	4	0	4	0.00000
SRR6145060	Methanobrevibacter sp. AbM4	224719	S	5	0	5	0.00000
SRR6145060	Methanobacterium sp. MB1	1379702	S	3	0	3	0.00000
SRR6145060	Melanoplus sanguinipes entomopoxvirus	83191	S	1	0	1	0.00000
SRR6145060	Marinomonas sp. MWYL1	400668	S	9	0	9	0.00000
SRR6145060	Marinomonas sp. FW-1	2071621	S	2	0	2	0.00000
SRR6145060	Marinobacterium sp. LSUCC0821	2668067	S	4	0	4	0.00000
SRR6145060	Marinobacter sp. LV10R510-11A	1415568	S	9	0	9	0.00000
SRR6145060	Marinobacter sp. JH2	2547598	S	7	0	7	0.00000
SRR6145060	Marinobacter sp. BSs20148	490759	S	2	0	2	0.00000
SRR6145060	Marinobacter sp. Arc7-DN-1	2304594	S	9	0	9	0.00000
SRR6145060	Mariniflexile sp. TRM1-10	2027857	S	24	0	24	0.00000
SRR6145060	Maribius sp. THAF1	2587842	S	48	0	48	0.00001
SRR6145060	Maribacter sp. T28	1836467	S	9	0	9	0.00000
SRR6145060	Maribacter sp. MJ134	2496865	S	7	0	7	0.00000
SRR6145060	Maribacter sp. HTCC2170	313603	S	10	0	10	0.00000
SRR6145060	Magpie-robin coronavirus HKU18	1159903	S	1	0	1	0.00000
SRR6145060	Magnetospira sp. QH-2	1288970	S	28	0	28	0.00000
SRR6145060	Macropodid alphaherpesvirus 1	137443	S	1	0	1	0.00000
SRR6145060	Macacine gammaherpesvirus 5	154334	S	2	0	2	0.00000
SRR6145060	Macacine betaherpesvirus 9	2560568	S	1	0	1	0.00000
SRR6145060	Macacine betaherpesvirus 3	47929	S	1	0	1	0.00000
SRR6145060	Macacine alphaherpesvirus 1	10325	S	1	0	1	0.00000
SRR6145060	Lysinibacillus sp. SGAir0095	2070463	S	19	0	19	0.00000
SRR6145060	Lysinibacillus sp. 2017	2169540	S	7	0	7	0.00000
SRR6145060	Luteolibacter sp. G-1-1-1	2728835	S	22	0	22	0.00000
SRR6145060	Litoreibacter sp. LN3S51	2599296	S	22	0	22	0.00000
SRR6145060	Listonella phage phiHSIC	310539	S	1	0	1	0.00000
SRR6145060	Listeria sp. PSOL-1	1844999	S	7	0	7	0.00000
SRR6145060	Limnohabitans sp. 103DPR2	1678129	S	11	0	11	0.00000
SRR6145060	Limnobacter sp. SAORIC-580	2732163	S	31	0	31	0.00000
SRR6145060	Leuconostoc virus LN03	2169974	S	1	0	1	0.00000
SRR6145060	Leucania separata nucleopolyhedrovirus	1307956	S	1	0	1	0.00000
SRR6145060	Leptotrichia sp. oral taxon 847	1785996	S	64	7	71	0.00001
SRR6145060	Leptotrichia sp. oral taxon 498	712368	S	227	42	269	0.00004
SRR6145060	Leptotrichia sp. oral taxon 212	712357	S	594	15	609	0.00008
SRR6145060	Leptospira borgpetersenii	174	S	6	-6	0	0.00000
SRR6145060	Leptospira biflexa	172	S	6	-6	0	0.00000
SRR6145060	Lentilitoribacter sp. Alg239-R112	2305987	S	5	0	5	0.00000
SRR6145060	Lelliottia sp. WB101	2153385	S	9	0	9	0.00000
SRR6145060	Legionella sp. TUM19329	2708020	S	7	0	7	0.00000
SRR6145060	Legionella endosymbiont of Polyplax serrata	2005262	S	7	0	7	0.00000
SRR6145060	Leeuwenhoekiella sp. ZYFB001	2719912	S	17	0	17	0.00000
SRR6145060	Lawsonia intracellularis	29546	S	6	-6	0	0.00000
SRR6145060	Lactococcus virus CB13	665883	S	1	0	1	0.00000
SRR6145060	Lactococcus phage phiL47	1412875	S	1	0	1	0.00000
SRR6145060	Lactococcus phage jm3	1262536	S	1	0	1	0.00000
SRR6145060	Lactococcus phage jm2	1262535	S	1	0	1	0.00000
SRR6145060	Lactococcus phage P680	1262537	S	1	0	1	0.00000
SRR6145060	Lactococcus phage P162	1476889	S	1	0	1	0.00000
SRR6145060	Lactococcus phage P087	641487	S	1	0	1	0.00000
SRR6145060	Lactococcus phage D4412	1862959	S	1	0	1	0.00000
SRR6145060	Lactococcus phage 949	881953	S	1	0	1	0.00000
SRR6145060	Lactococcus phage 340	1262533	S	1	0	1	0.00000
SRR6145060	Lactobacillus virus Lenus	2734205	S	1	0	1	0.00000
SRR6145060	Lactobacillus sp. wkB8	1545702	S	1	0	1	0.00000
SRR6145060	Lactobacillus sp. P38	2692756	S	5	0	5	0.00000
SRR6145060	Lactobacillus sp. CBA3606	2099789	S	2	0	2	0.00000
SRR6145060	Lactobacillus sp. CBA3605	2099788	S	3	0	3	0.00000
SRR6145060	Lactobacillus sp. BHWM-4	2419772	S	6	0	6	0.00000
SRR6145060	Lacinutrix sp. Bg11-31	2057808	S	18	0	18	0.00000
SRR6145060	Lacinutrix sp. 5H-3-7-4	983544	S	11	0	11	0.00000
SRR6145060	Lachnospiraceae bacterium oral taxon 500	712991	S	45	3	48	0.00001
SRR6145060	Lachnospiraceae bacterium KM106-2	2093742	S	10	0	10	0.00000
SRR6145060	Labrenzia sp. VG12	2021862	S	29	0	29	0.00000
SRR6145060	Labrenzia sp. THAF82	2587861	S	20	0	20	0.00000
SRR6145060	Labrenzia sp. PHM005	2590016	S	19	0	19	0.00000
SRR6145060	Kushneria sp. YCWA18	657387	S	13	0	13	0.00000
SRR6145060	Kurthia sp. 11kri321	1750719	S	56	0	56	0.00001
SRR6145060	Kordia sp. SMS9	2282170	S	9	0	9	0.00000
SRR6145060	Klebsiella virus KpV80	2560543	S	2	0	2	0.00000
SRR6145060	Klebsiella virus Kp2	1980955	S	1	0	1	0.00000
SRR6145060	Klebsiella phage Soft	2601626	S	1	0	1	0.00000
SRR6145060	Klebsiella phage KP8	2099850	S	1	0	1	0.00000
SRR6145060	Kiritimatiellaeota bacterium S-5007	2697043	S	5	0	5	0.00000
SRR6145060	Kineobactrum sp. M2	2708301	S	15	0	15	0.00000
SRR6145060	Jannaschia sp. CCS1	290400	S	31	0	31	0.00000
SRR6145060	Izhakiella sp. KSNA2	2579935	S	18	0	18	0.00000
SRR6145060	Iodobacter sp. H11R3	2496266	S	8	0	8	0.00000
SRR6145060	Invertebrate iridovirus 25	1301280	S	3	0	3	0.00000
SRR6145060	Influenza C virus	11552	S	1	0	1	0.00000
SRR6145060	Idiomarinaceae bacterium HL-53	1298881	S	7	0	7	0.00000
SRR6145060	Idiomarina sp. OT37-5b	2100422	S	7	0	7	0.00000
SRR6145060	Idiomarina loihiensis	135577	S	10	-10	0	0.00000
SRR6145060	Hyposoter fugitivus ichnovirus	265522	S	3	0	3	0.00000
SRR6145060	Hyphomonas sp. Mor2	1906738	S	17	0	17	0.00000
SRR6145060	Hyphomicrobium sp. MC1	717785	S	26	0	26	0.00000
SRR6145060	Hydrogenophaga sp. PAMC20947	2565558	S	25	0	25	0.00000
SRR6145060	Hydrogenobacter sp. T-8	1632019	S	8	0	8	0.00000
SRR6145060	Hungateiclostridium thermocellum	1515	S	8	-8	0	0.00000
SRR6145060	Human polyomavirus 6	746830	S	2	0	2	0.00000
SRR6145060	Human polyomavirus 5	1891726	S	8	0	8	0.00000
SRR6145060	Human polyomavirus 10	1208309	S	1	0	1	0.00000
SRR6145060	Human mastadenovirus F	130309	S	1	0	1	0.00000
SRR6145060	Human mastadenovirus D	130310	S	1	0	1	0.00000
SRR6145060	Human gammaherpesvirus 4	10376	S	3	0	3	0.00000
SRR6145060	Human coronavirus HKU1	290028	S	1	0	1	0.00000
SRR6145060	Human betaherpesvirus 7	10372	S	3	0	3	0.00000
SRR6145060	Human alphaherpesvirus 1	10298	S	4	0	4	0.00000
SRR6145060	Hoeflea sp. IMCC20628	1620421	S	29	0	29	0.00000
SRR6145060	Hibiscus green spot virus 2	1513278	S	3	0	3	0.00000
SRR6145060	Herbaspirillum sp. meg3	2025949	S	17	0	17	0.00000
SRR6145060	Heliothis zea nudivirus	29250	S	1	0	1	0.00000
SRR6145060	Halothiobacillus sp. LS2	1860122	S	16	0	16	0.00000
SRR6145060	Halorussus sp. ZS-3	2650975	S	7	0	7	0.00000
SRR6145060	Halorussus sp. RC-68	2505977	S	23	0	23	0.00000
SRR6145060	Halorientalis sp. IM1011	1932360	S	17	0	17	0.00000
SRR6145060	Halorhabdus sp. CBA1104	1380432	S	10	0	10	0.00000
SRR6145060	Haloprofundus sp. MHR1	2572921	S	17	0	17	0.00000
SRR6145060	Halomonas sp. Y2R2	2562282	S	23	0	23	0.00000
SRR6145060	Halomonas sp. GT	1971364	S	12	0	12	0.00000
SRR6145060	Halomonas sp. BC-M4-5	2497861	S	47	0	47	0.00001
SRR6145060	Halomonas sp. 1513	1883416	S	44	0	44	0.00001
SRR6145060	Halocella sp. SP3-1	2382161	S	23	0	23	0.00000
SRR6145060	Halobacteriovorax sp. BALOs_7	2109558	S	8	0	8	0.00000
SRR6145060	Haloarculaceae archaeon HArcel1	1679096	S	9	0	9	0.00000
SRR6145060	Haloarcula virus HCIV1	2049890	S	1	0	1	0.00000
SRR6145060	Haloarcula sp. JP-L23	2716717	S	25	0	25	0.00000
SRR6145060	Haloarcula hispanica	51589	S	2	-2	0	0.00000
SRR6145060	Haemophilus sp. oral taxon 036	712310	S	368	69	437	0.00006
SRR6145060	Granulicella sp. WH15	2602070	S	22	0	22	0.00000
SRR6145060	Gramella sp. MAR_2010_147	1250205	S	13	0	13	0.00000
SRR6145060	Gramella sp. MAR_2010_102	1250231	S	8	0	8	0.00000
SRR6145060	Gracilibacillus sp. SCU50	2663022	S	15	0	15	0.00000
SRR6145060	Gordonia virus Yvonnetastic	2560514	S	1	0	1	0.00000
SRR6145060	Gordonia virus Suzy	2734282	S	1	0	1	0.00000
SRR6145060	Gordonia virus Schnabeltier	2734276	S	2	0	2	0.00000
SRR6145060	Gordonia virus Orchid	2560508	S	1	0	1	0.00000
SRR6145060	Gordonia virus Nyceirae	2560506	S	1	0	1	0.00000
SRR6145060	Gordonia virus Mahdia	2560505	S	1	0	1	0.00000
SRR6145060	Gordonia virus Lucky10	2734247	S	2	0	2	0.00000
SRR6145060	Gordonia virus Hedwig	2560502	S	2	0	2	0.00000
SRR6145060	Gordonia virus GAL1	2560493	S	9	0	9	0.00000
SRR6145060	Gordonia virus Eyre	2560492	S	1	0	1	0.00000
SRR6145060	Gordonia virus Cozz	2560490	S	1	0	1	0.00000
SRR6145060	Gordonia virus BrutonGaster	2734263	S	3	0	3	0.00000
SRR6145060	Gordonia virus Britbrat	2560489	S	2	0	2	0.00000
SRR6145060	Gordonia virus BetterKatz	2560485	S	1	0	1	0.00000
SRR6145060	Gordonia virus Bantam	2560484	S	1	0	1	0.00000
SRR6145060	Gordonia phage Rickmore	2507854	S	1	0	1	0.00000
SRR6145060	Gordonia phage Phinally	1821560	S	10	0	10	0.00000
SRR6145060	Gordonia phage Obliviate	1821559	S	1	0	1	0.00000
SRR6145060	Gordonia phage GTE8	1647475	S	1	0	1	0.00000
SRR6145060	Gordonia phage GTE6	1647474	S	2	0	2	0.00000
SRR6145060	Gordonia phage GMA4	1647471	S	2	0	2	0.00000
SRR6145060	Gordonia phage CarolAnn	1887644	S	1	0	1	0.00000
SRR6145060	Gordonia phage Blueberry	1838062	S	1	0	1	0.00000
SRR6145060	Glypta fumiferanae ichnovirus	419435	S	1	0	1	0.00000
SRR6145060	Gluconobacter virus GC1	2560482	S	1	0	1	0.00000
SRR6145060	Glaesserella sp. 15-184	2030797	S	21	0	21	0.00000
SRR6145060	Glaciecola sp. THG-3.7	2489595	S	17	0	17	0.00000
SRR6145060	Glaciecola sp. 4H-3-7+YE-5	983545	S	4	0	4	0.00000
SRR6145060	Gilvibacter sp. SZ-19	754429	S	10	0	10	0.00000
SRR6145060	Gillisia sp. Hel1_33_143	1336796	S	16	0	16	0.00000
SRR6145060	Geobacter sp. FeAm09	2597769	S	9	0	9	0.00000
SRR6145060	Geobacillus virus E3	1572712	S	3	0	3	0.00000
SRR6145060	Geobacillus virus E2	447909	S	1	0	1	0.00000
SRR6145060	Geobacillus genomosp. 3	1921421	S	8	0	8	0.00000
SRR6145060	Gemella sp. oral taxon 928	1785995	S	6	28	34	0.00000
SRR6145060	Gammaproteobacteria bacterium DM2	2169539	S	4	0	4	0.00000
SRR6145060	Fusobacterium sp. oral taxon 203	671211	S	82	35	117	0.00002
SRR6145060	Francisella sp. FSC1006	1547445	S	8	0	8	0.00000
SRR6145060	Formosa sp. L2A11	2686363	S	20	0	20	0.00000
SRR6145060	Formosa sp. Hel3_A1_48	1336795	S	14	0	14	0.00000
SRR6145060	Formosa sp. Hel1_33_131	1336794	S	10	0	10	0.00000
SRR6145060	Formosa sp. Hel1_31_208	1798225	S	16	0	16	0.00000
SRR6145060	Fluoribacter dumoffii	463	S	6	-6	0	0.00000
SRR6145060	Flintibacter sp. KGMB00164	2610895	S	8	0	8	0.00000
SRR6145060	Flavobacterium sp. XS-5	2602769	S	33	0	33	0.00000
SRR6145060	Flavobacterium sp. CJ74	2294119	S	52	0	52	0.00001
SRR6145060	Flavobacteriaceae bacterium UJ101	1150389	S	16	0	16	0.00000
SRR6145060	Flavobacteriaceae bacterium MAR_2010_188	1250295	S	10	0	10	0.00000
SRR6145060	Flavobacteriaceae bacterium F202Z8	2583587	S	11	0	11	0.00000
SRR6145060	Flavobacteriaceae bacterium 3519-10	531844	S	63	0	63	0.00001
SRR6145060	Flavobacteriaceae bacterium 10Alg115	2584122	S	18	0	18	0.00000
SRR6145060	Flaviflexus sp. H23T48	2496867	S	23	0	23	0.00000
SRR6145060	Flammeovirgaceae bacterium 311	1257021	S	25	0	25	0.00000
SRR6145060	Flammeovirga sp. MY04	1191459	S	19	0	19	0.00000
SRR6145060	Ferrimonas sp. S7	2724191	S	4	0	4	0.00000
SRR6145060	Faecalibacterium virus Taranis	2734146	S	1	0	1	0.00000
SRR6145060	Faecalibacterium virus Brigit	2734096	S	1	0	1	0.00000
SRR6145060	Exiguobacterium sp. N4-1P	2051906	S	21	0	21	0.00000
SRR6145060	Euzebya sp. DY32-46	1608957	S	71	0	71	0.00001
SRR6145060	Euproctis pseudoconspersa nucleopolyhedrovirus	307467	S	1	0	1	0.00000
SRR6145060	Escherichia virus Talmos	1910969	S	2	0	2	0.00000
SRR6145060	Escherichia virus T4	10665	S	1	0	1	0.00000
SRR6145060	Escherichia virus Pollock	2170215	S	1	0	1	0.00000
SRR6145060	Escherichia virus IME08	1914192	S	1	0	1	0.00000
SRR6145060	Escherichia virus Golestan	2560464	S	1	0	1	0.00000
SRR6145060	Escherichia virus G4	1986034	S	4	0	4	0.00000
SRR6145060	Escherichia virus EK99P1	1981027	S	1	0	1	0.00000
SRR6145060	Escherichia virus ADB2	1921004	S	1	0	1	0.00000
SRR6145060	Escherichia virus 9g	1921118	S	1	0	1	0.00000
SRR6145060	Escherichia sp. E4742	2044467	S	3	0	3	0.00000
SRR6145060	Erythrobacter sp. KY5	2011159	S	29	0	29	0.00000
SRR6145060	Erysipelothrix sp. HDW6C	2714930	S	6	0	6	0.00000
SRR6145060	Erysipelothrix sp. HDW6B	2714929	S	4	0	4	0.00000
SRR6145060	Erysipelothrix sp. HDW6A	2714928	S	4	0	4	0.00000
SRR6145060	Erwiniaceae bacterium PD-1	2740817	S	7	0	7	0.00000
SRR6145060	Erwinia virus Yoloswag	2734158	S	2	0	2	0.00000
SRR6145060	Erwinia virus Y3	2734143	S	1	0	1	0.00000
SRR6145060	Erwinia virus Frozen	1982578	S	1	0	1	0.00000
SRR6145060	Erwinia virus Alexandra	2734081	S	2	0	2	0.00000
SRR6145060	Erwinia sp. J780	2681984	S	16	0	16	0.00000
SRR6145060	Erwinia phage vB_EamM_ChrisDB	1883371	S	1	0	1	0.00000
SRR6145060	Equid gammaherpesvirus 5	10371	S	1	0	1	0.00000
SRR6145060	Equid alphaherpesvirus 3	80341	S	1	0	1	0.00000
SRR6145060	Enterococcus virus EfV12	2734045	S	1	0	1	0.00000
SRR6145060	Enterococcus virus EFLK1	2560423	S	1	0	1	0.00000
SRR6145060	Enterococcus virus EFDG1	2560422	S	1	0	1	0.00000
SRR6145060	Enterococcus phage EF62phi	977801	S	2	0	2	0.00000
SRR6145060	Enterobacteriaceae endosymbiont of Plateumaris sericea	2675797	S	2	0	2	0.00000
SRR6145060	Enterobacteriaceae endosymbiont of Plateumaris rustica	2675796	S	6	0	6	0.00000
SRR6145060	Enterobacteriaceae endosymbiont of Plateumaris pusilla	2675795	S	2	0	2	0.00000
SRR6145060	Enterobacteriaceae endosymbiont of Plateumaris consimilis	2675794	S	2	0	2	0.00000
SRR6145060	Enterobacteriaceae endosymbiont of Plateumaris braccata	2675793	S	1	0	1	0.00000
SRR6145060	Enterobacteriaceae endosymbiont of Macroplea mutica	2675791	S	2	0	2	0.00000
SRR6145060	Enterobacteriaceae endosymbiont of Macroplea appendiculata	2675790	S	1	0	1	0.00000
SRR6145060	Enterobacteriaceae endosymbiont of Donacia vulgaris	2675789	S	2	0	2	0.00000
SRR6145060	Enterobacteriaceae endosymbiont of Donacia versicolorea	2675788	S	2	0	2	0.00000
SRR6145060	Enterobacteriaceae endosymbiont of Donacia tomentosa	2675787	S	5	0	5	0.00000
SRR6145060	Enterobacteriaceae endosymbiont of Donacia thalassina	2675786	S	1	0	1	0.00000
SRR6145060	Enterobacteriaceae endosymbiont of Donacia sparganii	2675785	S	6	0	6	0.00000
SRR6145060	Enterobacteriaceae endosymbiont of Donacia simplex	2675784	S	1	0	1	0.00000
SRR6145060	Enterobacteriaceae endosymbiont of Donacia semicuprea	2675783	S	1	0	1	0.00000
SRR6145060	Enterobacteriaceae endosymbiont of Donacia proxima	2675782	S	1	0	1	0.00000
SRR6145060	Enterobacteriaceae endosymbiont of Donacia provostii	2675781	S	2	0	2	0.00000
SRR6145060	Enterobacteriaceae endosymbiont of Donacia piscatrix	2675780	S	3	0	3	0.00000
SRR6145060	Enterobacteriaceae endosymbiont of Donacia marginata	2675779	S	3	0	3	0.00000
SRR6145060	Enterobacteriaceae endosymbiont of Donacia dentata	2675777	S	2	0	2	0.00000
SRR6145060	Enterobacteriaceae endosymbiont of Donacia crassipes	2675776	S	2	0	2	0.00000
SRR6145060	Enterobacteriaceae endosymbiont of Donacia clavipes	2675775	S	6	0	6	0.00000
SRR6145060	Enterobacteriaceae endosymbiont of Donacia cinerea	2675774	S	1	0	1	0.00000
SRR6145060	Enterobacteriaceae endosymbiont of Donacia cincticornis	2675773	S	16	0	16	0.00000
SRR6145060	Enterobacteriaceae endosymbiont of Donacia bicoloricornis	2675772	S	6	0	6	0.00000
SRR6145060	Enterobacteriaceae bacterium strain FGI 57	693444	S	19	0	19	0.00000
SRR6145060	Enterobacter virus KDA1	2733608	S	1	0	1	0.00000
SRR6145060	Enterobacter virus F20	1095076	S	1	0	1	0.00000
SRR6145060	Enterobacter sp. SA187	1914861	S	28	0	28	0.00000
SRR6145060	Enterobacter sp. 638	399742	S	7	0	7	0.00000
SRR6145060	Enterobacter phage Arya	1864622	S	1	0	1	0.00000
SRR6145060	Enterobacter cloacae complex sp. FDA-CDC-AR_0164	2077136	S	1	2	3	0.00000
SRR6145060	Enterobacter cloacae complex sp. ECNIH7	1915310	S	6	13	19	0.00000
SRR6145060	Emcibacter sp. MEBiC09520	2582913	S	15	0	15	0.00000
SRR6145060	Elizabethkingia sp. JS20170427COW	2583851	S	48	0	48	0.00001
SRR6145060	Ehrlichia sp. HF	391036	S	4	0	4	0.00000
SRR6145060	Ehrlichia chaffeensis	945	S	3	-3	0	0.00000
SRR6145060	Eggerthellaceae bacterium zg-1050	2734634	S	8	0	8	0.00000
SRR6145060	Eggerthella virus PMBT5	2734244	S	1	0	1	0.00000
SRR6145060	Eggerthella sp. YY7918	502558	S	6	0	6	0.00000
SRR6145060	Edwardsiella phage PEi20	1608310	S	1	0	1	0.00000
SRR6145060	Edaphobacter sp. 12200R-103	2703788	S	14	0	14	0.00000
SRR6145060	Ectothiorhodospiraceae bacterium BW-2	947515	S	14	0	14	0.00000
SRR6145060	Echinicola sp. LN3S3	2591634	S	11	0	11	0.00000
SRR6145060	Duck atadenovirus A	130328	S	1	0	1	0.00000
SRR6145060	Drosophila innubila nudivirus	2057187	S	2	0	2	0.00000
SRR6145060	Dolphin mastadenovirus B	2170001	S	1	0	1	0.00000
SRR6145060	Dokdonia sp. PRO95	1239415	S	2	0	2	0.00000
SRR6145060	Dinoroseobacter virus DFL12	2169868	S	1	0	1	0.00000
SRR6145060	Dietzia sp. oral taxon 368	712270	S	2841	457	3298	0.00043
SRR6145060	Dickeya virus JA11	2734141	S	2	0	2	0.00000
SRR6145060	Dickeya virus AD1	2734080	S	9	0	9	0.00000
SRR6145060	Dickeya phage vB_DsoP_JA10	2283033	S	1	0	1	0.00000
SRR6145060	Dickeya phage BF25/12	1698708	S	2	0	2	0.00000
SRR6145060	Dickeya paradisiaca	69223	S	8	-8	0	0.00000
SRR6145060	Desulfuromonas sp. DDH964	1823759	S	15	0	15	0.00000
SRR6145060	Desulfurococcus amylolyticus	94694	S	2	-2	0	0.00000
SRR6145060	Desulfovibrio sp. IOR2	2583823	S	9	0	9	0.00000
SRR6145060	Deinococcus sp. S14-83	2489213	S	36	0	36	0.00000
SRR6145060	Deefgea sp. D17	2739061	S	5	0	5	0.00000
SRR6145060	Dechloromonas sp. HYN0024	2231055	S	17	0	17	0.00000
SRR6145060	Cyprinid herpesvirus 3	180230	S	3	0	3	0.00000
SRR6145060	Cydia pomonella granulovirus	28289	S	1	0	1	0.00000
SRR6145060	Curvibacter sp. AEP1-3	1844971	S	29	0	29	0.00000
SRR6145060	Cucumber mosaic virus	12305	S	1	0	1	0.00000
SRR6145060	Cronobacter virus CR9	1914899	S	3	0	3	0.00000
SRR6145060	Cronobacter phage vB_CsaM_GAP32	1141136	S	4	0	4	0.00000
SRR6145060	Cronobacter phage S13	1327935	S	2	0	2	0.00000
SRR6145060	Cronobacter phage CR5	1195085	S	5	0	5	0.00000
SRR6145060	Crassaminicella sp. SY095	2599308	S	17	0	17	0.00000
SRR6145060	Coxiella endosymbiont of Amblyomma sculptum	2487929	S	3	1	4	0.00000
SRR6145060	Cotesia congregata bracovirus	39640	S	1	0	1	0.00000
SRR6145060	Corynebacterium sp. sy039	2599641	S	23	0	23	0.00000
SRR6145060	Corynebacteriaceae bacterium 'ARUP UnID 227'	1164002	S	68	71	139	0.00002
SRR6145060	Cordyline virus 2	1177751	S	1	0	1	0.00000
SRR6145060	Colwellia sp. MT41	58049	S	3	0	3	0.00000
SRR6145060	Colwellia sp. Arc7-D	2161872	S	8	0	8	0.00000
SRR6145060	Colwellia sp. Arc7-635	2497879	S	18	0	18	0.00000
SRR6145060	Colwellia sp. 20A7	2689569	S	15	0	15	0.00000
SRR6145060	Cohnella sp. MFER-1	2728023	S	11	0	11	0.00000
SRR6145060	Cohaesibacter sp. ES.047	1798205	S	7	0	7	0.00000
SRR6145060	Cobetia sp. L2A1	2686360	S	13	0	13	0.00000
SRR6145060	Clostridium sp. SY8519	1042156	S	1	0	1	0.00000
SRR6145060	Clostridium sp. JN500901	2068654	S	17	0	17	0.00000
SRR6145060	Clostridium sp. JN-9	2507159	S	12	0	12	0.00000
SRR6145060	Clostridium sp. JN-1	2483110	S	13	0	13	0.00000
SRR6145060	Clostridium sp. CT4	2320868	S	23	0	23	0.00000
SRR6145060	Clostridium sp. BNL1100	755731	S	12	0	12	0.00000
SRR6145060	Clostridium sp. AWRP	2212991	S	11	0	11	0.00000
SRR6145060	Clostridium phage susfortuna	2316154	S	1	0	1	0.00000
SRR6145060	Clostridium phage phiMMP04	1204535	S	1	0	1	0.00000
SRR6145060	Clostridium phage phiCTP1	871584	S	1	0	1	0.00000
SRR6145060	Clostridium phage c-st	12336	S	2	0	2	0.00000
SRR6145060	Clostridium phage CPS2	2175605	S	1	0	1	0.00000
SRR6145060	Clavibacter virus CMP1	2560387	S	1	0	1	0.00000
SRR6145060	Citrus endogenous pararetrovirus	1435008	S	3	0	3	0.00000
SRR6145060	Citrobacter sp. LY-1	2546350	S	4	0	4	0.00000
SRR6145060	Citrobacter freundii complex sp. CFNIH9	2077149	S	4	13	17	0.00000
SRR6145060	Citrobacter freundii complex sp. CFNIH3	2077147	S	2	5	7	0.00000
SRR6145060	Citrobacter freundii complex sp. CFNIH2	2066049	S	10	7	17	0.00000
SRR6145060	Chrysodeixis includens nucleopolyhedrovirus	1207438	S	1	0	1	0.00000
SRR6145060	Chrysochromulina ericina virus	455364	S	5	0	5	0.00000
SRR6145060	Chryseobacterium sp. IHB B 17019	1721091	S	168	3	171	0.00002
SRR6145060	Chromatiaceae bacterium No.7	2699430	S	14	0	14	0.00000
SRR6145060	Chromatiaceae bacterium 2141T.STBD.0c.01a	1978339	S	18	0	18	0.00000
SRR6145060	Christensenella sp. Marseille-P3954	2086585	S	7	0	7	0.00000
SRR6145060	Choristoneura rosaceana entomopoxvirus	1993631	S	1	0	1	0.00000
SRR6145060	Choristoneura murinana nucleopolyhedrovirus	1987479	S	1	0	1	0.00000
SRR6145060	Choristoneura fumiferana granulovirus	56947	S	1	0	1	0.00000
SRR6145060	Choristoneura biennis entomopoxvirus	10288	S	2	0	2	0.00000
SRR6145060	Chloroflexus aurantiacus	1108	S	9	-9	0	0.00000
SRR6145060	Chlamydia sp. H15-1957-10C	1967782	S	1	0	1	0.00000
SRR6145060	Chitinophaga sp. XS-30	2604421	S	23	0	23	0.00000
SRR6145060	Chitinophaga sp. MD30	2033437	S	36	0	36	0.00000
SRR6145060	Chitinimonas sp. R3-44	2594795	S	27	0	27	0.00000
SRR6145060	Cercopithecine alphaherpesvirus 9	35246	S	1	0	1	0.00000
SRR6145060	Cellvibrio sp. PSBB006	1987723	S	31	0	31	0.00000
SRR6145060	Cellulophaga virus Cba172	1918525	S	1	0	1	0.00000
SRR6145060	Cellulophaga phage phiSM	756280	S	1	0	1	0.00000
SRR6145060	Cedecea sp. FDAARGOS_727	2545798	S	12	0	12	0.00000
SRR6145060	Caulobacteraceae bacterium OTSz_A_272	1759059	S	26	0	26	0.00000
SRR6145060	Caulobacteraceae bacterium 0127_4	2686094	S	31	0	31	0.00000
SRR6145060	Caulobacter virus Sansa	2734274	S	2	0	2	0.00000
SRR6145060	Caulobacter virus Rogue	1211643	S	3	0	3	0.00000
SRR6145060	Caulobacter virus CcrPW	2734195	S	2	0	2	0.00000
SRR6145060	Caulobacter virus CcrColossus	2734194	S	1	0	1	0.00000
SRR6145060	Catenovulum sp. CCB-QB4	2172099	S	9	0	9	0.00000
SRR6145060	Carnobacterium sp. CP1	1564681	S	5	0	5	0.00000
SRR6145060	Cardinium endosymbiont of Sogatella furcifera	650378	S	4	0	4	0.00000
SRR6145060	Cardinium endosymbiont of Encarsia pergandiella	249402	S	4	0	4	0.00000
SRR6145060	Caproiciproducens sp. NJN-50	2507162	S	9	0	9	0.00000
SRR6145060	Capnocytophaga sp. oral taxon 878	1316596	S	67	6	73	0.00001
SRR6145060	Capnocytophaga sp. oral taxon 864	1316593	S	59	38	97	0.00001
SRR6145060	Capnocytophaga sp. oral taxon 323	1705617	S	69	50	119	0.00002
SRR6145060	Candidatus Xiphinematobacter sp. Idaho Grape	1704307	S	1	0	1	0.00000
SRR6145060	Candidatus Walczuchella monophlebidarum	1415657	S	2	0	2	0.00000
SRR6145060	Candidatus Vesicomyosocius okutanii	412965	S	3	0	3	0.00000
SRR6145060	Candidatus Uzinura diaspidicola	670956	S	2	0	2	0.00000
SRR6145060	Candidatus Thioglobus singularis	1427364	S	4	0	4	0.00000
SRR6145060	Candidatus Thioglobus autotrophicus	1705394	S	2	0	2	0.00000
SRR6145060	Candidatus Thiodictyon syntrophicum	1166950	S	56	0	56	0.00001
SRR6145060	Candidatus Tachikawaea gelatinosa	1410383	S	5	0	5	0.00000
SRR6145060	Candidatus Syntrophocurvum alkaliphilum	2293317	S	6	0	6	0.00000
SRR6145060	Candidatus Symbiobacter mobilis	1436290	S	14	0	14	0.00000
SRR6145060	Candidatus Sulcia muelleri	336810	S	10	0	10	0.00000
SRR6145060	Candidatus Sneabacter namystus	2601646	S	1	0	1	0.00000
SRR6145060	Candidatus Saccharimonas aalborgensis	1332188	S	18	0	18	0.00000
SRR6145060	Candidatus Ruthia magnifica	386487	S	8	0	8	0.00000
SRR6145060	Candidatus Ruthia endofausta	2738852	S	2	0	2	0.00000
SRR6145060	Candidatus Riesia pediculischaeffi	428411	S	1	0	1	0.00000
SRR6145060	Candidatus Riesia pediculicola	401619	S	3	0	3	0.00000
SRR6145060	Candidatus Rickettsiella viridis	676208	S	6	0	6	0.00000
SRR6145060	Candidatus Rhodoluna planktonica	535712	S	8	0	8	0.00000
SRR6145060	Candidatus Reidiella endopervernicosa	2738883	S	5	0	5	0.00000
SRR6145060	Candidatus Purcelliella pentastirinorum	472834	S	2	0	2	0.00000
SRR6145060	Candidatus Puniceispirillum marinum	767892	S	5	0	5	0.00000
SRR6145060	Candidatus Pseudomonas adelgestsugas	1302376	S	7	0	7	0.00000
SRR6145060	Candidatus Protochlamydia naegleriophila	389348	S	6	0	6	0.00000
SRR6145060	Candidatus Protochlamydia amoebophila	362787	S	7	0	7	0.00000
SRR6145060	Candidatus Promineofilum breve	1806508	S	30	0	30	0.00000
SRR6145060	Candidatus Prometheoarchaeum syntrophicum	2594042	S	9	0	9	0.00000
SRR6145060	Candidatus Profftella armatura	669502	S	5	0	5	0.00000
SRR6145060	Candidatus Portiera aleyrodidarum	91844	S	8	0	8	0.00000
SRR6145060	Candidatus Planktophila versatilis	1884905	S	8	0	8	0.00000
SRR6145060	Candidatus Planktophila limnetica	573600	S	3	0	3	0.00000
SRR6145060	Candidatus Planktophila lacus	1884913	S	7	0	7	0.00000
SRR6145060	Candidatus Planktophila dulcis	1884914	S	5	0	5	0.00000
SRR6145060	Candidatus Phytoplasma ziziphi	135727	S	7	0	7	0.00000
SRR6145060	Candidatus Phytoplasma mali	37692	S	5	0	5	0.00000
SRR6145060	Candidatus Phytoplasma australiense	59748	S	1	0	1	0.00000
SRR6145060	Candidatus Phycorickettsia trachydisci	2115978	S	3	0	3	0.00000
SRR6145060	Candidatus Phaeomarinobacter ectocarpi	1458461	S	14	0	14	0.00000
SRR6145060	Candidatus Paracaedibacter acanthamoebae	91604	S	4	0	4	0.00000
SRR6145060	Candidatus Pantoea carbekii	1235990	S	7	0	7	0.00000
SRR6145060	Candidatus Nucleicultrix amoebiphila	1509244	S	7	0	7	0.00000
SRR6145060	Candidatus Nitrospira inopinata	1715989	S	7	0	7	0.00000
SRR6145060	Candidatus Nitrosotenuis cloacae	1603555	S	2	0	2	0.00000
SRR6145060	Candidatus Nitrosotenuis aquarius	1846278	S	3	0	3	0.00000
SRR6145060	Candidatus Nitrososphaera gargensis	497727	S	2	0	2	0.00000
SRR6145060	Candidatus Nitrososphaera evergladensis	1459637	S	3	0	3	0.00000
SRR6145060	Candidatus Nitrosopumilus sediminis	1229909	S	6	0	6	0.00000
SRR6145060	Candidatus Nitrosopumilus koreensis	1510466	S	7	0	7	0.00000
SRR6145060	Candidatus Nitrosopelagicus brevis	1410606	S	1	0	1	0.00000
SRR6145060	Candidatus Nitrosomarinus catalina	1898749	S	5	0	5	0.00000
SRR6145060	Candidatus Nitrosoglobus terrae	1630141	S	6	0	6	0.00000
SRR6145060	Candidatus Nitrosocosmicus franklandus	1798806	S	5	0	5	0.00000
SRR6145060	Candidatus Nitrosocosmicus exaquare	1826872	S	7	0	7	0.00000
SRR6145060	Candidatus Nesciobacter abundans	2601668	S	4	0	4	0.00000
SRR6145060	Candidatus Nasuia deltocephalinicola	1160784	S	4	0	4	0.00000
SRR6145060	Candidatus Nardonella dryophthoridicola	1971485	S	1	0	1	0.00000
SRR6145060	Candidatus Nanopelagicus limnes	1884634	S	1	0	1	0.00000
SRR6145060	Candidatus Nanopelagicus hibericus	1884915	S	8	0	8	0.00000
SRR6145060	Candidatus Nanopelagicus abundans	1884916	S	5	0	5	0.00000
SRR6145060	Candidatus Midichloria mitochondrii	234827	S	4	0	4	0.00000
SRR6145060	Candidatus Methylospira mobilis	1808979	S	10	0	10	0.00000
SRR6145060	Candidatus Methylopumilus turicensis	1581680	S	11	0	11	0.00000
SRR6145060	Candidatus Methylopumilus rimovensis	2588535	S	5	0	5	0.00000
SRR6145060	Candidatus Methanoplasma termitum	1577791	S	2	0	2	0.00000
SRR6145060	Candidatus Methanomethylophilus alvus	1291540	S	5	0	5	0.00000
SRR6145060	Candidatus Methanomassiliicoccus intestinalis	1406512	S	2	0	2	0.00000
SRR6145060	Candidatus Liberibacter solanacearum	556287	S	7	0	7	0.00000
SRR6145060	Candidatus Liberibacter americanus	309868	S	4	0	4	0.00000
SRR6145060	Candidatus Liberibacter africanus	34020	S	3	0	3	0.00000
SRR6145060	Candidatus Kuenenia stuttgartiensis	174633	S	11	0	11	0.00000
SRR6145060	Candidatus Koribacter versatilis	658062	S	8	0	8	0.00000
SRR6145060	Candidatus Korarchaeum cryptofilum	498846	S	1	0	1	0.00000
SRR6145060	Candidatus Kinetoplastibacterium sorsogonicusi	1576550	S	14	0	14	0.00000
SRR6145060	Candidatus Kinetoplastibacterium oncopeltii	994696	S	5	0	5	0.00000
SRR6145060	Candidatus Kinetoplastibacterium galatii	994695	S	4	0	4	0.00000
SRR6145060	Candidatus Kinetoplastibacterium desouzaii	994692	S	4	0	4	0.00000
SRR6145060	Candidatus Ishikawaella capsulata	168169	S	4	0	4	0.00000
SRR6145060	Candidatus Hodgkinia cicadicola	573658	S	4	0	4	0.00000
SRR6145060	Candidatus Hoaglandella endobia	1778263	S	1	0	1	0.00000
SRR6145060	Candidatus Hepatoplasma crinochetorum	295596	S	8	0	8	0.00000
SRR6145060	Candidatus Gullanella endobia	1070130	S	3	0	3	0.00000
SRR6145060	Candidatus Fukatsuia symbiotica	1878942	S	10	0	10	0.00000
SRR6145060	Candidatus Fonsibacter ubiquis	1925548	S	4	0	4	0.00000
SRR6145060	Candidatus Fokinia solitaria	1802984	S	3	0	3	0.00000
SRR6145060	Candidatus Filomicrobium marinum	1608628	S	20	0	20	0.00000
SRR6145060	Candidatus Evansia muelleri	1495769	S	4	0	4	0.00000
SRR6145060	Candidatus Erwinia haradaeae	1922217	S	29	0	29	0.00000
SRR6145060	Candidatus Enterovibrio luxaltus	1927128	S	9	0	9	0.00000
SRR6145060	Candidatus Endolissoclinum faulkneri	1263979	S	12	0	12	0.00000
SRR6145060	Candidatus Doolittlea endobia	1778262	S	10	0	10	0.00000
SRR6145060	Candidatus Desulfovibrio trichonymphae	1725232	S	1	0	1	0.00000
SRR6145060	Candidatus Desulforudis audaxviator	471827	S	3	0	3	0.00000
SRR6145060	Candidatus Desulfofervidus auxilii	1621989	S	7	0	7	0.00000
SRR6145060	Candidatus Deianiraea vastatrix	2163644	S	5	0	5	0.00000
SRR6145060	Candidatus Cytomitobacter primus	2066024	S	3	0	3	0.00000
SRR6145060	Candidatus Cytomitobacter indipagum	2601575	S	2	0	2	0.00000
SRR6145060	Candidatus Cyclonatronum proteinivorum	1457365	S	7	0	7	0.00000
SRR6145060	Candidatus Coxiella mudrowiae	2054173	S	6	0	6	0.00000
SRR6145060	Candidatus Cloacimonas acidaminovorans	456827	S	4	0	4	0.00000
SRR6145060	Candidatus Chazhemtobacterium aquaticus	2715735	S	1	0	1	0.00000
SRR6145060	Candidatus Carsonella ruddii	114186	S	3	0	3	0.00000
SRR6145060	Candidatus Cardinium hertigii	247481	S	3	0	3	0.00000
SRR6145060	Candidatus Borrelia tachyglossi	1964448	S	2	0	2	0.00000
SRR6145060	Candidatus Blochmannia vafer	251535	S	7	0	7	0.00000
SRR6145060	Candidatus Blochmannia floridanus	203907	S	7	0	7	0.00000
SRR6145060	Candidatus Blochmannia chromaiodes	251542	S	1	0	1	0.00000
SRR6145060	Candidatus Bipolaricaulis anaerobius	2026885	S	2	0	2	0.00000
SRR6145060	Candidatus Baumannia cicadellinicola	186490	S	6	0	6	0.00000
SRR6145060	Candidatus Babela massiliensis	673862	S	5	0	5	0.00000
SRR6145060	Candidatus Azobacteroides pseudotrichonymphae	511435	S	6	0	6	0.00000
SRR6145060	Candidatus Arsenophonus lipoptenae	634113	S	7	0	7	0.00000
SRR6145060	Candidatus Annandia adelgestsuga	1302411	S	1	0	1	0.00000
SRR6145060	Candidatus Amoebophilus asiaticus	281120	S	6	0	6	0.00000
SRR6145060	Candidatus Accumulibacter phosphatis	327160	S	44	0	44	0.00001
SRR6145060	Campylobacter sp. RM6914	1032243	S	4	0	4	0.00000
SRR6145060	Campylobacter sp. RM6137	1660073	S	4	0	4	0.00000
SRR6145060	Campylobacter sp. RM16192	1660080	S	6	0	6	0.00000
SRR6145060	Caloramator sp. E03	2576307	S	13	0	13	0.00000
SRR6145060	Cafeteria roenbergensis virus	1513235	S	3	0	3	0.00000
SRR6145060	Buttiauxella sp. 3AFRM03	2479367	S	13	0	13	0.00000
SRR6145060	Burkholderiales bacterium YL45	1834205	S	5	0	5	0.00000
SRR6145060	Burkholderiales bacterium GJ-E10	1469502	S	27	0	27	0.00000
SRR6145060	Burkholderia virus BcepNazgul	2560360	S	1	0	1	0.00000
SRR6145060	Bubaline alphaherpesvirus 1	202910	S	1	0	1	0.00000
SRR6145060	Brucella sp. 10RB9215	1149953	S	2	0	2	0.00000
SRR6145060	Brucella sp. 09RB8910	1844051	S	2	0	2	0.00000
SRR6145060	Brochothrix virus A9	2560358	S	1	0	1	0.00000
SRR6145060	Brevibacillus phage Sundance	1691958	S	1	0	1	0.00000
SRR6145060	Bradymonadales bacterium V1718	2600177	S	5	0	5	0.00000
SRR6145060	Boseongicola sp. CCM32	2552942	S	23	0	23	0.00000
SRR6145060	Borrelia parkeri	141	S	1	-1	0	0.00000
SRR6145060	Borrelia anserina	143	S	5	-5	0	0.00000
SRR6145060	Bordetella sp. HZ20	2163011	S	18	0	18	0.00000
SRR6145060	Blochmannia endosymbiont of Camponotus nipponensis	2681986	S	5	0	5	0.00000
SRR6145060	Blautia sp. N6H1-15	1912897	S	7	0	7	0.00000
SRR6145060	Blattabacterium sp. DPU	2715232	S	5	0	5	0.00000
SRR6145060	Bifidobacterium asteroides	1684	S	16	-16	0	0.00000
SRR6145060	BeAn 58058 virus	67082	S	1	0	1	0.00000
SRR6145060	Bathymodiolus thermophilus thioautotrophic gill symbiont	2360	S	6	0	6	0.00000
SRR6145060	Bathymodiolus septemdierum thioautotrophic gill symbiont	113267	S	6	0	6	0.00000
SRR6145060	Bathycoccus sp. RCC1105 virus BpV	933845	S	1	0	1	0.00000
SRR6145060	Bat mastadenovirus B	1146874	S	1	0	1	0.00000
SRR6145060	Bartonella sp. WD16.2	1933904	S	5	0	5	0.00000
SRR6145060	Bacteroides sp. CBA7301	2715212	S	18	0	18	0.00000
SRR6145060	Bacteroidales bacterium CF	1400053	S	12	0	12	0.00000
SRR6145060	Bacteroidales bacterium 38-H	2590900	S	11	0	11	0.00000
SRR6145060	Bacillus virus Pascal	1921187	S	1	0	1	0.00000
SRR6145060	Bacillus virus PBS1	10683	S	4	0	4	0.00000
SRR6145060	Bacillus virus G	1084719	S	1	0	1	0.00000
SRR6145060	Bacillus virus B4	1918005	S	2	0	2	0.00000
SRR6145060	Bacillus sp. Y1	352858	S	14	0	14	0.00000
SRR6145060	Bacillus sp. X1(2014)	1565991	S	6	0	6	0.00000
SRR6145060	Bacillus sp. THAF10	2587848	S	8	0	8	0.00000
SRR6145060	Bacillus sp. SYJ	2529386	S	1	0	1	0.00000
SRR6145060	Bacillus sp. SPB7	2715209	S	3	0	3	0.00000
SRR6145060	Bacillus sp. SB49	1071080	S	3	0	3	0.00000
SRR6145060	Bacillus sp. S3	486398	S	12	0	12	0.00000
SRR6145060	Bacillus sp. OxB-1	98228	S	12	0	12	0.00000
SRR6145060	Bacillus sp. NSP9.1	1071078	S	9	0	9	0.00000
SRR6145060	Bacillus sp. N3536	2666127	S	4	0	4	0.00000
SRR6145060	Bacillus sp. N1-1	2682541	S	6	0	6	0.00000
SRR6145060	Bacillus sp. KH172YL63	2709784	S	13	0	13	0.00000
SRR6145060	Bacillus sp. IHB B 7164	1827146	S	1	4	5	0.00000
SRR6145060	Bacillus sp. FJAT-45348	2011012	S	6	0	6	0.00000
SRR6145060	Bacillus sp. FJAT-42376	2014076	S	9	0	9	0.00000
SRR6145060	Bacillus sp. FJAT-25496	1742359	S	11	0	11	0.00000
SRR6145060	Bacillus sp. FJAT-22090	1581038	S	24	0	24	0.00000
SRR6145060	Bacillus sp. FJAT-18017	1705566	S	7	0	7	0.00000
SRR6145060	Bacillus sp. DSL-17	2567941	S	14	0	14	0.00000
SRR6145060	Bacillus sp. BD59S	2499213	S	2	0	2	0.00000
SRR6145060	Bacillus sp. 1NLA3E	666686	S	18	0	18	0.00000
SRR6145060	Bacillaceae bacterium TKL69	2594883	S	9	0	9	0.00000
SRR6145060	Azotobacter vinelandii	354	S	40	-40	0	0.00000
SRR6145060	Avian myelocytomatosis virus	11867	S	1	0	1	0.00000
SRR6145060	Avian leukosis virus	11864	S	2	0	2	0.00000
SRR6145060	Avian avulavirus 5	740710	S	1	0	1	0.00000
SRR6145060	Auritidibacter sp. NML130574	2170745	S	43	0	43	0.00001
SRR6145060	Aureococcus anophagefferens virus	1474867	S	3	0	3	0.00000
SRR6145060	Aureitalea sp. RR4-38	2094025	S	9	0	9	0.00000
SRR6145060	Aurantimicrobium sp. MWH-Mo1	1987356	S	18	0	18	0.00000
SRR6145060	Ateline gammaherpesvirus 3	85618	S	1	0	1	0.00000
SRR6145060	Astrovirus wild boar/WBAstV-1/2011/HUN	1137931	S	1	0	1	0.00000
SRR6145060	Arthrobacter virus Tank	1982567	S	1	0	1	0.00000
SRR6145060	Arthrobacter virus Maja	2734249	S	1	0	1	0.00000
SRR6145060	Arthrobacter phage Mendel	2484218	S	1	0	1	0.00000
SRR6145060	Arsenicicoccus sp. oral taxon 190	1658671	S	267	18	285	0.00004
SRR6145060	Armatimonadetes bacterium Uphvl-Ar2	2004468	S	10	0	10	0.00000
SRR6145060	Armatimonadetes bacterium Uphvl-Ar1	2004467	S	4	0	4	0.00000
SRR6145060	Archaeoglobus fulgidus	2234	S	2	-2	0	0.00000
SRR6145060	Arcanobacterium sp. 2701	2722751	S	5	0	5	0.00000
SRR6145060	Arachidicoccus sp. KIS59-12	2341117	S	24	0	24	0.00000
SRR6145060	Arachidicoccus sp. BS20	1850526	S	22	0	22	0.00000
SRR6145060	Arachidicoccus sp. B3-10	2545455	S	45	0	45	0.00001
SRR6145060	Aquimarina sp. BL5	1714860	S	18	0	18	0.00000
SRR6145060	Aquimarina sp. AD10	1714849	S	22	0	22	0.00000
SRR6145060	Aquimarina sp. AD1	1714848	S	18	0	18	0.00000
SRR6145060	Aquiluna sp. 15G-AUS-rot	2499157	S	8	0	8	0.00000
SRR6145060	Apibacter sp. HY041	2500547	S	16	0	16	0.00000
SRR6145060	Aotine betaherpesvirus 1	50290	S	1	0	1	0.00000
SRR6145060	Anopheles minimus irodovirus	1465751	S	1	0	1	0.00000
SRR6145060	Aneurinibacillus sp. XH2	1450761	S	6	0	6	0.00000
SRR6145060	Anaeromyxobacter sp. Fw109-5	404589	S	63	0	63	0.00001
SRR6145060	Anaerolineaceae bacterium oral taxon 439	1889813	S	7	0	7	0.00000
SRR6145060	Anaerocolumna sp. CBA3638	2696063	S	11	0	11	0.00000
SRR6145060	Amycolatopsis mediterranei	33910	S	212	-212	0	0.00000
SRR6145060	Aminipila sp. JN-18	2507160	S	12	0	12	0.00000
SRR6145060	Aminipila sp. CBA3637	2697030	S	16	0	16	0.00000
SRR6145060	Alteromonas virus H4-4	2733905	S	2	0	2	0.00000
SRR6145060	Alteromonas sp. RKMC-009	2267264	S	9	0	9	0.00000
SRR6145060	Alteromonas sp. I4	2652380	S	15	0	15	0.00000
SRR6145060	Alteromonas sp. BL110	1714845	S	6	0	6	0.00000
SRR6145060	Alteromonas sp. 76-1	2358187	S	7	0	7	0.00000
SRR6145060	Altererythrobacter sp. ZODW24	2185142	S	13	0	13	0.00000
SRR6145060	Alloprevotella sp. E39	2133944	S	27	0	27	0.00000
SRR6145060	Algibacter sp. L1A34	2686365	S	17	0	17	0.00000
SRR6145060	Alcelaphine gammaherpesvirus 1	35252	S	1	0	1	0.00000
SRR6145060	Alcaligenaceae bacterium SJ-26	2593958	S	20	0	20	0.00000
SRR6145060	Agrotis segetum granulovirus	10464	S	1	0	1	0.00000
SRR6145060	Aeromonas virus Aeh1	227470	S	2	0	2	0.00000
SRR6145060	Aeromonas virus 65	260149	S	1	0	1	0.00000
SRR6145060	Aeromonas virus 25AhydR2PP	2733364	S	1	0	1	0.00000
SRR6145060	Aeromonas phage PX29	926067	S	1	0	1	0.00000
SRR6145060	Aequorivita sp. H23M31	2494375	S	19	0	19	0.00000
SRR6145060	Adoxophyes honmai entomopoxvirus	1993630	S	2	0	2	0.00000
SRR6145060	Actinomyces virus Av1	338473	S	13	0	13	0.00000
SRR6145060	Actinomyces sp. oral taxon 897	2081702	S	292	9	301	0.00004
SRR6145060	Actinomyces sp. oral taxon 848	649739	S	200	0	200	0.00003
SRR6145060	Actinomyces sp. oral taxon 414	712122	S	842	43	885	0.00012
SRR6145060	Actinomyces sp. oral taxon 171	706438	S	3042	369	3411	0.00045
SRR6145060	Actinobaculum sp. 313	2495645	S	12	0	12	0.00000
SRR6145060	Actinobacteria bacterium IMCC26256	1650658	S	6	0	6	0.00000
SRR6145060	Actinobacteria bacterium IMCC26103	1848756	S	3	0	3	0.00000
SRR6145060	Actinobacteria bacterium IMCC26077	1848755	S	6	0	6	0.00000
SRR6145060	Actinobacteria bacterium IMCC25003	1848255	S	4	0	4	0.00000
SRR6145060	Acinetobacter virus Petty	2733321	S	1	0	1	0.00000
SRR6145060	Acinetobacter virus ME3	2560269	S	45	0	45	0.00001
SRR6145060	Acinetobacter virus Loki	2560268	S	2	0	2	0.00000
SRR6145060	Acinetobacter virus LZ35	2560267	S	1	0	1	0.00000
SRR6145060	Acinetobacter virus IMEAB3	2560266	S	1	0	1	0.00000
SRR6145060	Acinetobacter virus AP22	1915209	S	2	0	2	0.00000
SRR6145060	Acinetobacter virus AB1	1915208	S	3	0	3	0.00000
SRR6145060	Acinetobacter virus 133	279006	S	1	0	1	0.00000
SRR6145060	Acinetobacter sp. Marseille-Q1620	2714110	S	55	0	55	0.00001
SRR6145060	Acinetobacter phage vB_AbaM_phiAbaA1	1605379	S	1	0	1	0.00000
SRR6145060	Acinetobacter phage vB_AbaM_Acibel004	1481186	S	3	0	3	0.00000
SRR6145060	Acinetobacter phage phiAC-1	1229760	S	1	0	1	0.00000
SRR6145060	Acinetobacter phage ZZ1	1049283	S	1	0	1	0.00000
SRR6145060	Acinetobacter phage YMC13/03/R2096	1560342	S	43	0	43	0.00001
SRR6145060	Acinetobacter phage Presley	1406780	S	3	0	3	0.00000
SRR6145060	Acinetobacter phage Acj9	760939	S	1	0	1	0.00000
SRR6145060	Acinetobacter phage Ac42	762660	S	3	0	3	0.00000
SRR6145060	Aciduliprofundum sp. MAR08-339	673860	S	2	0	2	0.00000
SRR6145060	Acidovorax virus ACP17	2560261	S	1	0	1	0.00000
SRR6145060	Acidithiobacillus ferrooxidans	920	S	3	-3	0	0.00000
SRR6145060	Acidilobus sp. 7A	1577685	S	2	0	2	0.00000
SRR6145060	Acidiferrobacter sp. SPIII_3	1281578	S	11	0	11	0.00000
SRR6145060	Achromobacter phage phiAxp-2	1664246	S	1	0	1	0.00000
SRR6145060	'Catharanthus roseus' aster yellows phytoplasma	1193712	S	1	2	3	0.00000
SRR6145060	Gordonia virus Vendetta	2049886	S	1	-1	0	0.00000
SRR6145060	Candidatus Tremblaya princeps	189385	S	1	-1	0	0.00000
SRR6145060	Staphylococcus virus Remus	1857890	S	2	-2	0	0.00000
SRR6145060	Candidatus Kinetoplastibacterium blastocrithidii	233181	S	3	-3	0	0.00000
SRR6145060	Candidatus Kinetoplastibacterium crithidii	33056	S	7	-7	0	0.00000
